"","id","total_degree","in_degree","out_degree","total_closeness_lcc","label","scaled"
"1",1,51,17,34,3.37397852800065e-06,"although",0.26046374188839
"2",2,94,52,42,3.71319297463889e-06,"deal",0.499086235483765
"3",3,679,632,47,4.0831825958425e-06,"music",0.759357715342548
"4",4,48,15,33,3.43942822945114e-06,"inform",0.306504737842327
"5",5,137,97,40,3.77994662715362e-06,"way",0.546044503852129
"6",6,95,65,30,3.64270857238608e-06,"none",0.449503548213722
"7",7,106,68,38,3.67398524527526e-06,"extra",0.471505316564527
"8",8,136,92,44,3.7746674517975e-06,"will",0.54233083540407
"9",9,552,514,38,4.01558045215436e-06,"paper",0.711802570627674
"10",10,42,4,38,3.62859185235986e-06,"w",0.439573054487909
"11",11,92,55,37,3.65549182814802e-06,"contract",0.458496008282599
"12",12,52,23,29,3.63935452408161e-06,"concern",0.447144122257709
"13",13,100,73,27,3.69689867170431e-06,"town",0.487623907637229
"14",14,94,62,32,3.70305909712013e-06,"couple",0.4919574968723
"15",15,321,282,39,3.98765422252706e-06,"mind",0.692157692243438
"16",16,115,85,30,3.48870879398826e-06,"maybe",0.341171454758946
"17",17,163,126,37,3.79944983966322e-06,"read",0.55976415892072
"18",18,143,107,36,3.75775977393317e-06,"board",0.530437025182021
"19",19,148,107,41,3.77063953817207e-06,"check",0.539497374733948
"20",20,32,7,25,3.38784373909538e-06,"v",0.2702173101059
"21",21,46,18,28,3.61212953096498e-06,"occasion",0.427992533019722
"22",22,123,86,37,3.70631184907898e-06,"real",0.494245665289537
"23",23,112,69,43,3.69374427469637e-06,"seat",0.48540492761653
"24",24,175,138,37,3.9066772928289e-06,"chair",0.635193971860156
"25",25,55,16,39,3.6125993013233e-06,"provide",0.428322995874206
"26",26,74,32,42,3.66249386532278e-06,"budget",0.463421634497658
"27",27,211,160,51,3.90004953062904e-06,"land",0.630531631683426
"28",28,68,35,33,3.63750118218788e-06,"village",0.445840377477532
"29",29,71,31,40,3.72472772240349e-06,"feed",0.507200424905415
"30",30,42,14,28,3.57649953684331e-06,"exist",0.402928394011607
"31",31,80,40,40,3.74509392695569e-06,"Sunday",0.52152715704634
"32",32,49,21,28,3.56773341895894e-06,"wee",0.396761814346587
"33",33,286,248,38,3.786000128724e-06,"glass",0.550302876848984
"34",34,95,68,27,3.79900238197449e-06,"sister",0.559449392051207
"35",35,129,86,43,3.74370589446493e-06,"know",0.520550737034108
"36",36,66,20,46,3.53992325446384e-06,"claim",0.377198582695096
"37",37,94,57,37,3.62376610764035e-06,"stairs",0.436178354616381
"38",38,554,516,38,4.2435455671923e-06,"dog",0.872166036105671
"39",39,104,73,31,3.70491123032692e-06,"key",0.493260391394203
"40",40,123,88,35,3.79125357799556e-06,"all",0.553998448124265
"41",41,99,62,37,3.70046921949703e-06,"grand",0.490135631492876
"42",42,128,89,39,3.74939072400735e-06,"carry",0.524549765420193
"43",43,44,11,33,3.33483400863722e-06,"recent",0.232927288433461
"44",44,119,84,35,3.7701419835471e-06,"simple",0.539147366865809
"45",45,45,10,35,3.55781991027178e-06,"e",0.389788095548193
"46",46,118,77,41,3.82216242661448e-06,"set",0.575741468224685
"47",47,60,18,42,3.69378520639025e-06,"across",0.485433721268911
"48",48,141,113,28,3.74359377515227e-06,"parent",0.520471866012451
"49",49,39,9,30,3.67710597051696e-06,"Mrs",0.473700609973705
"50",50,78,43,35,3.56424915527295e-06,"plus",0.39431078757773
"51",51,363,334,29,3.94452421148961e-06,"wrong",0.66181762010162
"52",52,262,225,37,3.93609358456107e-06,"go",0.655887043617633
"53",53,59,23,36,3.55540385832427e-06,"assume",0.388088508911817
"54",54,173,128,45,3.79616132167153e-06,"pay",0.557450830667199
"55",55,78,38,40,3.63336445915553e-06,"possible",0.442930374159349
"56",56,47,15,32,3.55579576931419e-06,"pardon",0.38836420111364
"57",57,80,53,27,3.70407411111482e-06,"sheet",0.492671514723975
"58",59,119,88,31,3.75171171847155e-06,"act",0.526182483283946
"59",60,150,115,35,3.75103622375681e-06,"choice",0.525707302362735
"60",61,146,103,43,3.78020382859044e-06,"understand",0.546225433788389
"61",62,74,33,41,3.64717252949651e-06,"example",0.452643746361381
"62",63,382,340,42,3.96949837449042e-06,"space",0.679385849019255
"63",64,291,254,37,3.8720819022764e-06,"sleep",0.610857631110646
"64",65,138,106,32,3.84701202575959e-06,"cook",0.59322207193015
"65",66,176,133,43,3.85194658120481e-06,"waste",0.596693315377451
"66",67,135,104,31,3.79215933136647e-06,"well",0.554635605916597
"67",68,62,33,29,3.4253965752885e-06,"month",0.296634084222654
"68",69,151,110,41,3.78469620243583e-06,"tie",0.549385621863437
"69",70,350,308,42,3.88048117966628e-06,"church",0.616766154568405
"70",71,55,14,41,3.53431823001343e-06,"advertise",0.373255693692945
"71",72,102,62,40,3.61035594499262e-06,"guess",0.426744893034086
"72",73,519,472,47,4.02884654123524e-06,"science",0.72113468277122
"73",75,127,82,45,3.77154969205297e-06,"radio",0.540137628092164
"74",76,76,37,39,3.67978510055013e-06,"hang",0.47558526051119
"75",77,36,3,33,3.36026021855132e-06,"k",0.250813512538927
"76",78,85,52,33,3.71914504293753e-06,"nation",0.503273254620322
"77",79,833,794,39,4.30733711804688e-06,"good",0.917040595801148
"78",80,129,91,38,3.72241227204878e-06,"part",0.505571607079659
"79",81,106,66,40,3.86143622258863e-06,"feel",0.603368862108358
"80",82,45,17,28,3.57532311982695e-06,"they",0.402100836209359
"81",83,111,71,40,3.63873212018004e-06,"other",0.446706288396308
"82",84,76,31,45,3.75513514731395e-06,"rate",0.528590715407063
"83",85,75,34,41,3.74430865085071e-06,"between",0.52097474972941
"84",86,75,37,38,3.83404710510273e-06,"very",0.584101818571055
"85",87,59,21,38,3.57688331848927e-06,"bring",0.403198367576301
"86",88,46,18,28,3.45050084019695e-06,"happen",0.314293834129243
"87",89,126,87,39,3.75140208652984e-06,"drop",0.525964670785804
"88",90,139,110,29,3.79999848000061e-06,"father",0.560150103348183
"89",91,53,12,41,3.35696637662477e-06,"except",0.248496439130608
"90",92,204,161,43,3.92874822224143e-06,"trouble",0.65071990321296
"91",93,172,137,35,3.84702682531805e-06,"like",0.593232482770781
"92",94,328,300,28,3.92822350020427e-06,"stop",0.650350784261237
"93",95,212,171,41,3.84693802967528e-06,"hold",0.593170018928487
"94",96,59,20,39,3.69232586991198e-06,"supply",0.484407142027103
"95",97,120,75,45,3.81963675254483e-06,"decision",0.573964767230721
"96",98,60,30,30,3.57326625121491e-06,"brief",0.400653919304528
"97",99,63,26,37,3.6101083032491e-06,"sort",0.426570687923005
"98",100,278,245,33,3.8389779105211e-06,"quiet",0.587570424038851
"99",101,108,81,27,3.69435834537078e-06,"throw",0.485836899417919
"100",102,78,45,33,3.71897906586684e-06,"wish",0.503156497026769
"101",103,91,58,33,3.67551117171621e-06,"debate",0.472578738926079
"102",104,250,208,42,3.89735914944034e-06,"hospital",0.62863906645122
"103",105,178,143,35,3.78711849515059e-06,"deep",0.551089598606006
"104",106,100,53,47,3.70592726005974e-06,"miss",0.493975123773129
"105",107,129,91,38,3.79329572912834e-06,"beat",0.555435011927578
"106",108,87,56,31,3.7149310508797e-06,"much",0.500308895929833
"107",109,91,59,32,3.80427752965434e-06,"match",0.56316022720556
"108",110,53,8,45,3.678999900667e-06,"refer",0.475032906812995
"109",111,275,238,37,3.9088762762481e-06,"open",0.636740860302158
"110",112,77,37,40,3.66847277809775e-06,"fill",0.467627537546579
"111",113,112,73,39,3.6726898780667e-06,"sorry",0.470594082516298
"112",114,33,2,31,3.67929769565585e-06,"such",0.475242392533676
"113",115,55,8,47,3.71527610074343e-06,"resource",0.500551623383556
"114",116,303,259,44,3.8940961608106e-06,"road",0.626343696984738
"115",117,187,149,38,3.86634807958491e-06,"television",0.606824138191826
"116",118,131,96,35,3.77993233921113e-06,"square",0.546034452910901
"117",119,50,24,26,3.39835519608509e-06,"once",0.27761165932382
"118",120,49,7,42,3.74732534653391e-06,"recommend",0.523096862904361
"119",121,85,44,41,3.61169901545085e-06,"offer",0.427689684227367
"120",122,106,79,27,3.64649426041803e-06,"add",0.452166613796898
"121",123,63,21,42,3.46999323351319e-06,"definite",0.328005878369574
"122",124,39,11,28,3.47262012661173e-06,"client",0.329853782513378
"123",125,187,151,36,3.84247393842051e-06,"age",0.590029726416164
"124",126,160,109,51,3.80556602086211e-06,"card",0.564066624288647
"125",127,256,213,43,3.85199109419659e-06,"cut",0.59672462831592
"126",128,46,13,33,3.63957970133609e-06,"fund",0.447302524585492
"127",129,101,71,30,3.72137333561578e-06,"necessary",0.504840760841278
"128",130,238,201,37,3.7889982646388e-06,"language",0.552411934040432
"129",131,107,68,39,3.6416340740417e-06,"say",0.44874768572956
"130",132,129,84,45,3.74129680829969e-06,"get",0.518856050520216
"131",133,149,111,38,3.75250010319375e-06,"rule",0.526737077376822
"132",134,91,56,35,3.68404183597909e-06,"telephone",0.478579687289593
"133",135,157,118,39,3.82417952228349e-06,"cross",0.577160406607558
"134",136,110,75,35,3.71874395704107e-06,"note",0.50299110827394
"135",137,148,120,28,3.75093773443361e-06,"finish",0.525638019441183
"136",138,116,86,30,3.72953418118077e-06,"answer",0.510581557961993
"137",139,109,69,40,3.7220243345951e-06,"engine",0.505298710086405
"138",140,44,10,34,3.53961000576956e-06,"apparent",0.376978225970065
"139",141,88,53,35,3.59976385549108e-06,"switch",0.419293822378662
"140",142,194,154,40,3.79443280818383e-06,"office",0.556234897198756
"141",143,74,40,34,3.68817239993066e-06,"purpose",0.481485357964435
"142",144,149,105,44,3.75881912938231e-06,"area",0.531182235303179
"143",145,102,63,39,3.73426939019381e-06,"lunch",0.513912569932693
"144",146,56,27,29,3.4470634466498e-06,"or",0.311875778448479
"145",147,41,5,36,3.62205979296306e-06,"lad",0.434978037037965
"146",148,1032,991,41,4.25957872766383e-06,"money",0.883444661676746
"147",149,178,139,39,3.81532310063678e-06,"cover",0.570930302204235
"148",150,45,17,28,3.59148960622908e-06,"previous",0.413473250728205
"149",151,164,124,40,3.7829351794057e-06,"sign",0.548146819356961
"150",152,40,6,34,3.57130102496339e-06,"tonight",0.399271468783144
"151",153,42,10,32,3.55008999478137e-06,"depend",0.384350438844936
"152",155,151,116,35,3.78423789233086e-06,"laugh",0.549063220794818
"153",156,212,169,43,3.87903613710065e-06,"coffee",0.615749630467565
"154",157,135,106,29,3.74962972406475e-06,"okay",0.524717891483901
"155",158,31,11,20,3.48874530763756e-06,"every",0.34119714051064
"156",159,211,165,46,3.89052074620188e-06,"force",0.62382854953738
"157",160,136,99,37,3.69453578157904e-06,"stage",0.485961718012435
"158",161,150,117,33,3.77213299032071e-06,"around",0.540547952854382
"159",162,145,118,27,3.63347007292374e-06,"same",0.443004668815659
"160",163,345,300,45,3.89626581883922e-06,"travel",0.627869956299964
"161",164,324,276,48,3.91008371489234e-06,"police",0.63759024045977
"162",165,141,95,46,3.78842409134648e-06,"honest",0.552008028298429
"163",166,145,97,48,3.87974347136167e-06,"grow",0.616247209113883
"164",167,641,599,42,4.13505075774805e-06,"child",0.795844693579386
"165",168,165,126,39,3.80248378240667e-06,"state",0.561898404646521
"166",169,96,55,41,3.73918440909669e-06,"secure",0.517370070278851
"167",170,89,53,36,3.68673108614785e-06,"year",0.480471456898848
"168",171,112,86,26,3.75888977431626e-06,"odd",0.531231930917457
"169",172,152,107,45,3.78875421972501e-06,"wait",0.552240259141402
"170",173,143,106,37,3.76500353910333e-06,"buy",0.535532696445589
"171",174,191,156,35,3.85121968127306e-06,"drive",0.596181973139441
"172",175,57,9,48,3.64967499644157e-06,"attend",0.454404122160489
"173",176,87,48,39,3.71006577946627e-06,"press",0.496886390761803
"174",177,67,42,25,3.45345604613817e-06,"also",0.316372691966136
"175",178,100,67,33,3.68598367846427e-06,"always",0.479945688356398
"176",179,82,42,40,3.76429490992042e-06,"double",0.535034206878488
"177",180,43,11,32,3.49550128983998e-06,"cent",0.345949677838584
"178",181,273,244,29,3.88204785788599e-06,"story",0.617868244019944
"179",182,142,119,23,3.72322997646919e-06,"present",0.506146826294983
"180",183,48,18,30,3.3310016321908e-06,"than",0.230231379597313
"181",184,32,6,26,3.35200399558876e-06,"whether",0.245005621599933
"182",185,52,20,32,3.73265249751779e-06,"policy",0.512775156812314
"183",186,92,51,41,3.71408939813181e-06,"some",0.499716830115917
"184",187,255,217,38,3.93199226183923e-06,"box",0.653001942866107
"185",188,60,23,37,3.69097666933647e-06,"comment",0.483458038565039
"186",189,232,193,39,3.85470833349395e-06,"lie",0.598636087050229
"187",190,110,81,29,3.6036945076092e-06,"ask",0.422058863841894
"188",191,101,69,32,3.58491039516467e-06,"never",0.408845064147008
"189",192,248,212,36,3.9051516760911e-06,"history",0.634120767361192
"190",193,37,5,32,3.39096849451172e-06,"already",0.272415438566265
"191",194,192,159,33,3.76825247291569e-06,"paint",0.537818178964139
"192",195,105,70,35,3.66350018134326e-06,"sense",0.464129533705762
"193",196,436,399,37,4.018904928785e-06,"help",0.714141194207436
"194",197,206,164,42,3.88593989228175e-06,"first",0.620606119608315
"195",198,85,47,38,3.76700331119591e-06,"meet",0.536939448451831
"196",199,120,77,43,3.69519107833066e-06,"agree",0.486422690551976
"197",200,50,9,41,3.67872921977832e-06,"h",0.474842494673222
"198",201,138,100,38,3.71024472774224e-06,"morning",0.497012273029673
"199",202,37,10,27,3.41199110152721e-06,"probable",0.287203921066427
"200",203,68,34,34,3.63085793542156e-06,"detail",0.44116714458707
"201",204,300,262,38,3.94902597274382e-06,"mother",0.664984411807271
"202",205,178,133,45,3.83398830633567e-06,"cheap",0.584060456215893
"203",206,79,35,44,3.70312766162301e-06,"most",0.492005728994518
"204",207,147,94,53,3.94819962097284e-06,"mark",0.664403109559876
"205",208,100,58,42,3.80287421232968e-06,"active",0.562173054982692
"206",209,273,237,36,3.87547329217581e-06,"doctor",0.613243325241811
"207",210,79,46,33,3.7051171372783e-06,"succeed",0.493405237908472
"208",211,61,31,30,3.63808345763452e-06,"how",0.446249982729938
"209",212,96,62,34,3.72990977348258e-06,"improve",0.510845770682061
"210",213,233,198,35,3.82127148987554e-06,"heat",0.575114733283444
"211",214,109,78,31,3.67867508838017e-06,"there",0.474804415607497
"212",215,317,274,43,3.98914951332376e-06,"head",0.693209563772188
"213",216,212,178,34,3.84265112186199e-06,"take",0.590154367200332
"214",217,152,128,24,3.75893216255126e-06,"two",0.531261749182676
"215",218,132,102,30,3.76934616921349e-06,"try",0.538587546366984
"216",219,96,65,31,3.67053296138599e-06,"sale",0.469076786180816
"217",220,94,54,40,3.734255445478e-06,"process",0.513902760436397
"218",221,174,133,41,3.76273686428561e-06,"news",0.533938190072011
"219",222,97,61,36,3.70329222678962e-06,"own",0.492121493375441
"220",223,529,488,41,4.177720218077e-06,"hard",0.825860788486216
"221",224,484,439,45,4.11321204842073e-06,"family",0.780482118877056
"222",225,53,17,36,3.74715684474405e-06,"lay",0.522978329281544
"223",226,143,109,34,3.84578405922507e-06,"build",0.59235825130157
"224",227,208,165,43,3.78356495056772e-06,"number",0.548589835763148
"225",228,70,37,33,3.65693556113848e-06,"subject",0.459511611154715
"226",229,120,80,40,3.73082820655357e-06,"blow",0.511491848087587
"227",230,60,20,40,3.57042120258927e-06,"further",0.398652552310348
"228",231,242,207,35,3.95964331533016e-06,"day",0.672453246900869
"229",232,115,84,31,3.77147857045876e-06,"lead",0.540087597168288
"230",233,218,170,48,3.89050561010909e-06,"bar",0.623817901959601
"231",234,58,20,38,3.47579456663793e-06,"knock",0.332086861918836
"232",235,101,61,40,3.7408069668789e-06,"position",0.518511468553099
"233",236,147,107,40,3.86501810760983e-06,"company",0.605888561207268
"234",237,301,257,44,3.93015331528083e-06,"line",0.651708324573305
"235",238,35,4,31,3.48110629558074e-06,"chairman",0.33582343038812
"236",239,496,455,41,4.03781005333947e-06,"fire",0.727440120617043
"237",240,80,49,31,3.48598459892004e-06,"few",0.339255102944747
"238",241,280,244,36,3.97818364091323e-06,"place",0.685495553225227
"239",242,193,163,30,3.82306839469358e-06,"shop",0.576378777054821
"240",243,92,47,45,3.71653262372337e-06,"matter",0.501435532219708
"241",244,49,13,36,3.61863888516973e-06,"council",0.432571578362357
"242",245,307,277,30,3.89329263544765e-06,"large",0.625778452114795
"243",246,45,4,41,3.56524033285084e-06,"insure",0.395008037555068
"244",247,60,31,29,3.50936298043179e-06,"a",0.355700769536616
"245",248,99,61,38,3.6958466075824e-06,"file",0.48688382664516
"246",249,398,354,44,3.99203190431898e-06,"party",0.695237199486447
"247",250,324,278,46,3.97677563031894e-06,"danger",0.684505079492906
"248",251,70,15,55,3.6335624900077e-06,"rid",0.44306968018308
"249",252,47,11,36,3.57182402337402e-06,"rather",0.399639375239151
"250",253,124,84,40,3.72586570489653e-06,"save",0.508000945705305
"251",254,124,86,38,3.72956200023869e-06,"worry",0.51060112744978
"252",255,236,197,39,3.77237489861743e-06,"king",0.540718124736967
"253",256,69,39,30,3.57353440420248e-06,"who",0.400842553176676
"254",257,36,12,24,3.5150743965496e-06,"actual",0.359718500413056
"255",258,34,13,21,3.18672283796789e-06,"either",0.12873757238597
"256",259,95,55,40,3.79449039993929e-06,"figure",0.556275410474159
"257",260,77,38,39,3.69209411886328e-06,"course",0.484244115323254
"258",261,221,180,41,3.86312186604239e-06,"order",0.604554638387153
"259",262,80,42,38,3.6248957842462e-06,"four",0.436973032588728
"260",263,304,253,51,3.99158573726584e-06,"free",0.694923340522495
"261",264,99,55,44,3.79151232051929e-06,"form",0.55418046214761
"262",265,155,115,40,3.8627040473413e-06,"hope",0.604260721246206
"263",266,576,549,27,4.1185482940973e-06,"woman",0.78423593379384
"264",267,37,6,31,3.53566781693726e-06,"f",0.374205068934124
"265",268,76,29,47,3.67080243741282e-06,"absolute",0.469266350753087
"266",269,102,56,46,3.76055776592784e-06,"organize",0.53240528989906
"267",270,102,64,38,3.79591635318724e-06,"case",0.557278506076806
"268",271,58,30,28,3.5763204669244e-06,"ever",0.402802426173263
"269",272,150,113,37,3.85760797444721e-06,"low",0.600675857353809
"270",273,101,73,28,3.67429572936607e-06,"France",0.471723728512211
"271",274,327,285,42,3.98838582049073e-06,"horse",0.692672339340964
"272",275,177,131,46,3.77744788066287e-06,"write",0.544286745229533
"273",276,133,93,40,3.79411608477573e-06,"on",0.556012096164866
"274",277,116,76,40,3.71882693323218e-06,"with",0.503049478387089
"275",278,95,70,25,3.69353962983346e-06,"near",0.485260968926166
"276",279,44,12,32,3.70529560848364e-06,"recognize",0.493530784578071
"277",280,490,457,33,4.06611503039421e-06,"girl",0.74735143121392
"278",281,228,190,38,3.86636302829018e-06,"walk",0.6068346539507
"279",282,80,43,37,3.83665075735486e-06,"original",0.585933373798183
"280",283,333,294,39,3.8986050791027e-06,"fight",0.629515523352813
"281",284,409,377,32,3.97104315332595e-06,"sun",0.680472533213991
"282",285,229,193,36,3.8494554945203e-06,"door",0.594940945092778
"283",286,49,11,38,3.57857293668431e-06,"apply",0.404386939911355
"284",287,98,69,29,3.71689178641253e-06,"sit",0.501688187427477
"285",288,128,92,36,3.78524058989189e-06,"shoe",0.549768574575314
"286",289,114,82,32,3.80178988267676e-06,"it",0.561410276603934
"287",290,290,246,44,3.83097728230472e-06,"together",0.581942332799683
"288",291,42,12,30,3.42145870470416e-06,"u",0.293863964884862
"289",292,37,8,29,3.45264524415381e-06,"Wednesday",0.315802328311998
"290",293,45,7,38,3.65777826548155e-06,"during",0.460104416719748
"291",294,316,275,41,3.90672307974794e-06,"eat",0.635226180950608
"292",295,53,30,23,3.33226700789081e-06,"perhaps",0.231121515933968
"293",296,139,99,40,3.76177435372717e-06,"can",0.533261106086223
"294",297,273,233,40,3.86462974914688e-06,"dress",0.605615368052446
"295",298,228,192,36,3.80542120304586e-06,"letter",0.563964751303065
"296",299,335,296,39,3.95981578936948e-06,"face",0.672574574827057
"297",300,573,531,42,4.3183673116868e-06,"life",0.924799853513435
"298",301,90,47,43,3.68837645045404e-06,"responsible",0.481628898562986
"299",302,87,51,36,3.51700295076548e-06,"welcome",0.361075153764899
"300",303,528,476,52,4.1237963669354e-06,"hair",0.787927722983863
"301",304,110,69,41,3.69161707594395e-06,"wonder",0.483908536540891
"302",305,38,10,28,3.46065067153926e-06,"ago",0.321433795556231
"303",306,48,15,33,3.48818551565846e-06,"should",0.340803351392074
"304",307,117,92,25,3.71277938664885e-06,"far",0.498795294462579
"305",308,33,4,29,3.56783525163942e-06,"p",0.396833449173428
"306",309,156,114,42,3.88684613530889e-06,"in",0.621243621852347
"307",310,150,113,37,3.74649702528136e-06,"cup",0.522514175213019
"308",311,608,567,41,4.11104761826456e-06,"cold",0.778959537140939
"309",312,116,77,39,3.82518886870039e-06,"stand",0.577870437566701
"310",313,232,190,42,3.95707366488335e-06,"nature",0.670645610453297
"311",314,55,19,36,3.68291569069401e-06,"committee",0.477787493446613
"312",315,428,386,42,3.96930930048862e-06,"mean",0.679252843747134
"313",316,72,34,38,3.66954970955514e-06,"member",0.468385111619088
"314",317,92,53,39,3.65419611339701e-06,"bother",0.457584529753494
"315",318,113,75,38,3.66714095022956e-06,"again",0.46669065502257
"316",319,48,10,38,3.57888031150574e-06,"pension",0.404603164624323
"317",320,280,240,40,3.89205009846887e-06,"end",0.624904381817377
"318",321,55,21,34,3.51637222909868e-06,"oppose",0.360631468720273
"319",322,181,149,32,3.92458517134739e-06,"college",0.647791379398171
"320",323,55,25,30,3.66282924256354e-06,"site",0.463657557685127
"321",324,82,46,36,3.66664344459152e-06,"standard",0.466340681614583
"322",325,154,109,45,3.84257729344226e-06,"forward",0.590102432143349
"323",326,173,142,31,3.73988361482191e-06,"many",0.517861930856552
"324",327,190,149,41,3.79907454544073e-06,"more",0.559500155886388
"325",328,114,69,45,3.87451229576477e-06,"service",0.612567306392348
"326",329,355,320,35,3.94494435655985e-06,"high",0.662113173741289
"327",330,91,54,37,3.69870360438666e-06,"current",0.488893598659247
"328",331,1068,1024,44,4.3874081386421e-06,"work",0.973367048841438
"329",332,120,97,23,3.78993166753203e-06,"less",0.553068542059699
"330",333,487,449,38,4.00580039897772e-06,"baby",0.704922731930845
"331",334,476,431,45,4.02683482728905e-06,"strong",0.719719530194442
"332",335,42,3,39,3.71613210106393e-06,"consult",0.501153782085877
"333",336,46,7,39,3.60494165401933e-06,"g",0.422936176672207
"334",337,344,301,43,3.93618654375268e-06,"country",0.655952436334027
"335",338,249,218,31,3.87053823704724e-06,"fall",0.609771730289181
"336",339,177,129,48,3.8113677855572e-06,"best",0.568147911428732
"337",340,177,141,36,3.69461768096237e-06,"kitchen",0.486019330638512
"338",341,77,54,23,3.71224185998166e-06,"begin",0.498417168014934
"339",342,233,201,32,3.76263775957497e-06,"city",0.533868474252379
"340",343,136,105,31,3.69827956034853e-06,"view",0.488595302266575
"341",344,216,180,36,3.85332696249942e-06,"give",0.597664353108587
"342",345,112,77,35,3.65479710393877e-06,"price",0.458007300254938
"343",346,77,40,37,3.54264458418209e-06,"so",0.379112918861197
"344",347,94,61,33,3.62575007704719e-06,"proper",0.437573990125921
"345",348,105,69,36,3.82007449145258e-06,"structure",0.574272697363846
"346",349,261,222,39,3.91889455822302e-06,"field",0.643788282515707
"347",350,116,81,35,3.86337558578432e-06,"husband",0.604733119103689
"348",351,134,104,30,3.71021719611466e-06,"start",0.496992905736531
"349",352,93,56,37,3.70274373310623e-06,"enough",0.491735652112642
"350",353,39,7,32,3.36676531289033e-06,"shall",0.255389561252746
"351",354,200,166,34,3.83279801920998e-06,"short",0.583223141399735
"352",355,70,32,38,3.68298351128282e-06,"evening",0.477835202257897
"353",356,42,10,32,3.45382580284181e-06,"each",0.316632799598696
"354",357,70,38,32,3.73347470757559e-06,"individual",0.513353545546041
"355",358,271,226,45,3.93437463115238e-06,"move",0.6546778352457
"356",359,63,17,46,3.61172510437886e-06,"identify",0.4277080366446
"357",360,61,23,38,3.63345687086694e-06,"eight",0.442995381747417
"358",361,70,29,41,3.69699434359865e-06,"really",0.487691208621082
"359",362,36,4,32,3.39907137370071e-06,"presume",0.278115458882441
"360",363,128,92,36,3.83544410607304e-06,"society",0.585084547515515
"361",364,50,18,32,3.57985401355333e-06,"yesterday",0.405288121332141
"362",365,61,26,35,3.65963894002218e-06,"six",0.461413319695595
"363",366,276,238,38,3.92253772500657e-06,"bed",0.646351090648117
"364",367,81,44,37,3.71028602594974e-06,"report",0.497041324508323
"365",368,169,128,41,3.69905932921258e-06,"leave",0.489143835480926
"366",369,62,32,30,3.51312327198249e-06,"exact",0.358345969808497
"367",370,89,50,39,3.76961613998846e-06,"apart",0.538777458972893
"368",371,227,181,46,3.9458471931216e-06,"control",0.662748279686241
"369",372,44,6,38,3.56313156506991e-06,"thirty",0.393524611859948
"370",373,77,43,34,3.62521116855057e-06,"obvious",0.437194891621839
"371",374,251,213,38,3.89241368572652e-06,"fly",0.625160149515126
"372",375,227,192,35,3.85923070095207e-06,"heavy",0.601817374317053
"373",376,84,35,49,3.6947405368458e-06,"range",0.486105754367061
"374",377,72,36,36,3.6655279093295e-06,"excuse",0.465555951457735
"375",378,219,175,44,3.91225592413353e-06,"clear",0.639118294441204
"376",379,35,7,28,3.45256180085624e-06,"Thursday",0.315743629609929
"377",380,146,102,44,3.80371318481101e-06,"fit",0.562763235346581
"378",381,746,708,38,4.25244196479828e-06,"old",0.878424261843975
"379",382,109,69,40,3.71324812666632e-06,"copy",0.499125032517447
"380",383,211,169,42,3.86916046956131e-06,"hit",0.608802531257875
"381",384,273,234,39,3.89617473564454e-06,"word",0.627805883265178
"382",385,164,130,34,3.76137816896111e-06,"true",0.532982407470234
"383",386,102,63,39,3.64650755738691e-06,"middle",0.452175967631625
"384",387,44,11,33,3.49342537344717e-06,"while",0.344489361654956
"385",388,54,14,40,3.58173886258301e-06,"relation",0.406614030001333
"386",389,125,87,38,3.79921888059815e-06,"lose",0.559601689342636
"387",390,115,81,34,3.67093719026467e-06,"what",0.469361143477417
"388",391,404,365,39,4.04238031522482e-06,"friend",0.730655099513943
"389",392,177,140,37,3.9012667413109e-06,"hate",0.631387886041151
"390",393,120,94,26,3.7226894197444e-06,"size",0.505766568334638
"391",394,130,93,37,3.78562748668406e-06,"to",0.550040739508808
"392",395,55,18,37,3.58185432598456e-06,"Friday",0.406695253442938
"393",396,44,6,38,3.44607750228303e-06,"unless",0.31118220980576
"394",397,29,8,21,3.21406991244874e-06,"y",0.147975040512193
"395",398,64,26,38,3.70995566602979e-06,"minister",0.496808930786111
"396",399,208,173,35,3.84764850961335e-06,"look",0.593669810420718
"397",400,45,10,35,3.54855307748266e-06,"term",0.383269284896739
"398",401,108,65,43,3.68379755322167e-06,"three",0.478407845077988
"399",402,200,163,37,3.9247700084775e-06,"back",0.64792140421679
"400",403,486,447,39,4.05686096326107e-06,"light",0.740841600641862
"401",404,236,209,27,3.94351311809639e-06,"boy",0.661106360221211
"402",405,54,11,43,3.68770996898636e-06,"involve",0.481160058065982
"403",406,60,21,39,3.62081388654542e-06,"compare",0.434101596488009
"404",407,38,6,32,3.60893572485474e-06,"r",0.425745830423065
"405",408,185,140,45,3.88680081311873e-06,"bag",0.62121173967829
"406",409,292,240,52,3.99937609732882e-06,"dead",0.700403517332933
"407",410,46,21,25,3.51437025999311e-06,"converse",0.3592231712117
"408",411,122,83,39,3.73392080353976e-06,"argue",0.513667354502017
"409",412,238,209,29,3.89874187599662e-06,"difficult",0.629611753971133
"410",413,163,130,33,3.87443723799118e-06,"watch",0.612514506538819
"411",414,53,10,43,3.68817239993066e-06,"become",0.481485357964435
"412",415,65,29,36,3.60907899913021e-06,"staff",0.425846617595369
"413",416,279,250,29,3.90102323839543e-06,"night",0.631216592414174
"414",417,38,11,27,3.3683643222851e-06,"elect",0.256514394268681
"415",419,118,76,42,3.79956532972628e-06,"bus",0.559845401117526
"416",420,304,264,40,4.04709196207065e-06,"no",0.733969536532875
"417",421,131,93,38,3.75829643938995e-06,"leg",0.5308145458059
"418",422,198,151,47,3.82331688032636e-06,"exercise",0.576553575805003
"419",423,152,118,34,3.81407163589347e-06,"surprise",0.570049951615823
"420",424,134,95,39,3.79830975216029e-06,"social",0.558962157338647
"421",425,78,46,32,3.67902697094672e-06,"early",0.475051949568141
"422",426,106,66,40,3.79164170502544e-06,"hell",0.554271478476064
"423",427,56,20,36,3.52295025946529e-06,"paragraph",0.365258824732321
"424",428,57,29,28,3.60844086487111e-06,"photograph",0.425397718116984
"425",429,54,20,34,3.61212953096498e-06,"mile",0.427992533019722
"426",430,341,305,36,3.87810345228769e-06,"law",0.615093527586297
"427",431,133,85,48,3.83841795765457e-06,"balance",0.587176521743028
"428",432,51,20,31,3.61016043552976e-06,"department",0.426607360697206
"429",433,517,487,30,4.13038809126505e-06,"big",0.792564712098636
"430",434,116,83,33,3.75799984216401e-06,"value",0.530605902658916
"431",435,240,209,31,3.85402495095753e-06,"right",0.598155357392237
"432",436,65,31,34,3.57961053837342e-06,"consider",0.405116847215921
"433",437,55,20,35,3.63705136971355e-06,"twelve",0.445523954119563
"434",438,99,61,38,3.64326596934556e-06,"equal",0.449895652540973
"435",439,407,364,43,4.00817668042807e-06,"play",0.706594341765825
"436",440,41,8,33,3.53200883002208e-06,"thank",0.371631132032592
"437",441,70,30,40,3.5784961012285e-06,"half",0.404332889536308
"438",442,96,59,37,3.65320824748294e-06,"catch",0.45688960938648
"439",443,78,43,35,3.59581590860874e-06,"lord",0.416516614806928
"440",444,188,158,30,3.76354405416493e-06,"Jesus",0.534506012768589
"441",445,57,24,33,3.56254764907481e-06,"manage",0.393113852553609
"442",446,41,5,36,3.62304400911558e-06,"operate",0.435670389957712
"443",447,212,178,34,3.92732870955833e-06,"idea",0.649721338265365
"444",448,219,188,31,3.80014288537249e-06,"quick",0.560251686197229
"445",449,118,85,33,3.80911750365675e-06,"wash",0.566564936753864
"446",450,219,178,41,3.83404710510273e-06,"train",0.584101818571055
"447",451,112,77,35,3.75530436741898e-06,"quality",0.528709754333112
"448",452,127,87,40,3.75757621303954e-06,"meaning",0.530307898139824
"449",453,611,571,40,4.16385606382359e-06,"house",0.816107963710249
"450",454,95,65,30,3.64246974018263e-06,"transport",0.44933554022791
"451",455,70,35,35,3.63607275054359e-06,"moment",0.444835538431703
"452",456,113,76,37,3.76769876494834e-06,"protect",0.537428669681148
"453",457,282,248,34,3.93624851898649e-06,"young",0.655996033194302
"454",458,121,76,45,3.65559873223836e-06,"next",0.458571210623966
"455",459,78,52,26,3.68115323168442e-06,"guy",0.476547680791536
"456",460,151,105,46,3.80560946835636e-06,"fair",0.564097187696307
"457",461,355,311,44,3.93770549900573e-06,"fish",0.657020954770474
"458",462,95,55,40,3.66130042068342e-06,"aware",0.462582098509041
"459",463,50,17,33,3.642018698124e-06,"c",0.449018251911287
"460",464,79,49,30,3.73578998882999e-06,"second",0.514982244417134
"461",465,83,49,34,3.71058890756552e-06,"interest",0.497254388448074
"462",466,58,21,37,3.52375717084584e-06,"another",0.365826451517226
"463",467,273,227,46,3.84167681509625e-06,"cake",0.589468985099799
"464",468,278,240,38,3.90646363473002e-06,"health",0.635043672753392
"465",469,252,213,39,3.97521058678083e-06,"full",0.683404139968223
"466",470,44,17,27,3.51647115087068e-06,"could",0.360701055850592
"467",471,60,23,37,3.63883804623508e-06,"express",0.446780802732707
"468",472,54,32,22,3.56633380884451e-06,"week",0.395777249983613
"469",473,53,18,35,3.67749812447596e-06,"both",0.473976473093614
"470",474,189,153,36,3.81332987591425e-06,"positive",0.569528155985817
"471",475,38,8,30,3.41371494114755e-06,"seem",0.288416566674072
"472",476,41,7,34,3.52930380953053e-06,"d",0.369728268692556
"473",477,71,34,37,3.67177287881681e-06,"spell",0.469949013741068
"474",478,167,136,31,3.82141751661361e-06,"correct",0.575217456692531
"475",479,98,74,24,3.64604222116892e-06,"able",0.451848624000487
"476",480,77,41,36,3.66613263334641e-06,"function",0.465981348295286
"477",481,59,35,24,3.66703337000367e-06,"fortune",0.466614977049478
"478",482,72,44,28,3.62498776566629e-06,"receive",0.437037737485714
"479",483,87,54,33,3.80500129370044e-06,"enjoy",0.563669363485474
"480",484,72,35,37,3.65541165418344e-06,"from",0.458439609412976
"481",485,50,16,34,3.62613135298213e-06,"appear",0.437842201032753
"482",486,421,376,45,4.15567145261496e-06,"nice",0.810350448501014
"483",487,63,28,35,3.45449395118109e-06,"else",0.317102812666805
"484",488,61,32,29,3.58825492398282e-06,"i",0.411197793561681
"485",489,36,15,21,3.41979720602568e-06,"let",0.292695173397076
"486",490,48,10,38,3.5707526789572e-06,"thousand",0.398885731404773
"487",492,336,301,35,3.87996927064338e-06,"sick",0.616406049010551
"488",493,88,51,37,3.6796903172629e-06,"just",0.475518584623492
"489",494,66,34,32,3.59365791251599e-06,"minute",0.414998559152387
"490",496,839,798,41,4.33801839319799e-06,"red",0.938623527942746
"491",497,112,81,31,3.71996131240235e-06,"arm",0.503847464407293
"492",498,102,64,38,3.65978626848192e-06,"chance",0.461516958808816
"493",499,48,14,34,3.62241404917065e-06,"hundred",0.435227240751025
"494",500,55,12,43,3.5956736854217e-06,"slight",0.41641656702926
"495",501,454,412,42,4.04741956765464e-06,"game",0.734199992700475
"496",502,220,185,35,3.89412648901662e-06,"easy",0.626365031548224
"497",503,283,245,38,3.89854428356452e-06,"test",0.629472756356703
"498",504,132,93,39,3.82873311050107e-06,"create",0.580363656310075
"499",505,198,158,40,3.76399736520184e-06,"win",0.534824897211972
"500",506,70,29,41,3.65487725094753e-06,"secretary",0.458063680162315
"501",507,77,40,37,3.62268962968867e-06,"sudden",0.435421099565257
"502",508,107,67,40,3.77089547454834e-06,"economy",0.539677414755572
"503",509,271,224,47,3.91762028073667e-06,"wind",0.642891884162577
"504",510,265,230,35,3.93925666226783e-06,"heart",0.658112130129436
"505",511,381,335,46,3.99451951921963e-06,"blood",0.696987127523361
"506",512,96,67,29,3.67112586087901e-06,"inside",0.469493864984146
"507",513,216,180,36,3.87771245986568e-06,"English",0.614818481556732
"508",514,273,230,43,3.88565300341549e-06,"talk",0.620404305866803
"509",515,49,8,41,3.54700490905479e-06,"regard",0.382180216272383
"510",516,211,179,32,3.90265224246398e-06,"one",0.632362525368287
"511",517,139,99,40,3.79395774289866e-06,"authority",0.555900709595333
"512",518,61,20,41,3.71907588402434e-06,"quite",0.503224604356503
"513",519,147,111,36,3.76913306170448e-06,"list",0.538437634576057
"514",520,101,70,31,3.68960122789929e-06,"under",0.482490475807061
"515",521,51,8,43,3.7122969837587e-06,"tend",0.498455945175705
"516",522,83,45,38,3.65706929780612e-06,"count",0.459605689037999
"517",523,96,53,43,3.72960372960373e-06,"step",0.510630482228859
"518",524,135,104,31,3.80936417902488e-06,"find",0.566738462062218
"519",525,104,68,36,3.82710663084495e-06,"use",0.579219499169448
"520",526,275,234,41,3.92933484219791e-06,"table",0.651132564637601
"521",527,150,111,39,3.69786928771642e-06,"touch",0.488306693454368
"522",528,79,46,33,3.73979969632826e-06,"remember",0.517802897874879
"523",529,116,83,33,3.74936260835658e-06,"awful",0.524529987292338
"524",530,78,44,34,3.56788617015963e-06,"bit",0.396869268120358
"525",531,184,148,36,3.83181401907477e-06,"jump",0.582530940438692
"526",532,105,64,41,3.73365592120493e-06,"community",0.513481021390697
"527",533,144,106,38,3.6698325088443e-06,"measure",0.468584048522378
"528",534,43,16,27,3.61344780735987e-06,"alright",0.428919882676301
"529",535,47,22,25,3.52565797591976e-06,"she",0.367163584564097
"530",536,286,249,37,3.98617594183372e-06,"new",0.691117786576762
"531",537,186,155,31,3.84707122467665e-06,"kid",0.593263715773292
"532",538,76,36,40,3.70851103282032e-06,"but",0.495792694649383
"533",539,204,168,36,3.87926185405441e-06,"street",0.615908412450131
"534",540,39,11,28,3.37740851444686e-06,"though",0.262876586998338
"535",541,117,77,40,3.75945502939894e-06,"against",0.531629563089917
"536",542,41,8,33,3.34794151815756e-06,"thirteen",0.24214784680757
"537",543,47,22,25,3.63329845366818e-06,"hour",0.442883942192374
"538",544,90,57,33,3.66681822848678e-06,"pick",0.46646363442317
"539",545,115,70,45,3.75314795284545e-06,"common",0.527192811208015
"540",546,725,678,47,4.2840679795907e-06,"time",0.900671776910155
"541",547,217,176,41,3.77610706018737e-06,"name",0.543343536800478
"542",548,87,52,35,3.75574158995564e-06,"teach",0.529017321221814
"543",549,98,64,34,3.66858044279766e-06,"have",0.467703274943435
"544",550,464,420,44,4.05092827021312e-06,"warm",0.736668211144843
"545",551,115,79,36,3.71980909939702e-06,"listen",0.503740389230366
"546",552,43,4,39,3.7810614195617e-06,"politic",0.546828711443793
"547",553,45,6,39,3.6829428186298e-06,"govern",0.477806576760276
"548",554,53,13,40,3.44306377587032e-06,"otherwise",0.309062185382445
"549",555,32,4,28,3.32076975442908e-06,"ought",0.223033702110808
"550",556,184,153,31,3.73036893348752e-06,"question",0.511168769618057
"551",557,88,57,31,3.6986215237581e-06,"of",0.48883585853509
"552",558,79,44,35,3.54529468489421e-06,"certain",0.38097714854384
"553",559,171,131,40,3.84030476658628e-06,"busy",0.588503809117381
"554",560,256,210,46,3.89248944162239e-06,"hand",0.625213440467079
"555",561,70,43,27,3.63186012980268e-06,"where",0.441872144402556
"556",563,87,57,30,3.62045994323119e-06,"ready",0.433852612881709
"557",564,224,195,29,3.91820358202172e-06,"little",0.643302211047337
"558",565,69,31,38,3.70658660439601e-06,"condition",0.494438943611047
"559",566,257,216,41,3.88778303060463e-06,"garden",0.621902686623683
"560",567,173,131,42,3.79859831722095e-06,"smoke",0.559165150209442
"561",568,75,45,30,3.4800281186272e-06,"then",0.335064980163668
"562",570,121,81,40,3.79864160576178e-06,"market",0.559195601800347
"563",571,101,59,42,3.73842956051022e-06,"limit",0.516839067387391
"564",572,154,126,28,3.78706112695365e-06,"university",0.551049242594216
"565",573,43,11,32,3.58763700288805e-06,"affect",0.410763113158353
"566",574,47,16,31,3.52553367766046e-06,"Monday",0.367076146187348
"567",575,100,57,43,3.73985564157224e-06,"finance",0.517842252901627
"568",576,124,81,43,3.8472636337405e-06,"private",0.593399067115373
"569",577,152,113,39,3.72506071848971e-06,"turn",0.50743467305504
"570",578,1268,1228,40,4.23344932984497e-06,"food",0.865063775704834
"571",579,155,119,36,3.8724117767787e-06,"off",0.611089683362818
"572",580,59,35,24,3.65482381921779e-06,"this",0.458026093282652
"573",581,181,139,42,3.87520296375523e-06,"ground",0.613053161047898
"574",582,80,52,28,3.62089255001358e-06,"item",0.434156932789612
"575",583,126,90,36,3.72464448268413e-06,"clock",0.507141869411691
"576",584,254,226,28,3.8287770885979e-06,"kind",0.5803945929734
"577",585,129,87,42,3.79806450632758e-06,"perfect",0.558789637645792
"578",586,51,24,27,3.47683385601736e-06,"might",0.332817956439552
"579",587,364,332,32,3.91874098689573e-06,"job",0.643680251818828
"580",588,131,96,35,3.70838725946473e-06,"keep",0.495705625519384
"581",589,98,63,35,3.74865985410216e-06,"luck",0.524035630479896
"582",590,136,94,42,3.73258283534457e-06,"stuff",0.51272615252713
"583",591,149,117,32,3.73820596019558e-06,"rest",0.516681774367662
"584",592,76,44,32,3.77617835645613e-06,"the",0.543393690600249
"585",593,63,19,44,3.73417177937019e-06,"contact",0.513843904997094
"586",594,256,216,40,3.87556341003073e-06,"think",0.613306719202396
"587",595,72,47,25,3.56858644722239e-06,"when",0.397361882337059
"588",596,68,26,42,3.71191115169467e-06,"serve",0.498184529231781
"589",597,75,39,36,3.67534906627757e-06,"income",0.472464704855961
"590",598,295,262,33,3.88684613530889e-06,"pretty",0.621243621852347
"591",599,63,33,30,3.55347085265533e-06,"minus",0.386728724157875
"592",600,37,8,29,3.27730238685933e-06,"suppose",0.192456314436687
"593",601,43,13,30,3.57830402702335e-06,"eleven",0.404197773752646
"594",602,117,82,35,3.76863590454799e-06,"die",0.538087906309571
"595",603,158,119,39,3.76670533817481e-06,"egg",0.536729837493262
"596",604,198,166,32,3.73872307652045e-06,"court",0.517045543034181
"597",605,77,34,43,3.73872307652045e-06,"agent",0.517045543034181
"598",606,46,10,36,3.63756734046539e-06,"educate",0.44588691692568
"599",607,56,20,36,3.65590611633093e-06,"afternoon",0.458787441858774
"600",608,81,46,35,3.68381112363607e-06,"believe",0.478417391269655
"601",609,194,152,42,3.8432270809153e-06,"future",0.590559529146916
"602",610,118,68,50,3.80323579301269e-06,"side",0.562427411143145
"603",611,321,287,34,3.94801257047202e-06,"down",0.664271527731996
"604",612,294,252,42,3.94531789398931e-06,"poor",0.662375940948735
"605",613,57,15,42,3.68841726326816e-06,"approach",0.481657608588672
"606",614,45,15,30,3.5097940803813e-06,"indeed",0.356004029453642
"607",615,299,261,38,3.89603811883695e-06,"change",0.627709779329697
"608",616,100,62,38,3.67902697094672e-06,"cost",0.475051949568141
"609",617,109,73,36,3.67432273046271e-06,"follow",0.471742722600089
"610",619,72,34,38,3.58563022829708e-06,"section",0.409351435201452
"611",620,52,22,30,3.6407192604971e-06,"colleague",0.448104154502188
"612",621,50,21,29,3.46893396190417e-06,"put",0.327260727226261
"613",622,61,28,33,3.63215034196695e-06,"arrange",0.442076295938545
"614",623,92,50,42,3.70529560848364e-06,"evidence",0.493530784578071
"615",624,75,37,38,3.6245673172765e-06,"continue",0.436741970474036
"616",625,230,196,34,3.85156084503245e-06,"problem",0.596421966889109
"617",626,102,64,38,3.69877200769345e-06,"whole",0.48894171738708
"618",627,622,592,30,4.06162294329568e-06,"small",0.744191444852721
"619",628,168,124,44,3.90620422416925e-06,"special",0.634861188795262
"620",629,158,111,47,3.83955276889348e-06,"floor",0.587974811704648
"621",630,61,32,29,3.58714796626646e-06,"Britain",0.410419097332201
"622",631,223,180,43,3.8875563209722e-06,"eye",0.621743206335186
"623",632,49,21,28,3.5357053201758e-06,"upon",0.374231450818461
"624",633,95,65,30,3.65965233302836e-06,"before",0.461422741088357
"625",634,66,29,37,3.68859412923358e-06,"major",0.481782026042351
"626",635,72,44,28,3.6068530207394e-06,"page",0.424280739374178
"627",636,92,59,33,3.61759162455187e-06,"print",0.431834876424822
"628",637,102,64,38,3.75682803495353e-06,"project",0.52978158765303
"629",638,143,108,35,3.70824974320371e-06,"tell",0.495608888857838
"630",639,81,40,41,3.78996039491387e-06,"industry",0.553088750513545
"631",640,87,55,32,3.64527135399959e-06,"please",0.451306352738165
"632",641,76,53,23,3.63542503571805e-06,"Christ",0.444379899444798
"633",642,36,11,25,3.70576246062627e-06,"would",0.493859194595742
"634",643,275,232,43,4.01325981041361e-06,"out",0.710170100889407
"635",644,59,27,32,3.5090058635488e-06,"likely",0.355449553463805
"636",645,407,380,27,4.0190341457141e-06,"fast",0.714232092652775
"637",646,237,197,40,3.94685948390865e-06,"important",0.663460381880722
"638",647,154,114,40,3.825627881176e-06,"not",0.578179263598985
"639",648,100,55,45,3.73000716161375e-06,"charge",0.510914278963289
"640",649,62,26,36,3.54511872602613e-06,"along",0.380853369193384
"641",650,92,55,37,3.64418206333588e-06,"divide",0.450540084505783
"642",651,62,21,41,3.53619293468652e-06,"describe",0.374574466251956
"643",652,41,11,30,3.66211831571854e-06,"expense",0.463157451813463
"644",653,72,46,26,3.61417914763199e-06,"worth",0.429434348499114
"645",654,70,39,31,3.68431329926572e-06,"be",0.478770649812023
"646",655,144,108,36,3.82524739787546e-06,"park",0.577911610275707
"647",656,108,76,32,3.7348551623168e-06,"final",0.514324634943642
"648",657,201,166,35,3.8670059319871e-06,"great",0.607286908519518
"649",658,56,29,27,3.54939695745693e-06,"we",0.383862917466789
"650",659,82,49,33,3.71907588402434e-06,"about",0.503224604356503
"651",660,64,23,41,3.75589675790992e-06,"develop",0.529126475075789
"652",661,73,51,22,3.62115478626134e-06,"allow",0.43434140449467
"653",662,114,76,38,3.73138505281776e-06,"amount",0.511883565024839
"654",663,79,39,40,3.71871629913354e-06,"encourage",0.502971652148389
"655",664,37,5,32,3.40985037576551e-06,"invest",0.285698014332731
"656",665,54,27,27,3.52667755234471e-06,"east",0.367880811885472
"657",666,53,20,33,3.44219860109049e-06,"yet",0.308453572850151
"658",667,94,44,50,3.81151305633797e-06,"public",0.568250103054997
"659",668,38,6,32,3.45518623453804e-06,"per",0.317589803661874
"660",669,228,177,51,3.90727260650248e-06,"care",0.635612748933682
"661",670,156,127,29,3.73708835971718e-06,"push",0.515895591421612
"662",671,84,51,33,3.73185850285301e-06,"base",0.512216616370746
"663",672,78,45,33,3.65780502436098e-06,"raise",0.460123240418444
"664",673,42,20,22,3.52178399490046e-06,"shut",0.364438408734683
"665",674,72,36,36,3.58611885115096e-06,"doubt",0.409695159960164
"666",675,45,7,38,3.49253470706365e-06,"expect",0.343862816896902
"667",676,115,68,47,3.82901165551148e-06,"serious",0.580559600514758
"668",677,361,324,37,3.89881787841926e-06,"God",0.629665218343866
"669",678,63,16,47,3.67219086579244e-06,"percent",0.470243049255782
"670",679,199,152,47,3.84889248118854e-06,"plan",0.594544889893821
"671",680,79,36,43,3.7592289069666e-06,"Germany",0.531470495870946
"672",681,108,79,29,3.77664897936061e-06,"call",0.543724753183589
"673",682,263,225,38,3.95661962245936e-06,"over",0.67032621151117
"674",683,133,85,48,3.72003050425013e-06,"join",0.503896137839154
"675",684,339,308,31,3.85043375136209e-06,"round",0.595629105898659
"676",685,960,923,37,4.28212341936119e-06,"bad",0.89930386402935
"677",686,97,65,32,3.70487005168294e-06,"draw",0.493231424023244
"678",687,70,38,32,3.65937110048267e-06,"produce",0.461224906320416
"679",688,190,140,50,3.9025913206369e-06,"gas",0.632319669533474
"680",689,76,52,24,3.60395425861255e-06,"north",0.42224158728645
"681",690,397,355,42,4.0290088638195e-06,"long",0.721248869593763
"682",691,81,42,39,3.71484824844905e-06,"unit",0.500250648049555
"683",692,71,32,39,3.63050202582013e-06,"account",0.440916777783918
"684",693,62,30,32,3.60124170814097e-06,"too",0.420333426935536
"685",694,117,71,46,3.82251307299471e-06,"pass",0.575988132582437
"686",695,95,63,32,3.5643634937891e-06,"increase",0.394391219711759
"687",696,53,20,33,3.37243105064717e-06,"may",0.25937515940457
"688",697,851,804,47,4.37791952508329e-06,"fun",0.966692225140371
"689",698,90,54,36,3.63633719027498e-06,"rise",0.445021560190901
"690",699,108,72,36,3.64254934743728e-06,"enter",0.449391540441938
"691",700,82,41,41,3.73534344615316e-06,"forget",0.514668121218378
"692",701,122,81,41,3.81083037993979e-06,"type",0.567769870134293
"693",702,133,103,30,3.81947627341339e-06,"wife",0.573851877196424
"694",703,94,57,37,3.6533817528195e-06,"normal",0.457011662785066
"695",704,148,108,40,3.82257152031315e-06,"self",0.576029247708892
"696",705,121,76,45,3.7312875927225e-06,"trade",0.51181500612003
"697",706,82,40,42,3.66198420952409e-06,"through",0.463063113984268
"698",707,301,265,36,3.87556341003073e-06,"America",0.613306719202396
"699",708,555,512,43,4.06408245210479e-06,"hot",0.745921601486277
"700",709,92,56,36,3.72062566041105e-06,"stay",0.504314804109428
"701",710,394,346,48,4.04470204702371e-06,"power",0.732288336060325
"702",711,230,186,44,3.81554146348908e-06,"film",0.5710839108988
"703",712,82,45,37,3.69606516902106e-06,"result",0.487037575036521
"704",713,34,7,27,3.53883338818525e-06,"thou",0.376431909542874
"705",714,51,12,39,3.52379442183343e-06,"various",0.365852655954081
"706",715,38,7,31,3.53648056527105e-06,"million",0.374776801759765
"707",716,176,131,45,3.85854571412035e-06,"support",0.601335516107633
"708",717,132,88,44,3.774966685919e-06,"level",0.542541333491485
"709",718,259,214,45,3.98215992354253e-06,"beauty",0.688292693752838
"710",719,68,38,30,3.60897479852898e-06,"hear",0.425773317040082
"711",720,37,4,33,3.60635873171576e-06,"l",0.423933028713422
"712",721,66,25,41,3.63513430003672e-06,"benefit",0.444175379637506
"713",722,134,93,41,3.83818223689261e-06,"date",0.587010702519909
"714",723,96,57,39,3.61616570717737e-06,"for",0.430831806057573
"715",724,108,70,38,3.71780381892808e-06,"reason",0.502329762322821
"716",725,87,41,46,3.64691981152718e-06,"associate",0.452465970347965
"717",726,89,56,33,3.68620107489623e-06,"terrible",0.480098617216615
"718",727,654,622,32,4.20763854701826e-06,"black",0.846907021413271
"719",728,659,623,36,4.138421936947e-06,"sex",0.798216170368724
"720",729,97,64,33,3.620551699668e-06,"sure",0.433917159512819
"721",730,173,138,35,3.84451253503312e-06,"student",0.591463789770353
"722",731,166,124,42,3.75019219735011e-06,"bear",0.525113566783891
"723",732,668,622,46,4.33007278852358e-06,"people",0.933034143353376
"724",733,205,174,31,3.79155544770687e-06,"speed",0.554210800233575
"725",734,464,422,42,4.03456818016768e-06,"study",0.725159604949624
"726",735,106,70,36,3.70679269761839e-06,"separate",0.494583921158801
"727",736,61,28,33,3.6513407723316e-06,"seven",0.455575922479108
"728",737,78,31,47,3.7611376689221e-06,"visit",0.532813226235215
"729",738,80,44,36,3.67020964237477e-06,"come",0.468849345429253
"730",739,171,136,35,3.7828922480972e-06,"bank",0.548116619063347
"731",740,85,48,37,3.69288491862728e-06,"direct",0.484800408292174
"732",741,214,182,32,3.83579719373077e-06,"away",0.585332929204975
"733",742,205,164,41,3.80955283468826e-06,"farm",0.566871173051605
"734",743,86,42,44,3.66152832192157e-06,"general",0.46274241703993
"735",744,220,178,42,3.78337885999228e-06,"stick",0.548458929200687
"736",745,219,179,40,3.86796320793397e-06,"point",0.607960310185526
"737",746,33,4,29,3.40801428639589e-06,"bloke",0.284406405946987
"738",747,89,48,41,3.59030330882353e-06,"return",0.412638742505269
"739",748,161,124,37,3.83063975514551e-06,"trust",0.581704897238832
"740",749,83,50,33,3.70874484948059e-06,"after",0.495957174420425
"741",750,47,14,33,3.43234504678286e-06,"which",0.301522029329628
"742",751,45,9,36,3.57715201465201e-06,"o",0.403387383548379
"743",752,54,33,21,3.4658921552997e-06,"today",0.325120949618947
"744",753,122,92,30,3.73854137069881e-06,"thing",0.516917720953814
"745",754,48,17,31,3.63873212018004e-06,"at",0.446706288396308
"746",755,64,35,29,3.35723685977493e-06,"because",0.248686712169997
"747",756,45,6,39,3.54312156095763e-06,"twenty",0.379448451114305
"748",757,78,49,29,3.68753318779869e-06,"strike",0.481035700249738
"749",758,80,39,41,3.58311207616263e-06,"ten",0.407580025559176
"750",759,90,54,36,3.69213501399319e-06,"lock",0.484272883254492
"751",760,141,103,38,3.76047291707405e-06,"traffic",0.532345602449805
"752",761,58,23,35,3.61299086997207e-06,"bet",0.428598447254036
"753",762,37,3,34,3.61729064930367e-06,"afford",0.431623153531096
"754",763,68,33,35,3.56940166119953e-06,"appropriate",0.397935349634715
"755",764,152,117,35,3.79594517136794e-06,"bottle",0.557298778403673
"756",765,71,43,28,3.66379547228156e-06,"pair",0.464337257936645
"757",766,99,64,35,3.64265549585648e-06,"sell",0.449466211201779
"758",767,115,73,42,3.81043831471934e-06,"shoot",0.567494069438061
"759",768,97,60,37,3.71530370750157e-06,"character",0.500571043527755
"760",769,64,22,42,3.57184953941e-06,"x",0.39965732465196
"761",770,224,177,47,3.90779174596227e-06,"wall",0.635977940786939
"762",771,40,12,28,3.60983463347544e-06,"worse",0.426378173233673
"763",772,267,232,35,3.8250864469537e-06,"boat",0.577798388357606
"764",773,46,19,27,3.62818373122415e-06,"wage",0.43928595915911
"765",774,293,257,36,3.93928769799845e-06,"air",0.658133962405462
"766",775,264,215,49,3.92264543207939e-06,"break",0.646426857852461
"767",776,76,31,45,3.7392123723059e-06,"imagine",0.517389741170751
"768",777,112,74,38,3.75331699389335e-06,"system",0.527311724175228
"769",778,274,237,37,3.96444684073231e-06,"run",0.675832316456636
"770",779,186,158,28,3.74677777111684e-06,"ring",0.52271166760166
"771",780,59,18,41,3.71323433850587e-06,"into",0.49911533315098
"772",781,101,63,38,3.71023096187738e-06,"document",0.497002589347173
"773",782,380,338,42,3.95450734747465e-06,"clean",0.668840318651934
"774",783,168,137,31,3.81376617036856e-06,"want",0.56983507000927
"775",784,43,4,39,3.52817067878476e-06,"confer",0.368931160884188
"776",785,84,50,34,3.69910037878788e-06,"wear",0.489172712057722
"777",786,95,56,39,3.73750738157708e-06,"hall",0.516190354932046
"778",787,430,390,40,4.06177141975158e-06,"up",0.744295891530917
"779",788,706,667,39,4.15427308529553e-06,"school",0.809366758389848
"780",789,125,86,39,3.68333621861337e-06,"sing",0.478083316403858
"781",790,113,75,38,3.79740105871542e-06,"pressure",0.558322931333156
"782",791,51,10,41,3.65160743759403e-06,"introduce",0.455763509801838
"783",792,55,18,37,3.59966019207787e-06,"unite",0.419220899711599
"784",793,39,11,28,3.60235738267122e-06,"b",0.421118255061484
"785",794,160,129,31,3.80962539953446e-06,"team",0.566922219239994
"786",795,319,273,46,4.05289843031244e-06,"business",0.738054132411878
"787",796,99,53,46,3.62337220003913e-06,"explain",0.435901257886039
"788",797,87,47,40,3.67918940099117e-06,"difference",0.475166211984219
"789",798,47,9,38,3.51758440443778e-06,"basis",0.36148418093509
"790",799,41,5,36,3.60179945900972e-06,"clothe",0.42072578022245
"791",800,124,84,40,3.8022379972852e-06,"share",0.561725505587669
"792",801,141,96,45,3.86209240442287e-06,"fine",0.603830457264725
"793",802,119,77,42,3.76696074073516e-06,"record",0.536909501998788
"794",804,74,39,35,3.62146951990179e-06,"reduce",0.434562805814237
"795",805,264,222,42,3.88435498343323e-06,"slow",0.619491205708559
"796",806,240,198,42,3.86764904952525e-06,"Christmas",0.607739313516264
"797",807,531,492,39,4.04833714551748e-06,"war",0.734845468504551
"798",808,49,20,29,3.54558379810028e-06,"he",0.381180527010904
"799",809,171,128,43,3.84498556207921e-06,"flat",0.591796543561931
"800",810,63,36,27,3.53000148260062e-06,"almost",0.370219051114559
"801",811,63,30,33,3.65921041557653e-06,"within",0.461111871532637
"802",812,223,186,37,3.90464848402023e-06,"safe",0.633766793796979
"803",813,47,8,39,3.69218954224234e-06,"commit",0.484311241487499
"804",814,49,23,26,3.49772647778944e-06,"scheme",0.347515000018936
"805",815,150,123,27,3.694249162329e-06,"complete",0.485760093934112
"806",816,74,37,37,3.59114137246241e-06,"specific",0.413228283538333
"807",817,218,177,41,3.85771214523515e-06,"dry",0.600749136936753
"808",818,41,12,29,3.31985472315731e-06,"district",0.222390017721922
"809",819,184,153,31,3.86850188396042e-06,"learn",0.608339245157033
"810",820,83,48,35,3.6694285232018e-06,"brilliant",0.468299862331768
"811",821,768,728,40,4.12129804403195e-06,"green",0.786170262336369
"812",822,117,89,28,3.74436473107973e-06,"brother",0.521014199712222
"813",823,101,55,46,3.56977117766751e-06,"soon",0.39819528827202
"814",824,28,7,21,3.49568457738921e-06,"employ",0.346078612594982
"815",825,168,129,39,3.82551080132975e-06,"yes",0.578096903059394
"816",826,181,146,35,3.77159236629705e-06,"need",0.540167647552232
"817",827,149,110,39,3.75068449992124e-06,"late",0.525459880062375
"818",828,243,211,32,3.93179128479144e-06,"now",0.652860564322904
"819",829,79,44,35,3.64947520546545e-06,"link",0.454263577966719
"820",830,37,6,31,3.56082240754325e-06,"compute",0.391900220762878
"821",831,146,103,43,3.83766669864722e-06,"club",0.586648043963126
"822",832,82,44,38,3.6479442010455e-06,"and",0.453186583469535
"823",833,62,20,42,3.59422623497613e-06,"include",0.415398349090432
"824",834,120,85,35,3.7370324972346e-06,"bill",0.515856294613873
"825",835,174,135,39,3.8433157053253e-06,"do",0.590621872534457
"826",836,64,22,42,3.69394894223772e-06,"main",0.485548902260175
"827",837,56,19,37,3.56393158676926e-06,"particular",0.394087392056139
"828",838,91,52,39,3.7074386048167e-06,"fact",0.495038288559191
"829",839,191,160,31,3.79903124703201e-06,"you",0.559469697353855
"830",840,831,791,40,4.27560553263356e-06,"white",0.894718816430895
"831",841,71,38,33,3.59057402506939e-06,"proceed",0.412829179517265
"832",842,35,13,22,3.36749091619325e-06,"Tuesday",0.255899991369209
"833",843,230,189,41,3.88248494566462e-06,"milk",0.618175716112275
"834",844,211,171,40,3.8169687161244e-06,"see",0.5720879205635
"835",845,70,30,40,3.5427449896729e-06,"dear",0.379183549722661
"836",846,51,25,26,3.22222043209976e-06,"however",0.153708573805071
"837",847,110,84,26,3.69937406590805e-06,"here",0.489365238949566
"838",848,115,77,38,3.85387642159866e-06,"piece",0.598050873499123
"839",849,147,113,34,3.72968719113528e-06,"straight",0.510689193757731
"840",850,83,42,41,3.64033491081179e-06,"vote",0.447833781346711
"841",851,103,66,37,3.62164002346823e-06,"behind",0.434682747599129
"842",852,66,29,37,3.67574084556742e-06,"strategy",0.472740304412556
"843",853,338,299,39,3.8587690526722e-06,"drink",0.601492624988715
"844",854,124,90,34,3.79348279655552e-06,"period",0.555566605662415
"845",855,69,38,31,3.67783625537424e-06,"load",0.474214333358439
"846",856,46,4,42,3.62017159613366e-06,"appoint",0.433649773338418
"847",857,51,17,34,3.55439287415317e-06,"as",0.387377325864384
"848",858,45,12,33,3.58627318077327e-06,"Saturday",0.409803724084351
"849",859,243,202,41,3.96336267542834e-06,"class",0.675069653690155
"850",860,464,425,39,4.02756465248158e-06,"wood",0.720232930225178
"851",861,91,46,45,3.73788458159989e-06,"notice",0.516455698613364
"852",862,39,8,31,3.26169562508766e-06,"since",0.181477641659591
"853",863,115,77,38,3.73834570725762e-06,"bottom",0.516780080299934
"854",864,62,26,36,3.49186395698024e-06,"suggest",0.343390973615845
"855",865,60,17,43,3.55205717391227e-06,"instead",0.385734263131363
"856",866,72,44,28,3.66423849795535e-06,"total",0.464648907077938
"857",867,97,56,41,3.70407411111482e-06,"accept",0.492671514723975
"858",868,343,310,33,4.01979346301187e-06,"stupid",0.714766239086747
"859",869,45,5,40,3.76870691896903e-06,"chap",0.538137861841826
"860",870,245,211,34,3.86010962711341e-06,"dinner",0.602435660343437
"861",871,1041,998,43,4.17266487242077e-06,"water",0.822304574420366
"862",872,109,80,29,3.68356687147298e-06,"left",0.478245570579827
"863",873,57,21,36,3.66976517172666e-06,"sir",0.468536679811874
"864",874,79,46,33,3.66669722247685e-06,"London",0.46637851199954
"865",875,191,157,34,3.83939061192208e-06,"picture",0.587860741383488
"866",876,46,11,35,3.56204005157834e-06,"non",0.392756779965604
"867",877,63,27,36,3.53473049447345e-06,"pound",0.373545703668774
"868",878,85,47,38,3.76109523093125e-06,"opportunity",0.532783372968941
"869",879,262,224,38,3.95942382464504e-06,"show",0.672298844825359
"870",880,201,156,45,3.84664207380167e-06,"suit",0.592961826944761
"871",881,74,29,45,3.66437276931308e-06,"collect",0.464743361092251
"872",882,133,102,31,3.83537055432611e-06,"dad",0.585032807085718
"873",883,172,133,39,3.88856916209112e-06,"lady",0.622455695664008
"874",884,43,17,26,3.6202633379552e-06,"role",0.433714309688332
"875",885,337,292,45,3.91930926093585e-06,"group",0.644080007695511
"876",886,85,43,42,3.74414042024232e-06,"corner",0.520856406870873
"877",887,47,14,33,3.59382580726312e-06,"nine",0.415116665747252
"878",889,50,9,41,3.7217611373702e-06,"represent",0.505113562376057
"879",890,118,86,32,3.71588354420972e-06,"birth",0.500978933234544
"880",891,224,187,37,3.84030476658628e-06,"top",0.588503809117381
"881",892,710,670,40,4.24738467288767e-06,"happy",0.874866678673474
"882",893,117,82,35,3.68565763189126e-06,"last",0.479716328884679
"883",894,56,15,41,3.68920648857637e-06,"mister",0.482212793996961
"884",895,45,14,31,3.33919919324948e-06,"therefore",0.235998004458393
"885",896,60,30,30,3.60660585929188e-06,"rail",0.424106872130275
"886",897,55,20,35,3.65402253070292e-06,"prepare",0.457462421937276
"887",898,174,140,34,3.84344864960432e-06,"kill",0.590715393007076
"888",899,116,71,45,3.84689363339104e-06,"live",0.593138788088652
"889",900,53,25,28,3.61168597112818e-06,"available",0.427680508118175
"890",901,97,64,33,3.68352616592812e-06,"even",0.478216936013359
"891",902,40,6,34,3.55916217322442e-06,"mention",0.390732318696688
"892",903,37,5,32,3.41570884497805e-06,"until",0.289819190615177
"893",904,84,40,44,3.70929512264784e-06,"must",0.496344267472121
"894",905,95,71,24,3.54535753158027e-06,"similar",0.381021358432574
"895",906,50,22,28,3.55112375311167e-06,"effect",0.385077642515054
"896",907,196,161,35,3.8258620623692e-06,"holiday",0.578343999802969
"897",908,103,63,40,3.7913254473764e-06,"experience",0.554049005083259
"898",909,101,66,35,3.66715439820163e-06,"single",0.466700115081419
"899",910,305,264,41,3.98860853402682e-06,"ball",0.692829008550856
"900",911,49,10,39,3.45159653597772e-06,"admit",0.315064608080702
"901",912,136,97,39,3.78194800577882e-06,"respect",0.547452385983638
"902",913,118,75,43,3.76703169203763e-06,"still",0.536959413129891
"903",914,58,33,25,3.51718850020048e-06,"only",0.361205679658783
"904",915,98,63,35,3.70263405386592e-06,"tape",0.491658497574921
"905",916,327,287,40,3.94957186640968e-06,"cat",0.665368424071714
"906",917,69,35,34,3.6009953151051e-06,"goodbye",0.420160100235547
"907",918,109,67,42,3.77617835645613e-06,"score",0.543393690600249
"908",919,61,15,46,3.69318496578264e-06,"settle",0.485011478313271
"909",920,161,129,32,3.68302420483507e-06,"judge",0.477863828388088
"910",921,529,488,41,4.12726844992179e-06,"book",0.7903701811645
"911",922,138,96,42,3.74208082146158e-06,"pull",0.519407569412043
"912",923,137,88,49,3.76876373243285e-06,"electric",0.538177827623178
"913",924,71,39,32,3.49288847905664e-06,"usual",0.344111679986219
"914",925,81,48,33,3.75970944965373e-06,"station",0.53180853658654
"915",926,118,72,46,3.86489860438511e-06,"environment",0.605804495927154
"916",927,226,199,27,3.89377774316642e-06,"close",0.626119704130039
"917",928,55,27,28,3.54300858116678e-06,"five",0.37936897478396
"918",929,67,42,25,3.62301775641002e-06,"west",0.435651922330153
"919",930,289,254,35,3.8630323258545e-06,"summer",0.60449165079001
"920",931,170,125,45,3.81740584368487e-06,"research",0.572395420640606
"921",932,53,23,30,3.49559904080762e-06,"region",0.346018441359367
"922",933,63,25,38,3.60353867497883e-06,"lot",0.421949242417419
"923",934,37,4,33,3.46676928303744e-06,"n",0.325737970533173
"924",935,68,33,35,3.42870857691451e-06,"if",0.298963932183496
"925",936,543,505,38,4.26834213323203e-06,"person",0.889609333346231
"926",937,75,38,37,3.57243650887215e-06,"often",0.400070231938514
"927",938,59,23,36,3.59888290674575e-06,"grant",0.418674113553096
"928",939,68,27,41,3.7074935860361e-06,"local",0.495076965436907
"929",940,102,59,43,3.83782871002901e-06,"product",0.586762011868376
"930",941,155,114,41,3.76193002057776e-06,"make",0.533370610891889
"931",943,147,117,30,3.75131765032468e-06,"past",0.525905273616769
"932",944,437,395,42,3.99090074629844e-06,"tree",0.694441479403807
"933",945,204,156,48,3.86709565647816e-06,"machine",0.607350025765865
"934",946,890,842,48,4.42526828188959e-06,"love",1
"935",947,258,216,42,3.92416935145253e-06,"room",0.647498868329786
"936",948,87,51,36,3.70783725560718e-06,"front",0.495318721915256
"937",949,103,68,35,3.6964340500719e-06,"post",0.487297066685721
"938",950,131,92,39,3.70296311108149e-06,"design",0.491889974901705
"939",951,60,30,30,3.59527293514487e-06,"tomorrow",0.416134656776575
"940",952,43,9,34,3.58833217908648e-06,"any",0.411252139140596
"941",953,97,59,38,3.6483168490217e-06,"tax",0.453448724985606
"942",954,74,28,46,3.66095192071843e-06,"due",0.462336944060318
"943",955,486,453,33,4.10202558023152e-06,"home",0.772612928869702
"944",956,49,13,36,3.44248299413401e-06,"quarter",0.308653630889773
"945",957,59,27,32,3.57389200413142e-06,"address",0.401094109051137
"946",958,109,72,37,3.74764835065996e-06,"wide",0.523324082148008
"947",959,182,143,39,3.84502991433273e-06,"tea",0.591827743428082
"948",960,93,53,40,3.69138541385968e-06,"motion",0.483745572419616
"949",961,114,85,29,3.71352391138046e-06,"south",0.499319034974704
"950",963,343,298,45,3.98660500717589e-06,"art",0.691419615236709
"951",964,127,91,36,3.74223486265998e-06,"Europe",0.519515930642652
"952",965,405,356,49,4.15116896918172e-06,"body",0.807183148774077
"953",966,60,18,42,3.65788530334843e-06,"toward",0.460179713167048
"954",967,54,21,33,3.53743132961431e-06,"require",0.375445622798075
"955",968,54,16,38,3.67430922986479e-06,"county",0.471733225521255
"956",969,85,48,37,3.71879927409038e-06,"pack",0.503030021393283
"957",970,39,13,26,3.49963603785206e-06,"propose",0.348858291816588
"958",971,801,753,48,4.16049526535639e-06,"car",0.813743789310656
"959",972,74,42,32,3.70583112527562e-06,"son",0.493907497166613
"960",973,172,133,39,3.72285572817197e-06,"speak",0.505883559023227
"961",974,81,41,40,3.63109524725943e-06,"Scotland",0.441334083062343
"962",975,42,5,37,3.54290816073466e-06,"m",0.379298333411933
"963",976,330,293,37,3.89913712095513e-06,"sound",0.629889791473713
"964",977,69,38,31,3.62002743980799e-06,"discuss",0.43354836568247
"965",978,46,13,33,3.59192821890647e-06,"weigh",0.413781795519971
"966",979,255,220,35,4.0255218082644e-06,"world",0.718795878867362
"967",980,91,55,36,3.70448576180897e-06,"decide",0.492961092942427
"968",981,480,452,28,4.117479937579e-06,"blue",0.7834843918151
"969",982,82,42,40,3.71701612813298e-06,"issue",0.501775656377239
"970",983,92,66,26,3.68671749421185e-06,"why",0.480461895567686
"971",984,840,809,31,4.38208254090674e-06,"man",0.969620724284537
"972",985,86,52,34,3.62307026220159e-06,"cause",0.435688857852909
"973",986,77,38,39,3.61138597771053e-06,"without",0.427469475899197
"974",987,152,114,38,3.74986875459359e-06,"foot",0.524886038982932
"975",988,72,43,29,3.57605189566511e-06,"spend",0.402613498065292
"976",990,93,50,43,3.73295904197339e-06,"union",0.512990797399321
"977",991,100,64,36,3.65110080689328e-06,"degree",0.455407117312239
"978",992,127,82,45,3.78400877890037e-06,"roll",0.548902049539752
"979",993,99,62,37,3.74300525892239e-06,"send",0.520057870642597
"980",994,78,43,35,3.59386455443267e-06,"achieve",0.415143922682532
"981",995,163,131,32,3.78773531305632e-06,"window",0.551523502964202
"982",996,76,38,38,3.62981676684961e-06,"by",0.440434728136785
"983",997,84,52,32,3.680367447886e-06,"choose",0.475994916334523
"984",998,87,50,37,3.6444476839535e-06,"video",0.450726936966677
"985",999,62,21,41,3.80630476320978e-06,"marry",0.564586297147135
"986",1000,83,42,41,3.79463438697681e-06,"treat",0.556376699043324
"987",1001,82,48,34,3.67434973195619e-06,"disorder",0.471761716967129
"988",1002,35,8,27,3.56751704381268e-06,"trot",0.396609603916094
"989",1003,39,9,30,3.62048615888141e-06,"ballroom",0.433871054442469
"990",1004,242,209,33,3.91751284944215e-06,"earth",0.642816310956177
"991",1005,306,266,40,3.90303304698081e-06,"building",0.632630404653143
"992",1006,90,49,41,3.69454943122411e-06,"uncertain",0.485971319939404
"993",1007,37,3,34,3.55296583823347e-06,"designate",0.386373468649623
"994",1008,76,40,36,3.50976944324527e-06,"whale",0.355986698308424
"995",1009,105,66,39,3.69762316782772e-06,"tower",0.488133558901443
"996",1010,61,28,33,3.72532438262062e-06,"servant",0.507620149213298
"997",1011,62,26,36,3.6895195507641e-06,"blame",0.482433019522808
"998",1012,96,68,28,3.71403422111131e-06,"plate",0.499678015500704
"999",1013,90,53,37,3.64563016540224e-06,"joint",0.451558760831273
"1000",1014,46,20,26,3.4557116001327e-06,"owe",0.317959375328083
"1001",1015,87,46,41,3.6556388228843e-06,"prize",0.458599412635993
"1002",1016,43,12,31,3.63158315235944e-06,"invitation",0.441677302912664
"1003",1017,84,50,34,3.76068504638805e-06,"delicate",0.532494826123421
"1004",1018,65,27,38,3.6312666584358e-06,"fasten",0.441454663311031
"1005",1019,259,213,46,3.93643445639808e-06,"smooth",0.656126832012707
"1006",1020,38,6,32,3.55401390330239e-06,"seize",0.387110736483217
"1007",1021,76,43,33,3.75593907866814e-06,"frame",0.529156245874052
"1008",1022,61,32,29,3.60469475444819e-06,"bigger",0.422762493646864
"1009",1023,52,18,34,3.68257662521313e-06,"kin",0.477548975743899
"1010",1024,178,147,31,3.83262174322967e-06,"dumb",0.583099138974723
"1011",1025,41,22,19,3.30772055053701e-06,"nearly",0.213854159190337
"1012",1026,81,46,35,3.67147630062048e-06,"oops",0.469740383980586
"1013",1027,65,18,47,3.67034435170708e-06,"restrict",0.468944107539487
"1014",1028,48,17,31,3.62444908373927e-06,"blog",0.436658798363415
"1015",1029,59,26,33,3.60717828478673e-06,"disc",0.424509548373376
"1016",1030,68,19,49,3.63418312648774e-06,"enclosed",0.443506270740915
"1017",1031,66,22,44,3.62080077629969e-06,"urgent",0.43409237400483
"1018",1032,76,34,42,3.64146168271944e-06,"constant",0.448626415991199
"1019",1033,48,6,42,3.6410904337631e-06,"facing",0.448365258624275
"1020",1034,59,26,33,3.58202111959652e-06,"costume",0.406812585437481
"1021",1035,71,37,34,3.65827336813571e-06,"hood",0.460452699733908
"1022",1036,79,49,30,3.6393942592195e-06,"bake",0.447172074185405
"1023",1037,169,131,38,3.82848392036753e-06,"soldier",0.580188361974495
"1024",1038,106,70,36,3.66629392678411e-06,"spoon",0.466094811158339
"1025",1039,77,39,38,3.58057181731923e-06,"ownership",0.405793064816206
"1026",1040,45,16,29,3.53453059666411e-06,"completely",0.373405084322512
"1027",1041,122,85,37,3.64868957313981e-06,"furry",0.453710920064165
"1028",1042,75,38,37,3.72320225179272e-06,"bounce",0.506127323200414
"1029",1043,79,41,38,3.71486204859783e-06,"chess",0.500260355849283
"1030",1044,70,36,34,3.67829621319405e-06,"bound",0.474537893522221
"1031",1045,131,86,45,3.74058308209084e-06,"construction",0.518353975418787
"1032",1046,32,11,21,3.46816398866604e-06,"swap",0.326719084805354
"1033",1047,126,94,32,3.69319860544821e-06,"soap",0.485021073220096
"1034",1048,66,31,35,3.71609067261241e-06,"commitment",0.50112463898627
"1035",1049,162,126,36,3.85582306399124e-06,"hungry",0.599420251090373
"1036",1050,93,61,32,3.67905404162482e-06,"bum",0.475070992603524
"1037",1051,62,29,33,3.55124986238907e-06,"cure",0.385166354863646
"1038",1052,53,18,35,3.71859184364065e-06,"sensation",0.502884103164702
"1039",1053,242,199,43,3.88453605043682e-06,"clothing",0.619618578408432
"1040",1054,75,43,32,3.52636664339265e-06,"entrance",0.367662101066525
"1041",1055,40,15,25,3.54913241458126e-06,"cork",0.383676823150107
"1042",1056,58,19,39,3.63201842159743e-06,"sequence",0.441983495741375
"1043",1057,69,31,38,3.70040075340159e-06,"butterfly",0.490087468595976
"1044",1058,39,6,33,3.44746749038157e-06,"domain",0.312160005502342
"1045",1059,96,63,33,3.75617891431405e-06,"naive",0.529324959737643
"1046",1060,64,18,46,3.63961944139121e-06,"prove",0.447330479972245
"1047",1061,166,133,33,3.82917293693735e-06,"cry",0.580673054928016
"1048",1062,64,15,49,3.69141266671342e-06,"tab",0.483764743607587
"1049",1063,52,18,34,3.59257343220095e-06,"stance",0.414235674789429
"1050",1064,42,6,36,3.67430922986479e-06,"daytime",0.471733225521255
"1051",1065,37,10,27,3.47765605981568e-06,"groom",0.333396340770011
"1052",1066,41,8,33,3.57033196946652e-06,"beware",0.398589780720068
"1053",1067,184,138,46,3.83281270960695e-06,"boss",0.583233475450038
"1054",1068,129,84,45,3.82479384361183e-06,"mystery",0.577592554732995
"1055",1069,63,19,44,3.64520491519431e-06,"abstract",0.451259615951022
"1056",1070,83,47,36,3.65979966256647e-06,"dish",0.461526380960162
"1057",1071,70,36,34,3.43576493870595e-06,"ant",0.303927773385054
"1058",1072,77,37,40,3.65507763384894e-06,"chat",0.458204640749589
"1059",1073,79,51,28,3.68818600259648e-06,"knee",0.481494926843561
"1060",1074,171,132,39,3.79404410955682e-06,"gift",0.555961464753427
"1061",1075,53,26,27,3.67046559856118e-06,"petrol",0.469029399386437
"1062",1076,146,98,48,3.80840667689859e-06,"foreign",0.566064901288898
"1063",1077,44,14,30,3.51029921790533e-06,"inquiry",0.356359371558871
"1064",1078,73,41,32,3.73956194771344e-06,"dude",0.517635652146168
"1065",1079,216,189,27,3.84776694845147e-06,"female",0.593753126951514
"1066",1080,36,4,32,3.61549892077357e-06,"partition",0.43036275105138
"1067",1081,149,108,41,3.78496837658921e-06,"liar",0.549577084449468
"1068",1082,85,46,39,3.73319595172231e-06,"coal",0.513157453022642
"1069",1083,50,16,34,3.61132076834461e-06,"vital",0.427423603968754
"1070",1084,124,84,40,3.70476024644065e-06,"waiting",0.493154180848657
"1071",1085,60,23,37,3.62059102527897e-06,"linen",0.433944823356282
"1072",1086,148,118,30,3.77283033959246e-06,"unhappy",0.541038507498448
"1073",1087,63,25,38,3.67950076533616e-06,"clip",0.475385243152123
"1074",1088,201,156,45,3.75478265440605e-06,"sticky",0.528342752098036
"1075",1089,76,32,44,3.71702994439323e-06,"heal",0.501785375510685
"1076",1090,404,358,46,4.05972669919861e-06,"smart",0.742857520253126
"1077",1091,156,119,37,3.76188756470447e-06,"thief",0.5333407450461
"1078",1092,130,90,40,3.76430907988993e-06,"duck",0.535044174830891
"1079",1093,100,67,33,3.63520037224452e-06,"feathers",0.444221858539391
"1080",1094,61,23,38,3.70336079992593e-06,"destination",0.492169731570906
"1081",1095,112,77,35,3.69791031088332e-06,"posh",0.488335551454015
"1082",1096,74,44,30,3.68877101216188e-06,"target",0.481906455428665
"1083",1097,66,25,41,3.65075424582719e-06,"manipulate",0.455163326793902
"1084",1098,50,18,32,3.66759823661877e-06,"mill",0.467012335952025
"1085",1099,49,13,36,3.54039949867943e-06,"weekly",0.377533599624387
"1086",1100,47,12,35,3.53394352758243e-06,"attachment",0.372992106957982
"1087",1101,36,2,34,3.65362201818773e-06,"existential",0.457180678939479
"1088",1103,236,190,46,3.88805511706934e-06,"shiny",0.622094087524577
"1089",1104,52,9,43,3.82622802788555e-06,"far away",0.578601440501459
"1090",1105,54,23,31,3.6425891523695e-06,"drag",0.449419541466889
"1091",1106,49,15,34,3.5784448794243e-06,"frequent",0.404296857242385
"1092",1107,67,27,40,3.58395963027872e-06,"presentation",0.408176242726941
"1093",1108,57,22,35,3.68709810630641e-06,"clutter",0.480729639491909
"1094",1109,78,39,39,3.67538959129668e-06,"tense",0.472493212430471
"1095",1110,97,69,28,3.71096069350433e-06,"soccer",0.497515923558631
"1096",1111,35,6,29,3.40199697222269e-06,"chuckle",0.280173489197761
"1097",1112,67,34,33,3.67690316507824e-06,"aged",0.473557945237631
"1098",1113,64,23,41,3.70592726005974e-06,"description",0.493975123773129
"1099",1114,59,19,40,3.64018914422793e-06,"consumer",0.447731240944707
"1100",1115,57,28,29,3.5672116176948e-06,"algebra",0.396394750030654
"1101",1116,58,26,32,3.60808933629197e-06,"central",0.425150433170969
"1102",1117,48,14,34,3.58406239135811e-06,"apologize",0.408248530641711
"1103",1118,68,33,35,3.58708362926773e-06,"horizon",0.410373839073837
"1104",1119,67,36,31,3.59056113289385e-06,"conclusion",0.412820110436907
"1105",1120,166,127,39,3.84086527012805e-06,"rough",0.588898098789102
"1106",1121,65,29,36,3.6539290699289e-06,"fame",0.45739667637964
"1107",1122,71,42,29,3.71831530570129e-06,"mate",0.502689570846527
"1108",1123,48,15,33,3.62844702467344e-06,"significant",0.439471174559101
"1109",1124,71,32,39,3.72964545990258e-06,"unable",0.510659837664835
"1110",1125,75,39,36,3.65288797323164e-06,"scare",0.456664310490052
"1111",1126,100,69,31,3.70427992502537e-06,"exam",0.49281629578811
"1112",1127,77,42,35,3.68984628100393e-06,"solve",0.482662859924167
"1113",1128,44,9,35,3.58802317862973e-06,"bureau",0.411034770864445
"1114",1129,134,94,40,3.69899091527831e-06,"wound",0.489095709277122
"1115",1130,178,146,32,3.81385344123996e-06,"gone",0.569896461241741
"1116",1131,98,65,33,3.69534128324421e-06,"dishonest",0.486528353124362
"1117",1132,73,40,33,3.61386567984041e-06,"sum",0.429213837648737
"1118",1133,70,30,40,3.6482103704028e-06,"marketing",0.453373821944744
"1119",1134,52,21,31,3.64017589329916e-06,"giggle",0.447721919497178
"1120",1135,85,44,41,3.67709244945836e-06,"pollution",0.473691098501681
"1121",1136,70,24,46,3.76894838802077e-06,"compromise",0.538307724734824
"1122",1137,36,6,30,3.51414795968569e-06,"compel",0.359066792690064
"1123",1138,82,41,41,3.74118483323669e-06,"lecture",0.518777280971866
"1124",1139,123,86,37,3.76314749656613e-06,"psychology",0.534227051881112
"1125",1140,130,88,42,3.80765262023615e-06,"gym",0.56553445548128
"1126",1141,29,4,25,3.47838185676024e-06,"ergo",0.333906907104874
"1127",1142,88,50,38,3.72232913578684e-06,"rhythm",0.505513124363703
"1128",1143,112,72,40,3.81693957784648e-06,"partner",0.572067423062272
"1129",1144,28,5,23,3.55242310780183e-06,"notion",0.385991681581796
"1130",1145,78,46,32,3.71060267608665e-06,"snap",0.497264073999141
"1131",1146,42,9,33,3.45563994996233e-06,"broadcast",0.317908972574048
"1132",1147,56,24,32,3.5153709595205e-06,"deck",0.359927119463116
"1133",1148,125,76,49,3.76177435372717e-06,"button",0.533261106086223
"1134",1149,75,34,41,3.77465320373691e-06,"tension",0.542320812518014
"1135",1150,40,15,25,3.4775109367719e-06,"frosting",0.333294253070238
"1136",1151,70,43,27,3.66028191491309e-06,"exchange",0.461865624346262
"1137",1152,69,40,29,3.68000176640085e-06,"bunny",0.475737675439529
"1138",1153,38,2,36,3.44921547594e-06,"propel",0.313389636718982
"1139",1154,49,11,38,3.57771512801065e-06,"launch",0.403783509111855
"1140",1155,167,141,26,3.69867624377235e-06,"upset",0.488874351666445
"1141",1156,180,138,42,3.85659632234975e-06,"friendly",0.599964204449462
"1142",1157,256,218,38,3.89341390104499e-06,"crazy",0.625863757146794
"1143",1158,46,11,35,3.57367488135399e-06,"conclude",0.400941372694891
"1144",1159,29,9,20,3.41457751432415e-06,"tote",0.289023349092534
"1145",1160,54,10,44,3.62064346075585e-06,"set up",0.433981709415734
"1146",1161,39,4,35,3.60552655109752e-06,"alibi",0.423347626127495
"1147",1162,67,35,32,3.66909193643665e-06,"companion",0.468063088296917
"1148",1163,28,3,25,3.26981178963339e-06,"supervise",0.187187007641866
"1149",1164,41,11,30,3.43897876086717e-06,"sufficient",0.306188556396162
"1150",1165,47,18,29,3.49497597204019e-06,"erect",0.345580139793973
"1151",1166,67,27,40,3.5706251807629e-06,"laboratory",0.398796042014024
"1152",1167,100,55,45,3.74767644060682e-06,"helper",0.523343842194291
"1153",1168,109,68,41,3.74044316770651e-06,"spice",0.518255551782623
"1154",1169,56,25,31,3.67905404162482e-06,"wallet",0.475070992603524
"1155",1170,39,4,35,3.59311559052855e-06,"discrete",0.414617059407142
"1156",1171,51,17,34,3.43861217612572e-06,"truly",0.305930680099951
"1157",1172,151,113,38,3.77858975473174e-06,"style",0.545090003582433
"1158",1173,45,16,29,3.40273784286837e-06,"incline",0.280694659220604
"1159",1174,41,9,32,3.61322585190833e-06,"seconds",0.428763746745654
"1160",1175,48,25,23,3.69699434359865e-06,"buddy",0.487691208621082
"1161",1176,47,12,35,3.52328539316342e-06,"ton",0.365494576598222
"1162",1177,63,27,36,3.60313616972213e-06,"senior",0.421666097613324
"1163",1178,74,43,31,3.61795809680932e-06,"cage",0.432092673593466
"1164",1179,91,55,36,3.65052768377669e-06,"bold",0.455003950322824
"1165",1180,56,21,35,3.7149310508797e-06,"smog",0.500308895929833
"1166",1181,83,42,41,3.7537396631394e-06,"congress",0.527609053461931
"1167",1182,34,4,30,3.56904495925935e-06,"disclose",0.397684425455984
"1168",1183,276,242,34,3.88909846808411e-06,"knowledge",0.62282803922772
"1169",1184,95,60,35,3.7314825180044e-06,"nut",0.511952127511216
"1170",1185,66,29,37,3.72130409380663e-06,"disappointment",0.504792052263791
"1171",1186,46,9,37,3.52102757668798e-06,"suitable",0.363906301680132
"1172",1187,54,22,32,3.52712535756233e-06,"drawer",0.368195823226329
"1173",1188,103,70,33,3.745991788786e-06,"theory",0.522158763485795
"1174",1189,55,17,38,3.62823638685708e-06,"pose",0.439323000088691
"1175",1190,89,43,46,3.67973093807381e-06,"farmer",0.475547159583336
"1176",1191,32,4,28,3.51696584322773e-06,"dual",0.361049050238721
"1177",1192,140,101,39,3.84136691200197e-06,"cruel",0.589250981857707
"1178",1193,55,20,35,3.67776862422031e-06,"construct",0.474166757806294
"1179",1194,36,5,31,3.53466802397919e-06,"visualize",0.373501758414483
"1180",1195,82,44,38,3.70756231485361e-06,"device",0.495125313147268
"1181",1196,86,54,32,3.75359876281385e-06,"pregnant",0.527509936259331
"1182",1197,50,22,28,3.46347934207746e-06,"hi",0.323423641283837
"1183",1198,93,54,39,3.87235179541591e-06,"irritating",0.611047489103408
"1184",1199,33,2,31,3.45838866755201e-06,"earner",0.319842574907142
"1185",1200,31,2,29,3.65163410626255e-06,"traverse",0.455782270041111
"1186",1201,53,20,33,3.52355851221265e-06,"certainty",0.365686703877066
"1187",1202,108,66,42,3.80798610846668e-06,"avoid",0.565769049832851
"1188",1203,90,47,43,3.61539434913863e-06,"lucky",0.430289189490144
"1189",1204,47,9,38,3.68896152044238e-06,"stake",0.482040469652984
"1190",1205,42,6,36,3.57592401876645e-06,"indent",0.402523542272624
"1191",1206,81,45,36,3.68843086774025e-06,"basket",0.481667178738427
"1192",1207,63,29,34,3.77456771763214e-06,"chalk",0.542260676790631
"1193",1208,112,75,37,3.68856691798103e-06,"bowl",0.481762884118993
"1194",1209,132,89,43,3.84445341483575e-06,"uncomfortable",0.59142220130306
"1195",1210,55,21,34,3.54159067003354e-06,"hypothesis",0.378371536456481
"1196",1211,57,18,39,3.53986060028956e-06,"hesitant",0.377154508229961
"1197",1212,59,19,40,3.60494165401933e-06,"deliver",0.422936176672207
"1198",1213,47,12,35,3.61943782891641e-06,"hallway",0.433133600266096
"1199",1214,97,65,32,3.7053917154852e-06,"diet",0.493598391640775
"1200",1215,50,18,32,3.56349978440826e-06,"garment",0.393783638023424
"1201",1216,58,22,36,3.59934923765783e-06,"column",0.419002156907927
"1202",1217,47,12,35,3.66046949181702e-06,"meticulous",0.461997576475663
"1203",1218,82,34,48,3.67691668474484e-06,"robe",0.473567455730441
"1204",1219,82,47,35,3.66501740883269e-06,"narrow",0.465196836736243
"1205",1220,56,25,31,3.60479870804014e-06,"appliance",0.42283562044195
"1206",1221,36,6,30,3.42645290169164e-06,"additionally",0.297377163542727
"1207",1222,45,18,27,3.58131556045798e-06,"conscious",0.406316255512011
"1208",1223,49,15,34,3.60449985762226e-06,"arrangement",0.422625392273205
"1209",1224,71,28,43,3.78665959823542e-06,"blond",0.550766784742126
"1210",1225,59,28,31,3.6223221983149e-06,"owl",0.435162627700326
"1211",1226,113,80,33,3.74107286487619e-06,"basketball",0.518698516138439
"1212",1227,74,32,42,3.6205123749113e-06,"erase",0.433889496270301
"1213",1228,132,97,35,3.80303329935957e-06,"fence",0.562284965734569
"1214",1229,63,33,30,3.65585265451461e-06,"eager",0.458749833814515
"1215",1230,139,103,36,3.70595472805704e-06,"mud",0.49399444630516
"1216",1231,89,51,38,3.67237966529932e-06,"cough",0.47037586143276
"1217",1232,32,4,28,3.48728535758624e-06,"cohort",0.340170129647089
"1218",1233,84,47,37,3.6884580769855e-06,"tent",0.481686319249732
"1219",1234,162,118,44,3.81622582897966e-06,"lies",0.571565332021955
"1220",1235,44,9,35,3.61030380706536e-06,"encounter",0.426708216287753
"1221",1236,29,3,26,3.12611367799779e-06,"alternatively",0.0861016851762162
"1222",1237,100,68,32,3.6816004653543e-06,"airport",0.476862290073609
"1223",1238,52,26,26,3.54630049931911e-06,"mop",0.38168469490144
"1224",1239,83,57,26,3.64773129352199e-06,"shout",0.453036812359643
"1225",1240,81,39,42,3.65819307211396e-06,"gap",0.46039621500242
"1226",1241,52,16,36,3.59593228140328e-06,"absorb",0.41659847796663
"1227",1242,85,36,49,3.7620573939476e-06,"massage",0.533460212474107
"1228",1243,33,11,22,3.56719889274146e-06,"abode",0.396385798583788
"1229",1244,33,10,23,3.55268814148225e-06,"debit",0.386178121158104
"1230",1245,350,314,36,3.9124242945899e-06,"angry",0.639236735676665
"1231",1246,102,69,33,3.57114798123005e-06,"mammal",0.399163809225473
"1232",1247,49,21,28,3.56503696943337e-06,"horrid",0.394864980305406
"1233",1248,42,15,27,3.44699215464586e-06,"duplicate",0.311825627648821
"1234",1249,43,14,29,3.5857845158653e-06,"locate",0.409459969742436
"1235",1250,80,37,43,3.70077050041819e-06,"sensitive",0.490347569414127
"1236",1251,170,136,34,3.71879927409038e-06,"theater",0.503030021393283
"1237",1252,88,56,32,3.67283825922158e-06,"golf",0.470698462154404
"1238",1253,53,19,34,3.79418806272552e-06,"surround",0.556062729497357
"1239",1254,80,30,50,3.74825237732907e-06,"pocket",0.523748988431952
"1240",1255,58,34,24,3.62892104919365e-06,"observe",0.439804630029998
"1241",1256,45,14,31,3.47771653132553e-06,"clover",0.333438879826393
"1242",1257,206,164,42,3.73968781086155e-06,"chicken",0.517724191353593
"1243",1258,85,47,38,3.68531806137529e-06,"myth",0.479477455911916
"1244",1259,107,72,35,3.67025005413619e-06,"payment",0.468877773331942
"1245",1260,47,21,26,3.56291574773131e-06,"auto",0.393372793822695
"1246",1261,111,72,39,3.7238816252509e-06,"disaster",0.506605232647604
"1247",1262,41,10,31,3.49013339289828e-06,"DVD",0.342173597644225
"1248",1263,79,38,41,3.71429632656093e-06,"romantic",0.499862395195004
"1249",1264,49,18,31,3.68054354267038e-06,"shove",0.476118791296145
"1250",1265,115,88,27,3.79125357799556e-06,"library",0.553998448124265
"1251",1266,126,84,42,3.72221829321402e-06,"elderly",0.505435151472557
"1252",1267,46,20,26,3.67233920662784e-06,"satisfied",0.470347400530898
"1253",1268,75,40,35,3.70517204966413e-06,"unexpected",0.493443866364796
"1254",1269,46,18,28,3.61188164586223e-06,"source",0.427818156716089
"1255",1270,68,32,36,3.64148820339897e-06,"dice",0.448645072126697
"1256",1271,139,97,42,3.83810858009173e-06,"bike",0.58695888818927
"1257",1272,199,164,35,3.92501648506924e-06,"tall",0.648094789694664
"1258",1273,52,25,27,3.71204893965322e-06,"hen",0.498281457020623
"1259",1274,73,42,31,3.80326472243774e-06,"fever",0.56244776172553
"1260",1275,56,17,39,3.70466417219279e-06,"paid",0.493086596826743
"1261",1276,57,29,28,3.60786803861862e-06,"corporation",0.42499475995845
"1262",1277,125,87,38,3.77791882008039e-06,"uniform",0.544618030465927
"1263",1278,101,58,43,3.774966685919e-06,"philosophy",0.542541333491485
"1264",1279,134,91,43,3.84439429645662e-06,"sunshine",0.591380614114827
"1265",1280,40,4,36,3.46858502542473e-06,"compartment",0.32701526570876
"1266",1281,75,38,37,3.67695724434116e-06,"trail",0.473595987628506
"1267",1282,60,26,34,3.62893421830942e-06,"wander",0.439813893925669
"1268",1283,290,243,47,3.90983911012062e-06,"government",0.637418171725225
"1269",1284,43,7,36,3.48320399035849e-06,"accumulate",0.337299066710897
"1270",1285,36,8,28,3.3496236697807e-06,"among",0.243331166736591
"1271",1286,45,7,38,3.61740841626242e-06,"triple",0.43170599742421
"1272",1287,53,18,35,3.47473175070885e-06,"leaving",0.331339217501727
"1273",1288,172,127,45,3.76518782639472e-06,"lawyer",0.535662334476769
"1274",1289,40,7,33,3.68852610185496e-06,"inexpensive",0.481734171763499
"1275",1290,41,10,31,3.53218348986793e-06,"reign",0.371753997577861
"1276",1291,117,84,33,3.74523418949387e-06,"shock",0.52162582559348
"1277",1292,177,140,37,3.86268912691638e-06,"airplane",0.604250225381315
"1278",1293,225,188,37,3.8022090834775e-06,"nose",0.5617051659914
"1279",1294,56,28,28,3.49110814754819e-06,"gamble",0.342859294811643
"1280",1295,45,13,32,3.69658435605501e-06,"reflect",0.48740280035611
"1281",1296,39,7,32,3.65493068423957e-06,"bid",0.458101268140998
"1282",1297,42,12,30,3.71198004439528e-06,"deceased",0.498232992226716
"1283",1298,52,25,27,3.501792917974e-06,"rapid",0.350375562434582
"1284",1299,102,73,29,3.69867624377235e-06,"soil",0.488874351666445
"1285",1300,40,6,34,3.51623622074931e-06,"amazement",0.360535792808474
"1286",1301,45,16,29,3.57884188676544e-06,"trying",0.404576134503888
"1287",1302,72,35,37,3.71198004439528e-06,"crook",0.498232992226716
"1288",1303,85,45,40,3.61455799377573e-06,"overcome",0.429700850154348
"1289",1304,90,56,34,3.71873012803588e-06,"mold",0.502981380174988
"1290",1305,150,112,38,3.75179617241755e-06,"Africa",0.526241892932876
"1291",1306,45,17,28,3.40932723745623e-06,"inch",0.285330009464151
"1292",1307,269,230,39,3.87577370132513e-06,"sharp",0.613454649909791
"1293",1308,56,20,36,3.59463967331915e-06,"dismiss",0.415689184841489
"1294",1309,58,14,44,3.74370589446493e-06,"surroundings",0.520550737034108
"1295",1310,26,8,18,3.27795770123382e-06,"nil",0.19291729937315
"1296",1311,92,68,24,3.68284787260293e-06,"yell",0.477739786392373
"1297",1312,59,16,43,3.64395631625168e-06,"disbelief",0.450381281327769
"1298",1313,61,17,44,3.68538597047269e-06,"engage",0.479525226985112
"1299",1314,84,50,34,3.7879935755629e-06,"lamp",0.551705179316525
"1300",1315,56,21,35,3.43949920891518e-06,"thank you",0.306554668783868
"1301",1316,102,61,41,3.73297297700862e-06,"practice",0.513000600085755
"1302",1317,60,18,42,3.6247249739926e-06,"category",0.43685287506286
"1303",1318,75,42,33,3.69564172970816e-06,"cane",0.486739704041542
"1304",1319,71,26,45,3.64128930771808e-06,"nerve",0.448505157733872
"1305",1320,48,13,35,3.6254083116111e-06,"ally",0.437333573123067
"1306",1321,61,24,37,3.68561688012531e-06,"loyalty",0.479687661803706
"1307",1322,36,8,28,3.65024785182914e-06,"rely",0.454807100814278
"1308",1323,119,83,36,3.73500860919484e-06,"beef",0.514432578095931
"1309",1324,78,34,44,3.66591759750424e-06,"countries",0.465830080006513
"1310",1325,68,32,36,3.71293102488035e-06,"deceive",0.498901965311315
"1311",1326,67,29,38,3.6757948906451e-06,"eliminate",0.472778322755613
"1312",1327,62,20,42,3.77051158301158e-06,"architect",0.539407363887517
"1313",1328,132,99,33,3.7025380898606e-06,"bathroom",0.491590991103802
"1314",1329,107,66,41,3.7822770064034e-06,"random",0.547683823501142
"1315",1330,30,10,20,3.47164361495306e-06,"peculiar",0.329166849367325
"1316",1331,226,193,33,3.77746214982926e-06,"different",0.544296782962595
"1317",1332,54,20,34,3.69773255040009e-06,"folder",0.488210504746275
"1318",1333,63,24,39,3.61939852835256e-06,"exclusive",0.433105954042182
"1319",1334,78,48,30,3.78731929752802e-06,"loyal",0.551230854276262
"1320",1335,42,8,34,3.55357187276791e-06,"crouch",0.386799787378816
"1321",1336,43,8,35,3.66613263334641e-06,"confidant",0.465981348295286
"1322",1337,223,177,46,3.90352058521581e-06,"lazy",0.63297336643001
"1323",1338,48,16,32,3.57614141493611e-06,"bedtime",0.402676470948325
"1324",1339,78,38,40,3.75778801566246e-06,"rigid",0.530456892000587
"1325",1340,54,11,43,3.57592401876645e-06,"fellow",0.402523542272624
"1326",1341,57,29,28,3.48974364343195e-06,"them",0.341899425979506
"1327",1342,61,30,31,3.68674467818406e-06,"fate",0.480481018300509
"1328",1343,59,29,30,3.57113522817769e-06,"acquire",0.399154838012173
"1329",1344,64,33,31,3.65114079894263e-06,"sharing",0.455435249965889
"1330",1345,56,19,37,3.66918617450649e-06,"halo",0.468129380648085
"1331",1346,224,190,34,3.8720519164721e-06,"football",0.610836537411761
"1332",1347,76,26,50,3.80272959930638e-06,"loved",0.562071326059978
"1333",1348,42,10,32,3.69487705296606e-06,"cot",0.486201787473421
"1334",1349,44,22,22,3.57509304179641e-06,"palm",0.401938986400445
"1335",1350,75,44,31,3.66653589355313e-06,"fitness",0.466265024173625
"1336",1351,70,34,36,3.74630052822837e-06,"meter",0.522375948149777
"1337",1352,337,301,36,3.89740471819815e-06,"wet",0.628671122074815
"1338",1353,45,5,40,3.6868534180818e-06,"homeland",0.480557512051914
"1339",1354,75,43,32,3.61577345009871e-06,"dollar",0.430555870397501
"1340",1355,85,47,38,3.71356528262089e-06,"escape",0.499348137828814
"1341",1356,70,40,30,3.61793191775717e-06,"bass",0.432074257777849
"1342",1357,63,23,40,3.66087150707097e-06,"rural",0.462280376584303
"1343",1358,38,12,26,3.75846594454008e-06,"canoe",0.530933785248678
"1344",1359,86,47,39,3.7423469005883e-06,"relief",0.519594744413991
"1345",1360,86,45,41,3.80516055874978e-06,"landscape",0.563781399466228
"1346",1361,43,17,26,3.54418894780119e-06,"dispute",0.38019931096937
"1347",1362,36,9,27,3.47422472675223e-06,"farewell",0.330982548373863
"1348",1363,110,72,38,3.76981509056981e-06,"rabbit",0.538917411985781
"1349",1364,61,29,32,3.69849840964568e-06,"endless",0.48874925315377
"1350",1365,73,36,37,3.55412758607208e-06,"kingdom",0.387190707328363
"1351",1366,45,18,27,3.61848175742422e-06,"define",0.432461045881153
"1352",1367,80,33,47,3.74482745707492e-06,"countryside",0.521339707166041
"1353",1368,37,4,33,3.43715843238078e-06,"billion",0.304908035100887
"1354",1369,39,3,36,3.56936343972416e-06,"cope",0.397908462502244
"1355",1370,183,155,28,3.78555583316298e-06,"weather",0.549990334397698
"1356",1372,81,44,37,3.8099302020787e-06,"adult",0.567136634468709
"1357",1373,40,5,35,3.57825281071758e-06,"accompany",0.404161745326626
"1358",1374,97,63,34,3.63646942456508e-06,"deny",0.445114581217438
"1359",1375,129,90,39,3.78931413414172e-06,"walking",0.552634134389461
"1360",1376,54,28,26,3.60433096408645e-06,"season",0.422506583074286
"1361",1377,48,17,31,3.61539434913863e-06,"vessel",0.430289189490144
"1362",1378,48,17,31,3.54568437026873e-06,"etiquette",0.381251275122784
"1363",1379,37,14,23,3.53574282420994e-06,"lone",0.374257833262475
"1364",1380,54,12,42,3.7396598405409e-06,"maiden",0.517704515459111
"1365",1381,62,35,27,3.65219423829837e-06,"keyboard",0.456176298374674
"1366",1382,42,5,37,3.66480250379307e-06,"woo",0.465045660461327
"1367",1383,53,17,36,3.58619601430175e-06,"scarce",0.409749440854261
"1368",1384,164,127,37,3.80021509217422e-06,"jail",0.560302480517027
"1369",1385,46,15,31,3.56828083797507e-06,"concise",0.397146899628086
"1370",1386,88,46,42,3.70815348788917e-06,"winning",0.495541177463457
"1371",1387,96,61,35,3.77099501474459e-06,"track",0.539747436920245
"1372",1388,104,63,41,3.65521123465725e-06,"cartoon",0.458298623061783
"1373",1389,80,47,33,3.7226894197444e-06,"stove",0.505766568334638
"1374",1390,87,47,40,3.56998782634151e-06,"excellent",0.39834769111729
"1375",1391,79,42,37,3.73507836194403e-06,"trustworthy",0.514481646097343
"1376",1392,39,7,32,3.54745789167483e-06,"aspect",0.382498869688882
"1377",1393,70,43,27,3.5632966195005e-06,"delay",0.393640720416634
"1378",1394,86,35,51,3.71082298632191e-06,"pastry",0.497419052592247
"1379",1395,88,60,28,3.75359876281385e-06,"tennis",0.527509936259331
"1380",1396,140,101,39,3.81133873272987e-06,"cheat",0.568127474038249
"1381",1397,41,12,29,3.51101405107823e-06,"comrade",0.356862225360978
"1382",1398,268,231,37,3.87047831371001e-06,"rock",0.609729576848202
"1383",1399,61,27,34,3.63543825208129e-06,"nuisance",0.444389196576991
"1384",1400,46,10,36,3.67244709839955e-06,"fifty",0.470423297662813
"1385",1401,56,10,46,3.7120627190117e-06,"inevitable",0.498291150195289
"1386",1402,61,24,37,3.58137969071205e-06,"jug",0.406361368334572
"1387",1403,163,123,40,3.91268453198424e-06,"vacation",0.639419801275962
"1388",1404,108,75,33,3.64574978490076e-06,"puzzle",0.45164290790491
"1389",1405,37,4,33,3.55933952895701e-06,"byte",0.390857080680095
"1390",1406,99,59,40,3.67947368808366e-06,"rice",0.475366195491931
"1391",1407,337,306,31,3.92566363343723e-06,"noise",0.648550030203515
"1392",1408,60,20,40,3.75350013887951e-06,"sway",0.527440558644744
"1393",1409,58,30,28,3.52802130924871e-06,"fright",0.368826085963257
"1394",1410,67,26,41,3.71408939813181e-06,"practical",0.499716830115917
"1395",1411,50,11,39,3.62681522101812e-06,"diagram",0.438323272218415
"1396",1412,71,35,36,3.72216287440306e-06,"holder",0.50539616676835
"1397",1413,43,23,20,3.48014922879893e-06,"sibling",0.335150175860565
"1398",1414,109,72,37,3.82197252001758e-06,"labor",0.575607877258404
"1399",1415,59,21,38,3.67541660847257e-06,"everywhere",0.472512217829403
"1400",1416,35,3,32,3.28448213570166e-06,"espresso",0.197506953019818
"1401",1417,31,4,27,3.36360578540195e-06,"resemble",0.253166972163946
"1402",1418,47,14,33,3.37113499372969e-06,"vocal",0.258463440176348
"1403",1419,75,45,30,3.60850597027313e-06,"curve",0.425443516913382
"1404",1420,28,9,19,3.50091023666153e-06,"midget",0.349754634823983
"1405",1421,70,31,39,3.75030471225787e-06,"dwarf",0.525192716089357
"1406",1422,99,70,29,3.75171171847155e-06,"flow",0.526182483283946
"1407",1423,53,12,41,3.66037570096195e-06,"pilgrim",0.461931598720482
"1408",1424,53,20,33,3.57565550704583e-06,"audio",0.402334656047497
"1409",1425,57,28,29,3.6819800215764e-06,"core",0.477129291237845
"1410",1426,37,2,35,3.64644107351225e-06,"quad",0.452129199140152
"1411",1427,99,60,39,3.79228876003534e-06,"clown",0.554726653311589
"1412",1428,84,47,37,3.73293117221505e-06,"gathering",0.512971192246009
"1413",1429,87,46,41,3.70026382881099e-06,"surface",0.48999114814864
"1414",1430,51,15,36,3.60338285582505e-06,"cathedral",0.421839630473136
"1415",1431,73,35,38,3.64052044880336e-06,"deadline",0.447964299190638
"1416",1432,51,17,34,3.53112332095086e-06,"arithmetic",0.371008215217673
"1417",1433,61,29,32,3.66237314455021e-06,"lane",0.463336712726003
"1418",1434,44,9,35,3.67443073881779e-06,"invite",0.471818701743294
"1419",1435,164,116,48,3.89691870637887e-06,"culture",0.628329234064489
"1420",1436,63,20,43,3.5304999894085e-06,"summary",0.370569728801635
"1421",1437,65,26,39,3.62827587958478e-06,"twin",0.43935078149145
"1422",1438,43,13,30,3.54171610312061e-06,"learner",0.378459773134818
"1423",1439,85,52,33,3.61025167064396e-06,"banana",0.426671540600719
"1424",1440,61,29,32,3.56094920662052e-06,"pavement",0.391989418355445
"1425",1441,69,41,28,3.55084634422615e-06,"barn",0.384882497524427
"1426",1442,152,114,38,3.80135632393638e-06,"cash",0.561105287035312
"1427",1443,106,63,43,3.78823752249266e-06,"celebration",0.551876785288093
"1428",1444,76,34,42,3.66964397114192e-06,"copper",0.468451420513389
"1429",1445,81,48,33,3.71857801576677e-06,"calendar",0.502874375861579
"1430",1446,247,207,40,3.85708720488462e-06,"broken",0.60030951879469
"1431",1447,56,25,31,3.47303018410533e-06,"solo",0.330142239985075
"1432",1448,53,28,25,3.64759823893957e-06,"pal",0.452943214293414
"1433",1449,58,15,43,3.60905294841581e-06,"dominant",0.425828292059728
"1434",1450,44,12,32,3.61364367305198e-06,"perceive",0.429057665604838
"1435",1451,60,18,42,3.56064490400501e-06,"persevere",0.391775354804677
"1436",1452,90,59,31,3.69853944677247e-06,"communicate",0.488778120973584
"1437",1453,48,5,43,3.65295469240295e-06,"cite",0.456711244502406
"1438",1454,45,11,34,3.54958594080001e-06,"poll",0.383995858964476
"1439",1455,40,10,30,3.50434538828147e-06,"tactile",0.352171113407225
"1440",1456,30,7,23,3.2546786004882e-06,"approximate",0.176541472448237
"1441",1457,96,58,38,3.5999193618063e-06,"orchestra",0.419403214254728
"1442",1458,89,50,39,3.72824105315353e-06,"dig",0.509671899079667
"1443",1459,235,199,36,3.85500553193294e-06,"teacher",0.598845153124236
"1444",1460,79,37,42,3.71582831386859e-06,"ease",0.5009400811106
"1445",1461,44,12,32,3.5539886414523e-06,"clinic",0.387092965879045
"1446",1462,59,20,39,3.63639008283697e-06,"places",0.44505876778969
"1447",1463,141,109,32,3.72058413170868e-06,"ancient",0.504285590487735
"1448",1464,56,26,30,3.56745340905848e-06,"coffin",0.396564839655973
"1449",1465,60,18,42,3.69886777657359e-06,"penalty",0.489009086596191
"1450",1466,132,90,42,3.81881990827195e-06,"childhood",0.573390153091473
"1451",1467,47,5,42,3.5900068569131e-06,"slipper",0.41243020158138
"1452",1468,63,31,32,3.5575414542518e-06,"choir",0.389592213944375
"1453",1469,54,24,30,3.55939020527003e-06,"united",0.39089272924489
"1454",1470,94,60,34,3.6582867511487e-06,"tiger",0.460462114096899
"1455",1471,55,34,21,3.65075424582719e-06,"spouse",0.455163326793902
"1456",1472,84,43,41,3.6313325901206e-06,"tube",0.441501043361144
"1457",1473,90,52,38,3.66473535113662e-06,"swimming",0.464998421511179
"1458",1474,121,89,32,3.79192925776777e-06,"ride",0.554473759225289
"1459",1475,71,34,37,3.66832474945342e-06,"visual",0.467523405884192
"1460",1476,73,41,32,3.73334926229019e-06,"cheerful",0.513265300286707
"1461",1477,67,30,37,3.64561687483139e-06,"damn",0.451549411497278
"1462",1478,47,15,32,3.62190236799977e-06,"quarrel",0.434867295477081
"1463",1479,54,18,36,3.69375791849354e-06,"concept",0.485414525429752
"1464",1481,40,8,32,3.60020449161512e-06,"sanity",0.419603790576448
"1465",1482,34,4,30,3.53525533381648e-06,"await",0.373914905140036
"1466",1483,38,3,35,3.5792389822076e-06,"evasion",0.404855473740594
"1467",1484,52,17,35,3.57102045480517e-06,"query",0.399074099975746
"1468",1485,78,32,46,3.67447124358805e-06,"seal",0.471847195073627
"1469",1486,100,67,33,3.72027961621595e-06,"ink",0.504071377187175
"1470",1487,40,8,32,3.69014583456338e-06,"payday",0.482873582722177
"1471",1488,43,15,28,3.35510798415047e-06,"album",0.247189141488389
"1472",1489,146,114,32,3.79895908521065e-06,"tough",0.559418934675778
"1473",1490,52,24,28,3.56929973908419e-06,"instant",0.397863651894371
"1474",1491,44,9,35,3.42987282031582e-06,"cannot",0.299782926381201
"1475",1492,68,26,42,3.75026251837629e-06,"critical",0.52516303454325
"1476",1493,184,136,48,3.82086267437462e-06,"disgusting",0.574827149499154
"1477",1494,67,30,37,3.66135404195179e-06,"tunnel",0.462619818720832
"1478",1495,41,10,31,3.6814107165866e-06,"heaps",0.476728810133251
"1479",1496,92,52,40,3.75417652138004e-06,"towel",0.527916364084343
"1480",1497,70,37,33,3.55480983544785e-06,"greeting",0.387670639857514
"1481",1498,433,392,41,4.0557750180482e-06,"annoying",0.740077685787496
"1482",1499,80,44,36,3.62177119098324e-06,"schedule",0.434775018196154
"1483",1500,54,24,30,3.64650755738691e-06,"umbrella",0.452175967631625
"1484",1501,126,90,36,3.71308267549885e-06,"insect",0.499008644873759
"1485",1502,53,24,29,3.60020449161512e-06,"bride",0.419603790576448
"1486",1503,37,8,29,3.50338777597937e-06,"hurdle",0.351497475130057
"1487",1504,85,48,37,3.78835233192028e-06,"axe",0.5519575486877
"1488",1505,28,5,23,3.51299985596701e-06,"collaborate",0.358259152051599
"1489",1506,41,5,36,3.60357763187292e-06,"confront",0.421976646884722
"1490",1507,50,21,29,3.67260894794444e-06,"glee",0.470537151722899
"1491",1508,82,46,36,3.73855534744264e-06,"vampire",0.516927552980424
"1492",1509,62,35,27,3.63394541087204e-06,"toddler",0.443339048225635
"1493",1510,46,17,29,3.68822681119598e-06,"beneath",0.481523633904445
"1494",1511,263,226,37,3.89593186794349e-06,"fake",0.627635036483702
"1495",1512,76,43,33,3.67290570916463e-06,"boyfriend",0.470745910232647
"1496",1513,32,5,27,3.56504967896728e-06,"lug",0.394873920905379
"1497",1514,104,67,37,3.70936391827529e-06,"nurse",0.496392662180346
"1498",1515,98,71,27,3.63424916412269e-06,"jeans",0.443552725322313
"1499",1516,66,37,29,3.55502467187122e-06,"chew",0.387821767863906
"1500",1517,59,29,30,3.75908759425912e-06,"tone",0.531371088575738
"1501",1518,154,121,33,3.75492364362771e-06,"burn",0.528441931835147
"1502",1519,50,20,30,3.6365619942906e-06,"separation",0.445179699961506
"1503",1520,41,9,32,3.55652925423138e-06,"get up",0.388880175600247
"1504",1521,36,3,33,3.55719977233921e-06,"testament",0.389351855696651
"1505",1522,42,14,28,3.62255839564134e-06,"scrabble",0.435328782165664
"1506",1523,72,32,40,3.66699302904625e-06,"title",0.466586598954301
"1507",1524,44,10,34,3.62360853432282e-06,"inbetween",0.436067508694795
"1508",1525,56,19,37,3.60321406694772e-06,"filter",0.421720894896868
"1509",1526,32,9,23,3.54938435928288e-06,"proximity",0.383854055203594
"1510",1527,49,25,24,3.55364764162174e-06,"throne",0.386853087446124
"1511",1528,55,20,35,3.71053383450277e-06,"conference",0.497215646962583
"1512",1529,85,51,34,3.73284756543682e-06,"republican",0.512912378542464
"1513",1530,175,137,38,3.81756614887744e-06,"intelligent",0.572508188316537
"1514",1531,31,8,23,3.31424329197158e-06,"distinct",0.218442621862313
"1515",1532,235,196,39,3.82527666313466e-06,"sport",0.577932197102702
"1516",1533,204,158,46,3.76416738499528e-06,"secret",0.534944498683758
"1517",1534,52,18,34,3.59927150744689e-06,"fraternity",0.41894747711187
"1518",1535,35,9,26,3.56074633243128e-06,"menu",0.391846705256394
"1519",1536,103,67,36,3.62926347726992e-06,"mix",0.440045513171168
"1520",1537,81,39,42,3.76276518087612e-06,"pile",0.533958109552169
"1521",1538,102,68,34,3.77099501474459e-06,"personal",0.539747436920245
"1522",1539,129,94,35,3.70471907115283e-06,"biology",0.493125215838614
"1523",1540,60,32,28,3.70690262337499e-06,"operation",0.494661249109925
"1524",1541,32,4,28,3.69224407210214e-06,"serendipity",0.484349600853528
"1525",1542,43,7,36,3.64927543636211e-06,"presidential",0.454123049159483
"1526",1543,106,74,32,3.70717746629249e-06,"camping",0.494854589054528
"1527",1544,112,74,38,3.73883490426713e-06,"location",0.517124208951957
"1528",1545,79,46,33,3.72621278910753e-06,"quickly",0.508245104233155
"1529",1546,65,26,39,3.64199216971684e-06,"values",0.448999590339733
"1530",1547,33,5,28,3.56310617343776e-06,"revenue",0.393506749959782
"1531",1548,229,184,45,3.83968545296769e-06,"smelly",0.588068149134593
"1532",1549,64,38,26,3.64475319553736e-06,"row",0.450941850973693
"1533",1550,48,12,36,3.61603494536171e-06,"carefully",0.430739820852263
"1534",1551,52,15,37,3.70248325551948e-06,"grim",0.49155241754851
"1535",1552,95,72,23,3.69534128324421e-06,"devil",0.486528353124362
"1536",1553,54,10,44,3.60259098343529e-06,"executive",0.421282582959013
"1537",1554,84,50,34,3.62034197750319e-06,"captain",0.433769629163146
"1538",1555,66,27,39,3.68590216141303e-06,"procedure",0.479888344684184
"1539",1556,48,15,33,3.57520807711009e-06,"contain",0.402019908700992
"1540",1557,167,131,36,3.76745745598668e-06,"tiny",0.537258919404499
"1541",1558,47,16,31,3.60172162293576e-06,"shatter",0.420671025956399
"1542",1559,42,6,36,3.53089889624101e-06,"proportion",0.370850342272045
"1543",1560,48,17,31,3.62656531625463e-06,"engagement",0.438147475171985
"1544",1561,253,216,37,3.91755889070402e-06,"healthy",0.64284869896567
"1545",1562,44,14,30,3.58511603228038e-06,"knob",0.408989720843718
"1546",1563,90,44,46,3.84051124885745e-06,"revolution",0.588649060343909
"1547",1564,75,47,28,3.63399823387686e-06,"barrier",0.443376206894007
"1548",1565,402,367,35,3.83407650516258e-06,"religion",0.584122500224395
"1549",1566,40,17,23,3.5911800617683e-06,"pupil",0.413255499769062
"1550",1567,95,61,34,3.65569227844677e-06,"moist",0.458637016280943
"1551",1568,85,28,57,3.73907256044211e-06,"cleaner",0.517291389653289
"1552",1569,50,19,31,3.65455668400145e-06,"recall",0.457838175367941
"1553",1570,177,140,37,3.76168944996577e-06,"thinking",0.533201380011873
"1554",1571,180,151,29,3.83807911816294e-06,"weird",0.586938163013844
"1555",1572,64,24,40,3.71575927825092e-06,"puberty",0.500891517579777
"1556",1573,35,11,24,3.49669911603446e-06,"seasons",0.346792296059167
"1557",1574,86,55,31,3.70761729974232e-06,"missing",0.495163992606192
"1558",1575,149,115,34,3.84951476866341e-06,"USA",0.594982641854148
"1559",1576,55,26,29,3.63331165457379e-06,"infant",0.442893228450807
"1560",1577,69,29,40,3.66008096099086e-06,"brand",0.461724262070877
"1561",1578,42,8,34,3.57176023487895e-06,"fare",0.399594502829071
"1562",1579,57,19,38,3.67525451137491e-06,"twitter",0.472398189626798
"1563",1580,119,83,36,3.68349902939801e-06,"jewelry",0.478197846653966
"1564",1581,54,19,35,3.60805028178873e-06,"lighter",0.425122960039911
"1565",1582,63,24,39,3.63193927397534e-06,"bunch",0.441927818858702
"1566",1583,64,35,29,3.65523795599093e-06,"picnic",0.458317420348688
"1567",1584,33,13,20,3.22936917502535e-06,"gigantic",0.15873740108493
"1568",1585,61,28,33,3.56974569131695e-06,"impossible",0.398177359741606
"1569",1586,98,77,21,3.55573255202037e-06,"unusual",0.388319730518591
"1570",1587,59,22,37,3.73714422386989e-06,"pony",0.515934889404214
"1571",1588,58,27,31,3.65122078566969e-06,"mum",0.455491517122122
"1572",1589,69,21,48,3.78485377217451e-06,"approval",0.549496465267461
"1573",1590,56,20,36,3.65324828571324e-06,"signature",0.456917774526404
"1574",1591,56,19,37,3.68372970264934e-06,"studies",0.478360115174615
"1575",1592,133,90,43,3.69858048480993e-06,"mountains",0.488806989434016
"1576",1593,48,13,35,3.49586788416092e-06,"has",0.346207560873546
"1577",1594,155,123,32,3.843182770243e-06,"gay",0.590528358531331
"1578",1595,72,33,39,3.73578998882999e-06,"rod",0.514982244417134
"1579",1596,173,136,37,3.77904669768004e-06,"moon",0.545411442916269
"1580",1597,48,14,34,3.64107717627183e-06,"prime",0.448355932560311
"1581",1598,64,25,39,3.69486340090007e-06,"wake",0.486192183843439
"1582",1599,162,119,43,3.86253992900652e-06,"truck",0.604145271191885
"1583",1600,57,32,25,3.65609324500212e-06,"melody",0.458919078676087
"1584",1601,52,12,40,3.61570808219228e-06,"promote",0.430509886940756
"1585",1602,53,11,42,3.63114798743623e-06,"principle",0.441371183464831
"1586",1603,101,67,34,3.67839092467391e-06,"jam",0.474604518896585
"1587",1604,53,17,36,3.66164898700481e-06,"plaster",0.462827299636581
"1588",1605,66,22,44,3.69052715489881e-06,"development",0.483141824862803
"1589",1606,37,5,32,3.55837695310415e-06,"bolster",0.390179950762546
"1590",1607,43,13,30,3.60801122813094e-06,"placement",0.425095487503594
"1591",1608,112,65,47,3.77509494363783e-06,"emotional",0.542631557174452
"1592",1609,110,76,34,3.64483290263558e-06,"professor",0.45099792142329
"1593",1610,48,24,24,3.55687080733854e-06,"paste",0.389120443239
"1594",1611,95,59,36,3.6597460868165e-06,"media",0.461488692768571
"1595",1612,36,10,26,3.63979165832548e-06,"trout",0.447451627036299
"1596",1613,189,143,46,3.84605029864581e-06,"tight",0.592545539063332
"1597",1614,77,28,49,3.66026851729843e-06,"scientific",0.46185619971164
"1598",1615,166,130,36,3.83936113030792e-06,"thin",0.587840002360266
"1599",1616,89,50,39,3.82008908447745e-06,"headache",0.574282962917148
"1600",1617,36,6,30,3.43712299057197e-06,"exactly",0.304883103341996
"1601",1618,66,28,38,3.62648640611571e-06,"haircut",0.438091965348314
"1602",1619,37,11,26,3.7090749937873e-06,"adjective",0.496189416468174
"1603",1620,68,37,31,3.71018966489567e-06,"spark",0.496973538730813
"1604",1621,52,10,42,3.67491685500616e-06,"linear",0.472160663172693
"1605",1622,41,10,31,3.61282117980288e-06,"anniversary",0.428479077658456
"1606",1623,34,8,26,3.50668022583021e-06,"teddy",0.35381356927413
"1607",1624,47,5,42,3.67863449087699e-06,"socialize",0.474775857043617
"1608",1625,35,4,31,3.40533343322311e-06,"bagpipes",0.282520543256319
"1609",1626,205,173,32,3.78818012038836e-06,"apple",0.551836405423967
"1610",1627,116,80,36,3.74847718114516e-06,"belief",0.523907128062196
"1611",1628,49,12,37,3.63325885152688e-06,"vinyl",0.442856083821946
"1612",1629,378,338,40,3.98504809953056e-06,"smell",0.690324398955954
"1613",1630,48,21,27,3.67316204154346e-06,"employment",0.470926228824709
"1614",1631,39,7,32,3.70320994237805e-06,"dreadful",0.49206360989888
"1615",1632,50,21,29,3.61280812737316e-06,"unity",0.428469895846306
"1616",1633,56,25,31,3.56830630341309e-06,"salmon",0.397164813447439
"1617",1634,93,59,34,3.61642725918211e-06,"cereal",0.431015796427663
"1618",1635,56,28,28,3.57726718250859e-06,"joker",0.403468399087049
"1619",1636,147,104,43,3.77042628439571e-06,"spy",0.539347360050355
"1620",1637,43,17,26,3.57424967563684e-06,"borrow",0.401345715276514
"1621",1638,89,47,42,3.71392387198847e-06,"prince",0.499600389729988
"1622",1639,280,239,41,3.82302454764062e-06,"meat",0.576347932575118
"1623",1640,116,77,39,3.69157619228682e-06,"cowboy",0.483879776680256
"1624",1641,57,15,42,3.66797491105161e-06,"offense",0.467277309903839
"1625",1642,352,327,25,3.82206016687115e-06,"ocean",0.575669532977849
"1626",1643,55,18,37,3.69225770481877e-06,"calculate",0.484359190872077
"1627",1644,104,72,32,3.70260663507109e-06,"shower",0.491639209654673
"1628",1645,100,60,40,3.82612555048381e-06,"bored",0.57852935214148
"1629",1646,307,272,35,3.99846458959759e-06,"women",0.699762311600361
"1630",1647,28,4,24,3.2441937043177e-06,"circa",0.169165807602327
"1631",1648,47,21,26,3.61327807426732e-06,"lottery",0.428800482886015
"1632",1649,170,137,33,3.76116596144805e-06,"tool",0.532833128787007
"1633",1650,103,67,36,3.66950931321464e-06,"flour",0.468356694564335
"1634",1651,80,49,31,3.64657404368596e-06,"crap",0.452222737828547
"1635",1652,71,22,49,3.76323246615913e-06,"dating",0.534286824265111
"1636",1653,54,4,50,3.79642073453148e-06,"impatience",0.557633316242703
"1637",1654,41,13,28,3.72981239043676e-06,"worst",0.510777265978157
"1638",1655,69,28,41,3.74421051449197e-06,"classic",0.520905715102887
"1639",1656,62,25,37,3.54266968502124e-06,"arrive",0.379130576201231
"1640",1657,73,38,35,3.63862620029182e-06,"pieces",0.446631778397985
"1641",1658,35,8,27,3.44216305526393e-06,"former",0.308428567919333
"1642",1659,54,18,36,3.70643548393075e-06,"minor",0.494332636988167
"1643",1660,63,32,31,3.64099763335154e-06,"students",0.448299977602686
"1644",1661,45,18,27,3.41997264021888e-06,"beside",0.292818583661754
"1645",1662,95,55,40,3.77529447296889e-06,"chain",0.542771917312397
"1646",1663,40,7,33,3.68042162910183e-06,"whiz",0.476033030444803
"1647",1664,98,55,43,3.7975596881444e-06,"bicycle",0.558434520182855
"1648",1665,67,26,41,3.64366421448065e-06,"cabinet",0.450175800536258
"1649",1666,52,16,36,3.58668479138048e-06,"expectations",0.410093274103389
"1650",1667,73,35,38,3.65034112437807e-06,"electrical",0.45487271396381
"1651",1669,49,19,30,3.41418114279471e-06,"minuscule",0.288744519096693
"1652",1670,28,7,21,3.62019780760821e-06,"hearth",0.433668211961773
"1653",1671,94,56,38,3.7291169451074e-06,"alarm",0.510288050674103
"1654",1672,61,21,40,3.77287304282211e-06,"bonus",0.541068547348592
"1655",1673,40,5,35,3.57721599587905e-06,"corridor",0.403432391536951
"1656",1674,55,28,27,3.68849889160608e-06,"assistance",0.481715030546187
"1657",1675,52,17,35,3.68295638274756e-06,"wig",0.477816118522532
"1658",1676,53,22,31,3.55522689458041e-06,"cruise",0.387964022675299
"1659",1677,129,99,30,3.77623539540961e-06,"dull",0.543433815003691
"1660",1678,51,14,37,3.62959279598422e-06,"resist",0.440277174450844
"1661",1679,58,23,35,3.66858044279766e-06,"beam",0.467703274943435
"1662",1680,40,12,28,3.56681718635193e-06,"appendage",0.396117284871019
"1663",1681,35,11,24,3.35161078414286e-06,"hurl",0.244729014584337
"1664",1682,64,20,44,3.69795133496043e-06,"assemble",0.488364410093955
"1665",1683,66,34,32,3.60139734216876e-06,"tale",0.420442908651803
"1666",1684,39,4,35,3.45672696350733e-06,"indefinite",0.318673638953238
"1667",1685,71,36,35,3.6353853872049e-06,"explanation",0.444352008453805
"1668",1686,59,22,37,3.68790036768367e-06,"intimate",0.481293995203327
"1669",1687,38,12,26,3.58100776720585e-06,"yearn",0.406099736451389
"1670",1688,92,59,33,3.65174078483213e-06,"hay",0.455857313738506
"1671",1689,46,12,34,3.60695709885227e-06,"exhaust",0.424353953764267
"1672",1690,56,26,30,3.63343046704115e-06,"pear",0.442976807813397
"1673",1691,66,27,39,3.62906591472421e-06,"porch",0.4399065365805
"1674",1692,37,16,21,3.58464053224743e-06,"embrace",0.408655227414285
"1675",1693,51,14,37,3.69441293931188e-06,"esteem",0.485875303862329
"1676",1694,228,186,42,3.94295335091891e-06,"wild",0.660712588549493
"1677",1695,108,62,46,3.69487705296606e-06,"cookies",0.486201787473421
"1678",1696,245,211,34,3.84452731536657e-06,"army",0.591474187087036
"1679",1697,27,7,20,3.35052150867282e-06,"Celsius",0.243962757040037
"1680",1698,189,155,34,3.87014876851866e-06,"negative",0.609497756251848
"1681",1699,109,74,35,3.7549659424589e-06,"honey",0.528471687208705
"1682",1700,36,9,27,3.63031750756921e-06,"contemporary",0.440786977282836
"1683",1701,87,46,41,3.71012083863571e-06,"Canada",0.496925122473964
"1684",1702,56,21,35,3.58014879098375e-06,"absent",0.405495484332748
"1685",1703,70,27,43,3.79218809252939e-06,"obey",0.554655838133955
"1686",1704,81,46,35,3.7021268718879e-06,"angel",0.491301717285929
"1687",1705,89,45,44,3.77960374634323e-06,"precious",0.54580330223235
"1688",1706,132,94,38,3.74428061136614e-06,"baseball",0.520955025181139
"1689",1707,64,24,40,3.61950333175282e-06,"maker",0.43317967864016
"1690",1708,39,14,25,3.47764396576607e-06,"instruct",0.333387833136257
"1691",1709,55,13,42,3.64195237783071e-06,"prompt",0.448971598492137
"1692",1710,42,14,28,3.54969934046586e-06,"sinister",0.384075630658482
"1693",1711,52,18,34,3.72198277466372e-06,"lemonade",0.505269474496477
"1694",1712,35,7,28,3.69108565902489e-06,"youngster",0.483534708033228
"1695",1713,53,17,36,3.51397507888874e-06,"greenery",0.358945178627713
"1696",1714,73,34,39,3.69674834015999e-06,"cycle",0.487518155985654
"1697",1715,48,21,27,3.48056106644391e-06,"tumble",0.335439885590723
"1698",1716,65,36,29,3.6440891052668e-06,"seek",0.450474692579041
"1699",1718,46,3,43,3.68917926828818e-06,"coordinate",0.482193645717434
"1700",1719,121,94,27,3.73213705900135e-06,"furniture",0.512412568410479
"1701",1720,45,8,37,3.5778175313059e-06,"convey",0.403855545341174
"1702",1721,43,9,34,3.43702848265504e-06,"darn",0.304816621165228
"1703",1722,180,146,34,3.83404710510273e-06,"learning",0.584101818571055
"1704",1723,45,8,37,3.58982643189202e-06,"vendetta",0.412303280488061
"1705",1724,211,179,32,3.77214721936168e-06,"illness",0.540557962360969
"1706",1725,59,20,39,3.67986634725427e-06,"intellectual",0.475642414006068
"1707",1726,171,134,37,3.8646148138415e-06,"running",0.605604861719809
"1708",1727,138,102,36,3.79318061988158e-06,"wheel",0.555354037618345
"1709",1728,79,40,39,3.68976459301897e-06,"signal",0.482605396007571
"1710",1729,59,22,37,3.69637939638124e-06,"drill",0.487258620210117
"1711",1730,98,64,34,3.65324828571324e-06,"breathe",0.456917774526404
"1712",1731,46,11,35,3.75192286046599e-06,"felt",0.526331012421529
"1713",1732,51,18,33,3.67008841242986e-06,"counting",0.468764065477172
"1714",1733,79,37,42,3.72075025208083e-06,"healing",0.504402448887584
"1715",1734,58,19,39,3.7037997281411e-06,"pro",0.492478498329665
"1716",1735,131,95,36,3.82612555048381e-06,"shit",0.57852935214148
"1717",1736,28,2,26,3.31325500798494e-06,"crucifix",0.21774740739958
"1718",1737,187,160,27,3.8876923435787e-06,"mad",0.621838892276247
"1719",1738,111,76,35,3.75735031655676e-06,"edge",0.530148989866463
"1720",1739,120,89,31,3.6962700938483e-06,"effort",0.487181730669513
"1721",1740,36,12,24,3.47740210243731e-06,"saucer",0.333217692886659
"1722",1741,28,7,21,3.32096826150632e-06,"opt",0.223173343138007
"1723",1742,98,49,49,3.75629178874615e-06,"slang",0.529404361952728
"1724",1743,49,10,39,3.68796837198324e-06,"wart",0.481341833247079
"1725",1744,66,35,31,3.53610540422989e-06,"light bulb",0.374512892412655
"1726",1745,48,13,35,3.70709500913799e-06,"existence",0.494796584060883
"1727",1746,51,20,31,3.50707376778963e-06,"feline",0.3540904087915
"1728",1747,47,14,33,3.46856096342749e-06,"possess",0.326998339148473
"1729",1748,48,4,44,3.63389258940284e-06,"settlement",0.443301890637508
"1730",1749,52,9,43,3.73669735740763e-06,"lap",0.515620538436604
"1731",1750,56,18,38,3.68434044779474e-06,"stack",0.478789747612122
"1732",1751,46,16,30,3.46921075455334e-06,"pea",0.327455438721626
"1733",1752,97,57,40,3.71129123244559e-06,"evolution",0.497748443214486
"1734",1753,143,97,46,3.87118253012748e-06,"gray",0.610224962228256
"1735",1754,130,84,46,3.68204780770874e-06,"vegetables",0.477176975810506
"1736",1755,41,7,34,3.4823791614431e-06,"insist",0.336718835725656
"1737",1756,137,93,44,3.80715974461572e-06,"solid",0.56518773908773
"1738",1757,91,57,34,3.72717107715244e-06,"pole",0.508919217865769
"1739",1758,64,36,28,3.56212887069828e-06,"fault",0.39281926032306
"1740",1759,81,54,27,3.62980359132767e-06,"gender",0.440425459734658
"1741",1760,43,9,34,3.51718850020048e-06,"endeavor",0.361205679658783
"1742",1761,43,4,39,3.6320711885953e-06,"prop",0.442020615011306
"1743",1762,33,9,24,3.65609324500212e-06,"duration",0.458919078676087
"1744",1763,46,11,35,3.66915924884972e-06,"chapter",0.46811043962884
"1745",1764,50,18,32,3.66485622769019e-06,"hush",0.465083452867938
"1746",1765,66,29,37,3.63145127318682e-06,"population",0.441584531695705
"1747",1766,48,2,46,3.67035782318418e-06,"exploit",0.468953584133102
"1748",1767,94,63,31,3.71349633106563e-06,"funeral",0.49929963343221
"1749",1768,78,45,33,3.69523204209608e-06,"dishes",0.486451506765286
"1750",1769,39,7,32,3.59522123193851e-06,"proposition",0.416098285837331
"1751",1770,45,14,31,3.7125174952387e-06,"consistent",0.498611065335664
"1752",1771,146,105,41,3.74954536762418e-06,"hill",0.524658550425759
"1753",1772,47,14,33,3.53998591085607e-06,"habitat",0.37724265872046
"1754",1773,89,48,41,3.63001441115721e-06,"split",0.440573762243359
"1755",1774,56,10,46,3.75915824928482e-06,"fuss",0.531420791289123
"1756",1775,50,18,32,3.42015978986538e-06,"absolutely",0.292950235234283
"1757",1776,39,6,33,3.6426156894743e-06,"sake",0.449438209156845
"1758",1777,70,31,39,3.739492027403e-06,"relative",0.517586466272756
"1759",1778,114,77,37,3.77085281607288e-06,"surgery",0.53964740638804
"1760",1779,72,38,34,3.64922216829483e-06,"lightning",0.45408557740918
"1761",1780,222,187,35,3.80485651886067e-06,"stone",0.563567520731967
"1762",1781,63,21,42,3.72669881565512e-06,"paperwork",0.508587002604192
"1763",1782,109,77,32,3.69315768675375e-06,"catholic",0.484992288712235
"1764",1783,59,20,39,3.50207497942531e-06,"percentage",0.350573980301289
"1765",1784,43,14,29,3.54849011745502e-06,"intention",0.38322499527718
"1766",1785,70,30,40,3.75445841937301e-06,"acceptance",0.528114666965275
"1767",1786,44,14,30,3.63029114935018e-06,"passive",0.44076843543117
"1768",1787,43,6,37,3.70160612689846e-06,"alongside",0.490935396012945
"1769",1788,66,29,37,3.72178884058834e-06,"independent",0.505133050375633
"1770",1789,120,77,43,3.87356678029129e-06,"dancing",0.611902177703843
"1771",1790,51,20,31,3.48729751878782e-06,"bye",0.340178684519305
"1772",1791,57,19,38,3.59370957076733e-06,"acceptable",0.41503489846774
"1773",1792,64,29,35,3.59775643908459e-06,"license",0.417881692932677
"1774",1793,50,22,28,3.52874337919523e-06,"exclamation",0.369334030518385
"1775",1794,42,6,36,3.55768067681317e-06,"their",0.389690150913421
"1776",1795,81,47,34,3.7202380952381e-06,"rainbow",0.504042168999342
"1777",1796,58,24,34,3.73039676499993e-06,"director",0.511188347867027
"1778",1797,56,23,33,3.75660222841644e-06,"bedroom",0.529622742652519
"1779",1798,28,7,21,3.42144699836455e-06,"Berlin",0.293855729988095
"1780",1799,147,103,44,3.71513807310649e-06,"island",0.500454526991471
"1781",1800,130,98,32,3.74266904700418e-06,"garbage",0.519821360296135
"1782",1801,61,25,36,3.6836618545764e-06,"needed",0.478312387029451
"1783",1802,119,78,41,3.80948027260641e-06,"challenge",0.56682012880781
"1784",1803,49,11,38,3.67761984443668e-06,"continuous",0.474062097750336
"1785",1804,64,31,33,3.80705828606236e-06,"grandparents",0.565116367442918
"1786",1805,73,28,45,3.64614857326206e-06,"urge",0.451923438036021
"1787",1806,88,45,43,3.83059573424859e-06,"working",0.581673930467526
"1788",1807,175,136,39,3.77577913202389e-06,"bug",0.543112853712347
"1789",1808,68,36,32,3.6063977496078e-06,"groceries",0.423960476090108
"1790",1809,47,14,33,3.55146426871799e-06,"went",0.385317180317448
"1791",1810,72,41,31,3.69228497055403e-06,"warning",0.484378371121628
"1792",1811,68,23,45,3.74037321443934e-06,"hierarchy",0.518206342725599
"1793",1812,206,167,39,3.94676601992327e-06,"hands",0.663394634064043
"1794",1813,40,5,35,3.51876027038154e-06,"farther",0.36231135108192
"1795",1814,196,164,32,3.84352251151135e-06,"penis",0.590767351620905
"1796",1815,88,66,22,3.65868828707532e-06,"scent",0.460744577019769
"1797",1816,90,63,27,3.64381025951217e-06,"conversation",0.450278536813982
"1798",1817,73,40,33,3.69193054740254e-06,"dentist",0.484129049970853
"1799",1818,114,73,41,3.8103076442392e-06,"craft",0.567402148483276
"1800",1819,84,41,43,3.77406912585011e-06,"proof",0.541909939327963
"1801",1820,273,228,45,3.94226940680672e-06,"gun",0.660231463847564
"1802",1821,60,24,36,3.55717446517882e-06,"carrier",0.389334053218663
"1803",1822,55,22,33,3.64220440779577e-06,"favor",0.449148890524717
"1804",1823,91,47,44,3.72612948299953e-06,"sausage",0.508186502037937
"1805",1824,166,127,39,3.857563331546e-06,"action",0.600644453029749
"1806",1825,45,5,40,3.58896322030492e-06,"brought",0.411696048975796
"1807",1826,62,29,33,3.56642284222502e-06,"chief",0.395839881063986
"1808",1827,73,35,38,3.62668368790211e-06,"riot",0.438230744437114
"1809",1828,106,58,48,3.80219462673855e-06,"steady",0.561694996309269
"1810",1829,139,99,40,3.70360768424522e-06,"fantasy",0.492343403867244
"1811",1830,107,73,34,3.79541210584645e-06,"photo",0.556923790176465
"1812",1831,63,25,38,3.69592856509269e-06,"chart",0.486941480161009
"1813",1832,60,26,34,3.6014492231674e-06,"uncle",0.420479404660121
"1814",1833,34,4,30,3.59453630481668e-06,"contribute",0.415616469631206
"1815",1834,94,55,39,3.64898248123511e-06,"triangle",0.453916968069454
"1816",1835,104,68,36,3.72278643118802e-06,"cliff",0.505834811632682
"1817",1836,50,20,30,3.47574624271831e-06,"several",0.332052868159682
"1818",1837,54,25,29,3.54833902250357e-06,"circular",0.383118706602143
"1819",1838,109,69,40,3.74230488557903e-06,"rare",0.519565188696716
"1820",1839,46,15,31,3.44919168192934e-06,"index",0.313372898675505
"1821",1840,78,46,32,3.66572946183426e-06,"shade",0.465697734809688
"1822",1841,60,21,39,3.7219689215595e-06,"chase",0.505259729444919
"1823",1842,41,9,32,3.58968468209752e-06,"reuse",0.412203565721299
"1824",1843,67,27,40,3.72314680367847e-06,"interview",0.506088317882629
"1825",1845,65,16,49,3.65054101017771e-06,"scenery",0.455013324861772
"1826",1846,154,117,37,3.71956005043723e-06,"ghost",0.503565194204328
"1827",1847,46,9,37,3.6654204237226e-06,"retire",0.465480340044959
"1828",1848,60,28,32,3.60752963585596e-06,"tune",0.424756708448953
"1829",1849,56,30,26,3.64886264951215e-06,"arrest",0.453832671705228
"1830",1850,57,22,35,3.68170890200395e-06,"appreciate",0.476938570503274
"1831",1851,124,83,41,3.76092548854422e-06,"snake",0.5326639666404
"1832",1852,42,13,29,3.24873624160202e-06,"usually",0.172361283457724
"1833",1853,66,23,43,3.69929195551971e-06,"abundance",0.489307477890717
"1834",1854,160,121,39,3.7575056174709e-06,"prison",0.530258237251871
"1835",1855,37,6,31,3.53546781310103e-06,"steeple",0.37406437500259
"1836",1856,42,8,34,3.65279457048615e-06,"session",0.456598605752952
"1837",1857,42,7,35,3.55364764162174e-06,"effective",0.386853087446124
"1838",1858,73,34,39,3.71436530782802e-06,"gentleman",0.499910920492579
"1839",1859,43,20,23,3.5322458725707e-06,"calories",0.371797881074684
"1840",1860,58,19,39,3.63512108588337e-06,"poster",0.444166084059876
"1841",1861,237,200,37,3.91763562854546e-06,"medicine",0.642902680673283
"1842",1862,53,20,33,3.41090876842317e-06,"contrary",0.286442547172286
"1843",1863,128,87,41,3.70655912703119e-06,"priest",0.494419614489381
"1844",1864,114,80,34,3.74310333211059e-06,"above",0.520126860831412
"1845",1865,50,3,47,3.56903222122289e-06,"compile",0.397675464805712
"1846",1866,59,23,36,3.70500731738945e-06,"sunrise",0.493327984430674
"1847",1867,49,18,31,3.66018813367007e-06,"necessity",0.461799653352742
"1848",1868,38,8,30,3.58745681598858e-06,"exhibit",0.410636359573147
"1849",1869,103,72,31,3.70074310921633e-06,"ears",0.490328300904326
"1850",1870,118,71,47,3.84890729521889e-06,"diamond",0.594555310914792
"1851",1871,71,40,31,3.59837785126465e-06,"basic",0.418318829161474
"1852",1872,69,32,37,3.68195290782231e-06,"mice",0.477110217900384
"1853",1873,83,43,40,3.64335888542365e-06,"smoking",0.449961014928892
"1854",1874,105,71,34,3.73532949341461e-06,"lips",0.514658306078438
"1855",1875,47,18,29,3.59478181471776e-06,"oak",0.41578917508458
"1856",1876,81,41,40,3.70246954718797e-06,"border",0.491542774338209
"1857",1877,33,10,23,3.44824019061872e-06,"decade",0.312703566247523
"1858",1878,40,6,34,3.61434896539261e-06,"opener",0.429553807849673
"1859",1879,68,35,33,3.6368926389293e-06,"goat",0.445412293970879
"1860",1880,90,46,44,3.74189878912155e-06,"float",0.519279517640299
"1861",1881,109,71,38,3.60488967235158e-06,"pirate",0.422899609847583
"1862",1882,41,15,26,3.61963434453851e-06,"petite",0.433271840391896
"1863",1883,70,32,38,3.65856781704234e-06,"pitch",0.460659831632427
"1864",1884,77,37,40,3.60273375437282e-06,"biscuit",0.421383016055139
"1865",1885,56,22,34,3.62317527835044e-06,"sack",0.435762732110193
"1866",1886,57,28,29,3.52216852871976e-06,"zero",0.364708911420356
"1867",1887,43,14,29,3.6191496445995e-06,"enterprise",0.432930875231837
"1868",1888,105,50,55,3.79306551762069e-06,"scientist",0.555273068223366
"1869",1889,45,9,36,3.58410092828214e-06,"anticipate",0.408275639678484
"1870",1890,54,22,32,3.65056766327164e-06,"demon",0.455032074145001
"1871",1891,81,43,38,3.70448576180897e-06,"command",0.492961092942427
"1872",1892,58,20,38,3.60047670311549e-06,"virtue",0.419795279434446
"1873",1893,62,24,38,3.6531949016012e-06,"faithful",0.456880221143695
"1874",1895,67,38,29,3.57193884840692e-06,"below",0.39972014961639
"1875",1896,51,17,34,3.52865621713939e-06,"teaching",0.369272715832884
"1876",1897,189,152,37,3.77210453256081e-06,"marriage",0.540527934067751
"1877",1898,33,7,26,3.40198539867867e-06,"finally",0.28016534771687
"1878",1899,56,28,28,3.52081682950444e-06,"grasp",0.36375805027471
"1879",1900,62,28,34,3.68984628100393e-06,"suicide",0.482662859924167
"1880",1901,49,20,29,3.58971045395478e-06,"railroad",0.412221695093161
"1881",1902,47,15,32,3.43880137139399e-06,"maximum",0.306063770677722
"1882",1903,173,126,47,3.83653300185688e-06,"dust",0.585850537967219
"1883",1904,43,7,36,3.49096189964183e-06,"instance",0.342756415820354
"1884",1905,58,24,34,3.58351011983258e-06,"tag",0.407860031832566
"1885",1906,59,26,33,3.6645204791727e-06,"meadow",0.464847268503568
"1886",1907,59,32,27,3.66511143771326e-06,"sailing",0.465262981931928
"1887",1908,84,47,37,3.72799087387834e-06,"going",0.509495908926289
"1888",1909,97,51,46,3.73627851714578e-06,"defense",0.515325902672442
"1889",1910,94,64,30,3.70785100371527e-06,"responsibility",0.495328393106643
"1890",1911,88,44,44,3.72402030335869e-06,"discipline",0.506702786617424
"1891",1912,106,71,35,3.78731929752802e-06,"heaven",0.551230854276262
"1892",1913,33,8,25,3.48006445079363e-06,"fore",0.335090538250116
"1893",1914,108,73,35,3.66743682840063e-06,"wheat",0.466898792345966
"1894",1915,54,20,34,3.57441576174374e-06,"manner",0.401462549572261
"1895",1916,90,56,34,3.63661489339263e-06,"spicy",0.445216912160933
"1896",1917,60,25,35,3.62077455609304e-06,"irritate",0.434073929238828
"1897",1918,51,23,28,3.61616570717737e-06,"lumber",0.430831806057573
"1898",1919,75,40,35,3.73020195313374e-06,"expression",0.511051306258831
"1899",1920,118,87,31,3.7628642922993e-06,"swim",0.534027830093781
"1900",1921,78,42,36,3.6363239673749e-06,"museum",0.445012258460328
"1901",1922,169,132,37,3.79706942182024e-06,"map",0.558089639314848
"1902",1923,88,42,46,3.67506541616441e-06,"stain",0.472265169435279
"1903",1924,50,9,41,3.6740662360661e-06,"dictate",0.471562290035622
"1904",1925,165,125,40,3.79031952393587e-06,"dream",0.553341382037939
"1905",1926,139,103,36,3.75109250569228e-06,"string",0.525746894237194
"1906",1927,54,18,36,3.72001666567466e-06,"shoulders",0.503886403007929
"1907",1928,59,18,41,3.6658235272554e-06,"curiosity",0.465763905710061
"1908",1929,143,115,28,3.75562874858694e-06,"mistake",0.528937942265384
"1909",1930,105,70,35,3.72138718428681e-06,"romance",0.504850502774291
"1910",1931,40,11,29,3.45265716495415e-06,"inquire",0.315810714072484
"1911",1932,51,13,38,3.61407465232602e-06,"binding",0.429360840631961
"1912",1933,62,27,35,3.66601167258117e-06,"pope",0.465896257699305
"1913",1934,34,12,22,3.46740638002774e-06,"meow",0.326186140338418
"1914",1935,56,27,29,3.64998138509494e-06,"steep",0.454619653147453
"1915",1936,44,8,36,3.57412192759544e-06,"dubious",0.401255850129278
"1916",1937,72,41,31,3.58054617651377e-06,"empathy",0.405775027633541
"1917",1938,177,138,39,3.86310694238949e-06,"messy",0.604544140251523
"1918",1939,72,31,41,3.63810992912962e-06,"particle",0.446268604266351
"1919",1940,78,43,35,3.57394309567803e-06,"tissue",0.401130049714557
"1920",1941,96,55,41,3.76030323085254e-06,"relaxed",0.532226235631239
"1921",1942,73,34,39,3.60453883530141e-06,"broad",0.422652811361888
"1922",1943,38,13,25,3.64265549585648e-06,"hue",0.449466211201779
"1923",1944,65,24,41,3.71025849370926e-06,"commercial",0.497021956784031
"1924",1945,158,120,38,3.81423166117417e-06,"thick",0.570162522386022
"1925",1946,288,258,30,3.864331064971e-06,"grass",0.605405256827663
"1926",1947,102,66,36,3.73633435708895e-06,"powder",0.51536518362469
"1927",1948,134,104,30,3.75044536538714e-06,"wave",0.525291659400207
"1928",1949,135,99,36,3.77095235401701e-06,"useless",0.539717426968442
"1929",1950,108,68,40,3.65026117618716e-06,"neck",0.454816473916064
"1930",1951,49,14,35,3.6276704188871e-06,"octopus",0.438924866431271
"1931",1952,138,111,27,3.6993603805902e-06,"pen",0.489355611928359
"1932",1953,60,20,40,3.67932477031815e-06,"picky",0.475261438371773
"1933",1954,74,42,32,3.66387601443567e-06,"reach",0.464393915811465
"1934",1955,42,16,26,3.36050864658875e-06,"subtraction",0.250988270773301
"1935",1956,43,9,34,3.58356148674799e-06,"utter",0.407896166205866
"1936",1957,169,137,32,3.78856761835485e-06,"ill",0.552108993257247
"1937",1958,47,18,29,3.58999396881013e-06,"masculine",0.4124211353659
"1938",1959,54,21,33,3.62689414546747e-06,"corruption",0.438378792108846
"1939",1960,75,43,32,3.63673392199933e-06,"software",0.445300643568073
"1940",1961,149,124,25,3.75805633326444e-06,"desire",0.530645641671756
"1941",1962,65,25,40,3.63836142754749e-06,"variable",0.44644552237878
"1942",1963,68,33,35,3.69789663639322e-06,"honesty",0.488325932049657
"1943",1964,76,33,43,3.78879728419011e-06,"worthy",0.552270553104846
"1944",1965,123,92,31,3.68206136523471e-06,"anxiety",0.477186512935731
"1945",1966,107,71,36,3.63488324755009e-06,"formal",0.44399877521816
"1946",1968,59,30,29,3.50408751808985e-06,"disappear",0.351989713031276
"1947",1969,43,4,39,3.74954536762418e-06,"ran",0.524658550425759
"1948",1970,47,9,38,3.62343784535892e-06,"swell",0.435947436490917
"1949",1971,95,65,30,3.74690412047046e-06,"bitch",0.522800548833353
"1950",1972,49,20,29,3.61496305507758e-06,"limb",0.429985793024157
"1951",1973,79,33,46,3.66693924248369e-06,"counter",0.466548762465297
"1952",1974,33,5,28,3.5304127405535e-06,"actually",0.370508353056733
"1953",1975,66,35,31,3.58763700288805e-06,"thumb",0.410763113158353
"1954",1976,91,61,30,3.81083037993979e-06,"attractive",0.567769870134293
"1955",1977,65,31,34,3.67927062139202e-06,"temporary",0.475223346975879
"1956",1978,61,28,33,3.58248309067981e-06,"status",0.40713756184387
"1957",1979,115,77,38,3.70624316661416e-06,"jacket",0.494197350186262
"1958",1980,33,4,29,3.44231709248129e-06,"lately",0.308536926349458
"1959",1981,77,40,37,3.78665959823542e-06,"activity",0.550766784742126
"1960",1982,41,6,35,3.65123411713159e-06,"execute",0.455500895221179
"1961",1983,101,58,43,3.78483944711065e-06,"concert",0.549486388212982
"1962",1984,44,9,35,3.6347114947751e-06,"exception",0.443877954669815
"1963",1985,41,5,36,3.61464945129621e-06,"consideration",0.429765186510927
"1964",1986,136,97,39,3.79851174309905e-06,"beard",0.559104249109707
"1965",1987,45,14,31,3.47983435988447e-06,"lease",0.334928679381658
"1966",1988,54,22,32,3.69334864841906e-06,"accomplish",0.485126621872893
"1967",1989,116,80,36,3.74996718778711e-06,"gentle",0.524955282419709
"1968",1990,68,31,37,3.56413482409213e-06,"variety",0.394230360603777
"1969",1991,29,4,25,3.50428398717432e-06,"relocate",0.352127920419891
"1970",1992,37,11,26,3.52705071546224e-06,"nudge",0.368143315780882
"1971",1993,46,22,24,3.64984816631628e-06,"thirst",0.454525939576373
"1972",1994,46,10,36,3.52281374179184e-06,"portal",0.365162790533366
"1973",1995,146,113,33,3.84542913066384e-06,"coat",0.592108574617189
"1974",1996,42,8,34,3.47088448549344e-06,"despite",0.328632835069253
"1975",1997,116,67,49,3.76680465727728e-06,"code",0.536799704128155
"1976",1998,51,17,34,3.60560455171519e-06,"enhance",0.42340249614283
"1977",1999,50,10,40,3.69709002044491e-06,"auction",0.487758513088385
"1978",2000,44,10,34,3.65452997262757e-06,"cherish",0.457819385087324
"1979",2001,50,20,30,3.61126860254739e-06,"recipe",0.427386907617123
"1980",2002,72,38,34,3.66890347481848e-06,"judgement",0.467930513809832
"1981",2003,55,21,34,3.49224198443159e-06,"devious",0.343656899356869
"1982",2004,80,44,36,3.68809078604279e-06,"repair",0.481427946171897
"1983",2005,36,10,26,3.4887331363362e-06,"yolk",0.341188578533668
"1984",2006,79,42,37,3.77005670165279e-06,"cricket",0.539087374791533
"1985",2007,165,130,35,3.87439220472288e-06,"games",0.612482827608624
"1986",2008,61,26,35,3.73620871956391e-06,"tender",0.515276803133202
"1987",2009,103,60,43,3.73884888320584e-06,"hunt",0.517134042522564
"1988",2010,50,20,30,3.75157097034383e-06,"bureaucracy",0.52608347314585
"1989",2011,163,117,46,3.75588265120245e-06,"drug",0.529116551625456
"1990",2012,129,91,38,3.74557086245515e-06,"ruler",0.521862660263532
"1991",2013,48,14,34,3.61583882036874e-06,"production",0.430601855516935
"1992",2014,85,47,38,3.55224644064907e-06,"excess",0.385867403984108
"1993",2015,58,20,38,3.72726832231926e-06,"acknowledge",0.508987625577838
"1994",2016,310,276,34,3.99894427871042e-06,"tired",0.700099751863851
"1995",2017,59,20,39,3.7146964535793e-06,"inspiration",0.500143867012678
"1996",2018,182,148,34,3.80521847661884e-06,"rules",0.563822142148256
"1997",2019,105,76,29,3.76185926132132e-06,"novel",0.533320834856745
"1998",2020,86,44,42,3.69116740551534e-06,"accent",0.483592213105869
"1999",2021,29,7,22,3.5127777289892e-06,"rover",0.358102895459745
"2000",2022,105,68,37,3.72472772240349e-06,"image",0.507200424905415
"2001",2023,91,57,34,3.73856932429098e-06,"fuck",0.516937385080549
"2002",2024,85,50,35,3.59136062288559e-06,"plenty",0.413382516600099
"2003",2025,45,12,33,3.60815442900956e-06,"illuminate",0.425196223044429
"2004",2026,65,24,41,3.74230488557903e-06,"impact",0.519565188696716
"2005",2027,86,40,46,3.73265249751779e-06,"crisp",0.512775156812314
"2006",2028,72,35,37,3.70381344632434e-06,"corrupt",0.492488148470229
"2007",2029,61,30,31,3.64471334329555e-06,"outcome",0.450913816668516
"2008",2030,38,11,27,3.44014999053959e-06,"parchment",0.307012465129338
"2009",2031,157,117,40,3.74750790724168e-06,"physics",0.523225286359649
"2010",2032,78,37,41,3.69800603514585e-06,"pause",0.48840288927659
"2011",2033,102,66,36,3.72654605079282e-06,"spot",0.508479539220083
"2012",2034,44,17,27,3.34891696025505e-06,"possibly",0.242834027564222
"2013",2035,80,45,35,3.77349946793657e-06,"spray",0.541509209956998
"2014",2036,52,24,28,3.61931992978519e-06,"attempt",0.433050663395443
"2015",2037,43,17,26,3.62874985938594e-06,"dwelling",0.439684205504454
"2016",2038,30,2,28,3.56223038368783e-06,"sensibility",0.392890670261342
"2017",2039,46,12,34,3.51344419420914e-06,"differ",0.358571724527179
"2018",2040,61,36,25,3.63650909672751e-06,"branch",0.445142488844658
"2019",2041,50,9,41,3.65858120220978e-06,"satisfy",0.460669247510978
"2020",2042,54,13,41,3.73777281069302e-06,"booth",0.516377072679909
"2021",2043,43,7,36,3.57172196287552e-06,"seam",0.399567580152327
"2022",2044,51,23,28,3.61117731602857e-06,"tide",0.427322691552719
"2023",2045,50,17,33,3.65850089267422e-06,"negotiate",0.460612753273112
"2024",2046,46,13,33,3.64996806277945e-06,"pursue",0.454610281482499
"2025",2047,47,12,35,3.61697664156485e-06,"distribute",0.431402262851502
"2026",2048,77,37,40,3.70812598728854e-06,"species",0.495521831996417
"2027",2049,102,69,33,3.79608926883525e-06,"alive",0.557400144655344
"2028",2050,41,13,28,3.43562329077741e-06,"solar",0.303828130276525
"2029",2051,57,10,47,3.65158076931504e-06,"fifth",0.455744749836582
"2030",2052,41,12,29,3.45314598865296e-06,"barely",0.316154580116797
"2031",2053,49,16,33,3.69715836408137e-06,"deed",0.487806589840761
"2032",2054,44,17,27,3.50927677314982e-06,"comprehend",0.355640126492684
"2033",2055,114,77,37,3.65744381251943e-06,"guitar",0.459869143721792
"2034",2056,96,61,35,3.77817574562298e-06,"silence",0.544798766322694
"2035",2057,52,20,32,3.61351309356469e-06,"grateful",0.428965808659545
"2036",2058,37,2,35,3.61126860254739e-06,"regulate",0.427386907617123
"2037",2059,88,54,34,3.76112352281874e-06,"soul",0.532803275071602
"2038",2060,45,20,25,3.35763139251047e-06,"stool",0.248964248654931
"2039",2061,112,73,39,3.72532438262062e-06,"achievement",0.507620149213298
"2040",2062,37,8,29,3.5557831256756e-06,"brunch",0.388355306868128
"2041",2063,48,22,26,3.51096474289205e-06,"kangaroo",0.356827539213446
"2042",2064,133,102,31,3.75352831661762e-06,"wise",0.527460380448325
"2043",2065,66,27,39,3.70761729974232e-06,"prejudice",0.495163992606192
"2044",2066,107,73,34,3.68697575813439e-06,"alien",0.480643572916078
"2045",2067,86,54,32,3.6210498872043e-06,"flu",0.434267612606337
"2046",2068,139,91,48,3.64209828566434e-06,"unsure",0.449074238257161
"2047",2069,79,45,34,3.71509666681527e-06,"victory",0.500425399480663
"2048",2070,78,43,35,3.74517808321786e-06,"lover",0.521586357287749
"2049",2071,101,59,42,3.68708451166409e-06,"steam",0.480720076256964
"2050",2072,98,64,34,3.71967073474656e-06,"message",0.503643055764043
"2051",2073,198,169,29,3.89436913167251e-06,"joy",0.626535720020301
"2052",2074,117,77,40,3.8897489556024e-06,"naked",0.623285628682431
"2053",2075,99,66,33,3.71057513914657e-06,"hunger",0.497244702968887
"2054",2076,81,44,37,3.77147857045876e-06,"entertainment",0.540087597168288
"2055",2077,39,6,33,3.69916879677137e-06,"haven",0.489220841109973
"2056",2078,67,32,35,3.65506427430526e-06,"donkey",0.458195242896232
"2057",2079,68,33,35,3.76745745598668e-06,"stare",0.537258919404499
"2058",2080,69,28,41,3.68470699209999e-06,"whatever",0.479047595463234
"2059",2081,102,73,29,3.64374387395561e-06,"enemy",0.450231837484986
"2060",2082,38,3,35,3.59862388622591e-06,"detector",0.418491903971668
"2061",2083,48,14,34,3.50835338942021e-06,"canal",0.354990566515834
"2062",2084,96,58,38,3.4831554601945e-06,"bacon",0.33726492786787
"2063",2085,133,99,34,3.78068974903781e-06,"failure",0.546567257522581
"2064",2086,152,116,36,3.6787698193724e-06,"butter",0.474871054707957
"2065",2087,78,46,32,3.5714030614067e-06,"gain",0.3993432469482
"2066",2088,72,38,34,3.67016923150326e-06,"breeze",0.468820918152576
"2067",2089,54,29,25,3.66305733417339e-06,"yourself",0.463818010134163
"2068",2090,70,30,40,3.67256848422081e-06,"crooked",0.470508687267069
"2069",2091,146,108,38,3.75092366495249e-06,"eggs",0.525628122177962
"2070",2092,154,115,39,3.74244493927883e-06,"electricity",0.519663710335212
"2071",2093,266,234,32,3.88310306532156e-06,"rain",0.618610536195383
"2072",2094,126,82,44,3.76133572554286e-06,"monster",0.53295255038602
"2073",2095,109,62,47,3.85798003881128e-06,"damage",0.600937588324329
"2074",2096,41,14,27,3.53551781193874e-06,"queue",0.374099546993196
"2075",2097,43,14,29,3.64920885152099e-06,"vista",0.454076209642532
"2076",2098,277,236,41,4.00180881758555e-06,"cool",0.70211482939418
"2077",2099,45,12,33,3.55228429641681e-06,"karma",0.385894033857292
"2078",2100,95,67,28,3.66521890519911e-06,"treasure",0.465338580597339
"2079",2101,36,10,26,3.47896271247765e-06,"destitute",0.334315513640007
"2080",2102,63,26,37,3.71379973706298e-06,"sitting",0.499513066251412
"2081",2103,50,9,41,3.77676308742829e-06,"sustain",0.543805023207221
"2082",2104,47,17,30,3.48575372452785e-06,"untruth",0.339092692930324
"2083",2105,105,62,43,3.73873705462295e-06,"ticket",0.517055376016556
"2084",2106,220,184,36,3.79627661189905e-06,"disease",0.557531932288464
"2085",2107,45,12,33,3.62328030058733e-06,"bust",0.435836610650151
"2086",2108,32,6,26,3.47742628725628e-06,"utilize",0.333234705846648
"2087",2109,240,191,49,3.94662583224472e-06,"energy",0.66329601817737
"2088",2110,56,18,38,3.64338543374504e-06,"medium",0.44997969050923
"2089",2111,247,209,38,3.90596010452349e-06,"ugly",0.634689461325565
"2090",2112,30,4,26,3.46816398866604e-06,"amid",0.326719084805354
"2091",2113,85,48,37,3.73915644630571e-06,"burden",0.517350399681162
"2092",2114,61,31,30,3.57096944678541e-06,"toe",0.39903821806981
"2093",2115,108,72,36,3.7321788460103e-06,"actor",0.51244196373952
"2094",2116,106,59,47,3.77412610110129e-06,"golden",0.541950018919634
"2095",2117,94,51,43,3.74048514092278e-06,"reaction",0.518285078100353
"2096",2118,91,56,35,3.76360071207325e-06,"object",0.534545869123473
"2097",2119,48,7,41,3.58838368433706e-06,"governor",0.411288370826625
"2098",2120,51,21,30,3.52661536616847e-06,"engaged",0.367837066636446
"2099",2121,52,17,35,3.693908006915e-06,"replace",0.485520106055056
"2100",2122,43,9,34,3.69605150817382e-06,"restroom",0.487027965229316
"2101",2123,172,128,44,3.91165909108689e-06,"medical",0.638698448555332
"2102",2124,176,138,38,3.90321585954668e-06,"mess",0.632759005279564
"2103",2125,45,18,27,3.62181054309049e-06,"fable",0.43480270067859
"2104",2126,84,38,46,3.72137333561578e-06,"hanging",0.504840760841278
"2105",2127,238,206,32,3.77055423376682e-06,"chocolate",0.539437366824213
"2106",2128,50,9,41,3.59431666648695e-06,"miracle",0.415461963694185
"2107",2129,55,19,36,3.7264210706753e-06,"adolescent",0.508391621185965
"2108",2130,109,82,27,3.64053370224075e-06,"leaf",0.44797362240287
"2109",2131,49,18,31,3.51234589582382e-06,"retail",0.357799119757499
"2110",2132,72,31,41,3.72116561791816e-06,"fart",0.504694640546399
"2111",2133,36,4,32,3.62439653797643e-06,"naturally",0.436621834722621
"2112",2134,56,34,22,3.694986273126e-06,"shampoo",0.48627861906822
"2113",2135,44,11,33,3.69010498348678e-06,"earnings",0.482844845780513
"2114",2136,180,145,35,3.96183956134512e-06,"lonely",0.673998209698988
"2115",2137,94,62,32,3.64379698220734e-06,"stink",0.450269196812053
"2116",2138,67,28,39,3.60058041356267e-06,"reality",0.41986823518784
"2117",2139,79,46,33,3.68405540819334e-06,"content",0.478589234747374
"2118",2140,102,70,32,3.72433930220779e-06,"grab",0.506927188324307
"2119",2141,35,9,26,3.42383675146369e-06,"ballot",0.295536816537462
"2120",2142,68,30,38,3.69478149062264e-06,"pathetic",0.486134563553844
"2121",2143,57,20,37,3.71297238291142e-06,"born",0.498931058873221
"2122",2144,74,39,35,3.60583857381873e-06,"vague",0.423567120434209
"2123",2145,293,252,41,3.88177661151956e-06,"bird",0.617677434091363
"2124",2146,48,20,28,3.55044291775399e-06,"savior",0.384598704685642
"2125",2147,59,30,29,3.7291586645137e-06,"boxing",0.510317398447646
"2126",2148,90,48,42,3.70135950934778e-06,"smash",0.490761911376632
"2127",2149,47,17,30,3.45455361985401e-06,"abrupt",0.317144786962601
"2128",2150,37,18,19,3.57424967563684e-06,"occupation",0.401345715276514
"2129",2151,47,14,33,3.62885520504846e-06,"chasm",0.439758311560164
"2130",2152,79,34,45,3.59127034005739e-06,"lotion",0.413319006588049
"2131",2153,76,41,35,3.73591559819481e-06,"distant",0.515070605099142
"2132",2154,124,97,27,3.73431122496611e-06,"nothing",0.513941998861162
"2133",2155,42,6,36,3.6952593517776e-06,"recreation",0.486470717929104
"2134",2156,73,28,45,3.62678891363165e-06,"hut",0.438304766125229
"2135",2157,179,135,44,3.77126522176925e-06,"newspaper",0.53993751571745
"2136",2158,38,4,34,3.51947855405743e-06,"invoice",0.362816632161629
"2137",2159,46,11,35,3.73622267887166e-06,"unlucky",0.515286622894293
"2138",2160,39,10,29,3.44506838460743e-06,"kilo",0.310472339756098
"2139",2161,134,99,35,3.76096792270459e-06,"faith",0.532693817212098
"2140",2162,88,52,36,3.76747164977584e-06,"innocent",0.537268904112981
"2141",2163,197,160,37,3.81442079927373e-06,"writing",0.570295572748112
"2142",2164,129,92,37,3.77779037041235e-06,"unfair",0.544527671755103
"2143",2165,135,103,32,3.86288310143158e-06,"reading",0.604386677949806
"2144",2166,102,65,37,3.71397904573022e-06,"property",0.499639202038745
"2145",2167,143,102,41,3.83996559390828e-06,"interesting",0.588265216006193
"2146",2168,55,21,34,3.57889311993587e-06,"ankle",0.404612174793452
"2147",2169,36,15,21,3.37154416722859e-06,"seldom",0.258751275796524
"2148",2170,48,11,37,3.66558165449694e-06,"buggy",0.465593758827081
"2149",2171,52,21,31,3.61619186067536e-06,"objective",0.430850203896962
"2150",2172,126,84,42,3.80969796714516e-06,"exciting",0.566973267373089
"2151",2173,52,22,30,3.70134580933627e-06,"tile",0.490752274019082
"2152",2174,36,13,23,3.61201210746458e-06,"tardy",0.427909930734504
"2153",2175,103,72,31,3.63031750756921e-06,"trial",0.440786977282836
"2154",2176,104,62,42,3.7014554122681e-06,"factory",0.490829374877131
"2155",2177,100,56,44,3.78907004853799e-06,"slave",0.552462430866835
"2156",2178,61,22,39,3.68825401743069e-06,"witness",0.481542772297964
"2157",2179,65,23,42,3.6536754147835e-06,"looks",0.457218241103941
"2158",2180,47,10,37,3.60235738267122e-06,"slash",0.421118255061484
"2159",2181,54,24,30,3.64621504647101e-06,"wit",0.451970199024634
"2160",2183,101,65,36,3.8121959773708e-06,"dislike",0.568730508065449
"2161",2184,62,20,42,3.6784856410313e-06,"extraordinary",0.474671147702075
"2162",2185,244,198,46,3.98439710095267e-06,"sexy",0.689866449993215
"2163",2186,51,21,30,3.65304810333742e-06,"primary",0.456776955000099
"2164",2187,55,14,41,3.73506441118577e-06,"hazard",0.514471832350443
"2165",2188,128,89,39,3.8803155472603e-06,"peaceful",0.616649639431371
"2166",2189,98,57,41,3.7409609032176e-06,"player",0.518619756019511
"2167",2191,69,26,43,3.68821320822914e-06,"liberal",0.481514064813565
"2168",2192,105,68,37,3.7318167230171e-06,"laundry",0.512187226087624
"2169",2193,134,96,38,3.80307668904143e-06,"cozy",0.562315488473756
"2170",2194,70,23,47,3.74430865085071e-06,"citizen",0.52097474972941
"2171",2195,132,85,47,3.83999508480629e-06,"lines",0.588285961560198
"2172",2196,61,28,33,3.67368830958906e-06,"cushion",0.471296435325596
"2173",2197,70,31,39,3.76667696225036e-06,"invisible",0.536709876274289
"2174",2198,80,56,24,3.64319960361988e-06,"hurry",0.449848967162131
"2175",2199,45,13,32,3.47216194163296e-06,"affirm",0.329531469465552
"2176",2200,142,101,41,3.81316992629143e-06,"bone",0.569415638437625
"2177",2201,119,81,38,3.76330327708449e-06,"adventure",0.534336636647074
"2178",2202,84,35,49,3.79695408343427e-06,"stroke",0.558008503816228
"2179",2203,32,2,30,3.59976385549108e-06,"grizzly",0.419293822378662
"2180",2204,48,15,33,3.55199408948184e-06,"got",0.385689885999885
"2181",2205,44,19,25,3.47893850628296e-06,"reply",0.334298485643136
"2182",2206,45,13,32,3.584961802232e-06,"upper",0.408881226765419
"2183",2207,81,44,37,3.75576980135734e-06,"kitten",0.529037166706244
"2184",2208,104,51,53,3.78720455070499e-06,"falling",0.551150134916239
"2185",2209,223,179,44,3.80254161881802e-06,"cooking",0.561939090026621
"2186",2210,39,4,35,3.6244228106674e-06,"import",0.436640316409046
"2187",2211,36,2,34,3.5938128917256e-06,"stipend",0.415107580232767
"2188",2212,79,49,30,3.6233590712606e-06,"jar",0.435892022365849
"2189",2213,53,15,38,3.57293430802981e-06,"remark",0.400420411824687
"2190",2214,40,14,26,3.4185112383557e-06,"falsehood",0.2917905515122
"2191",2215,65,37,28,3.67795799771967e-06,"tin",0.474299973761817
"2192",2217,40,9,31,3.67524100392883e-06,"technique",0.472388687730585
"2193",2218,46,13,33,3.65749732088321e-06,"ledge",0.459906784510151
"2194",2219,22,2,20,3.5239185974804e-06,"peasy",0.365940008078428
"2195",2220,93,60,33,3.61954263459269e-06,"royal",0.433207326465156
"2196",2221,87,45,42,3.72984021364525e-06,"talent",0.510796838385685
"2197",2222,83,44,39,3.70029121291846e-06,"reliable",0.490010411667845
"2198",2223,46,10,36,3.62461986799134e-06,"retirement",0.436778937598346
"2199",2224,46,13,33,3.64424846486033e-06,"dye",0.450586795067493
"2200",2225,95,58,37,3.79000348680321e-06,"tire",0.55311906376874
"2201",2226,61,29,32,3.54411358175207e-06,"calculus",0.38014629425752
"2202",2227,60,24,36,3.57649953684331e-06,"confirm",0.402928394011607
"2203",2228,52,11,41,3.64634800016044e-06,"magnetic",0.452063726117063
"2204",2229,65,19,46,3.69613347477204e-06,"expected",0.487085625138124
"2205",2230,83,40,43,3.69272127709073e-06,"goals",0.484685293644507
"2206",2231,40,13,27,3.46180075951909e-06,"manure",0.322242832035424
"2207",2232,68,29,39,3.63439445536782e-06,"bruise",0.443654931344354
"2208",2233,55,20,35,3.68382469415045e-06,"disk",0.478426937531656
"2209",2234,39,5,34,3.55296583823347e-06,"locale",0.386373468649623
"2210",2235,134,93,41,3.64492589865648e-06,"corn",0.451063340047474
"2211",2236,145,89,56,3.84430562229697e-06,"growth",0.591318235730584
"2212",2237,51,15,36,3.63813640100995e-06,"intent",0.446287226073756
"2213",2238,61,29,32,3.58181583735691e-06,"swallow",0.406668178380549
"2214",2239,56,21,35,3.64245647264515e-06,"fuzz",0.449326207096881
"2215",2240,47,9,38,3.57047219494778e-06,"ounce",0.398688423199289
"2216",2241,170,134,36,3.78203382651054e-06,"chemistry",0.547512757106419
"2217",2242,263,225,38,3.9521630188202e-06,"grey",0.667191186208207
"2218",2243,111,67,44,3.75993562990202e-06,"model",0.531967644476498
"2219",2244,65,29,36,3.67147630062048e-06,"log",0.469740383980586
"2220",2245,62,28,34,3.61989639856507e-06,"smack",0.433456183912326
"2221",2246,48,23,25,3.43551706249549e-06,"parcel",0.303753403336756
"2222",2247,54,14,40,3.68013719551465e-06,"cottage",0.475832943884493
"2223",2248,86,40,46,3.8065220949575e-06,"shoulder",0.564739180504823
"2224",2250,26,8,18,3.42887316941034e-06,"loathe",0.299079715789329
"2225",2251,112,81,31,3.70399179195419e-06,"storm",0.492613606802971
"2226",2252,37,5,32,3.55689611017841e-06,"March",0.389138242677693
"2227",2253,50,7,43,3.74822427874794e-06,"affairs",0.523729222311842
"2228",2254,140,99,41,3.70323737010895e-06,"toilet",0.492082904105259
"2229",2255,188,151,37,3.8337825248525e-06,"fresh",0.583915697963004
"2230",2256,66,32,34,3.65823321968422e-06,"sperm",0.460424457058213
"2231",2257,105,65,40,3.84997420517283e-06,"homework",0.59530583529892
"2232",2258,55,19,36,3.77948946656286e-06,"protected",0.545722911416359
"2233",2259,65,25,40,3.70955655960886e-06,"spine",0.496528176913995
"2234",2260,110,76,34,3.75864959237445e-06,"bridge",0.531062973449878
"2235",2261,29,4,25,3.42661727768964e-06,"sterling",0.297492794851824
"2236",2262,57,28,29,3.58163623469746e-06,"boundary",0.406541835782589
"2237",2263,61,25,36,3.64192585038969e-06,"humble",0.44895293760022
"2238",2264,102,58,44,3.78741970670222e-06,"giving",0.551301487728832
"2239",2265,116,82,34,3.66020153069628e-06,"dessert",0.461809077573416
"2240",2266,61,23,38,3.66013454654593e-06,"sunlight",0.461761957159925
"2241",2267,54,17,37,3.62761777968026e-06,"pledge",0.43888783705672
"2242",2268,59,24,35,3.68602443834203e-06,"graduate",0.479974361143672
"2243",2269,319,280,39,3.93874464330729e-06,"gold",0.65775194723527
"2244",2270,98,61,37,3.71944937271486e-06,"carpet",0.503487337278247
"2245",2271,62,22,40,3.61552506462751e-06,"metric",0.430381142106598
"2246",2272,84,54,30,3.65362201818773e-06,"rose",0.457180678939479
"2247",2273,331,298,33,3.92992163736255e-06,"evil",0.6515453493135
"2248",2274,70,30,40,3.67182680727315e-06,"flip",0.46998695004613
"2249",2275,75,49,26,3.59328343460404e-06,"liquor",0.414735130356731
"2250",2276,29,3,26,3.549333967481e-06,"oneself",0.383818606779918
"2251",2277,50,18,32,3.62309651566808e-06,"velocity",0.43570732601575
"2252",2278,91,50,41,3.70789224865125e-06,"moral",0.49535740711112
"2253",2279,74,50,24,3.62326717247476e-06,"temperature",0.435827375598435
"2254",2280,79,48,31,3.74680584801457e-06,"brick",0.522731418468448
"2255",2281,78,32,46,3.64943524989508e-06,"suck",0.45423547097443
"2256",2282,36,5,31,3.4841991568238e-06,"conjunction",0.337999122695684
"2257",2283,109,76,33,3.65294134837371e-06,"tail",0.456701857562777
"2258",2284,338,303,35,3.92290703102627e-06,"anger",0.646610881244285
"2259",2285,56,14,42,3.59063848733582e-06,"tracks",0.412874525895967
"2260",2286,51,20,31,3.54475429535602e-06,"formula",0.380597008191936
"2261",2287,80,40,40,3.76497518881351e-06,"divorce",0.535512753259447
"2262",2288,206,170,36,3.76360071207325e-06,"sugar",0.534545869123473
"2263",2289,122,86,36,3.82032258803933e-06,"hug",0.574447222437202
"2264",2290,97,59,38,3.87338673442511e-06,"aid",0.611775523329375
"2265",2291,48,20,28,3.61459718928923e-06,"singular",0.429728422479939
"2266",2292,45,15,30,3.51153187066326e-06,"affirmative",0.357226488740194
"2267",2293,47,16,31,3.58638893670741e-06,"interior",0.409885153309803
"2268",2294,120,91,29,3.69130365771279e-06,"pet",0.483688060554102
"2269",2295,63,27,36,3.71272424854461e-06,"capital",0.498756507223254
"2270",2296,63,27,36,3.6649905443244e-06,"cupboard",0.465177938732274
"2271",2297,70,33,37,3.66782692258318e-06,"dinosaur",0.467173206503437
"2272",2298,76,39,37,3.63980490645701e-06,"armor",0.447460946516097
"2273",2299,180,142,38,3.84191296530368e-06,"weight",0.589635106418978
"2274",2300,106,66,40,3.7628642922993e-06,"prayer",0.534027830093781
"2275",2301,68,29,39,3.79758853128264e-06,"advertisement",0.558454810066253
"2276",2302,68,40,28,3.78007522349695e-06,"patient",0.546134965742579
"2277",2303,51,16,35,3.61719905808137e-06,"midnight",0.431558723121145
"2278",2304,227,187,40,3.81615301247119e-06,"mountain",0.571514108800193
"2279",2305,189,145,44,3.78994603116852e-06,"plastic",0.553078646248328
"2280",2306,176,142,34,3.86960963378014e-06,"girls",0.60911849859651
"2281",2307,43,10,33,3.52724976808333e-06,"extend",0.368283340574259
"2282",2308,75,36,39,3.63042294427301e-06,"capable",0.440861147382092
"2283",2309,46,8,38,3.68885265615836e-06,"assurance",0.481963888401286
"2284",2310,60,16,44,3.65629376126596e-06,"restrain",0.459060133077976
"2285",2311,41,8,33,3.52130034579169e-06,"our",0.36409818278764
"2286",2312,431,394,37,4.02498712004122e-06,"loud",0.718419749140649
"2287",2313,82,53,29,3.61765706058129e-06,"coin",0.431880907803098
"2288",2314,71,40,31,3.67802563583868e-06,"ceremony",0.474347554213599
"2289",2315,35,12,23,3.29931737123589e-06,"numerous",0.207942890909065
"2290",2316,63,21,42,3.54526954684365e-06,"script",0.380959465027207
"2291",2317,41,4,37,3.71159427820626e-06,"safeguard",0.497961622622971
"2292",2318,60,36,24,3.6430403357426e-06,"assist",0.449736929192037
"2293",2319,105,68,37,3.8035395739275e-06,"plain",0.562641107700338
"2294",2320,82,41,41,3.78852455911045e-06,"thanks",0.552078702966335
"2295",2321,32,8,24,3.54520670327683e-06,"prefer",0.38091525733273
"2296",2322,225,189,36,3.88088779189127e-06,"mouth",0.617052188444663
"2297",2323,50,13,37,3.59723875952819e-06,"banking",0.417517528057459
"2298",2324,117,80,37,3.64539094995243e-06,"sentence",0.451390483248444
"2299",2325,64,29,35,3.59356751414967e-06,"bargain",0.414934967864333
"2300",2326,83,45,38,3.66462791200495e-06,"fog",0.464922842791695
"2301",2327,96,56,40,3.70090746250981e-06,"tooth",0.490443916241788
"2302",2328,66,24,42,3.63961944139121e-06,"quilt",0.447330479972245
"2303",2329,42,14,28,3.54821311987283e-06,"norm",0.383030139620419
"2304",2330,30,7,23,3.58619601430175e-06,"calender",0.409749440854261
"2305",2331,52,18,34,3.67430922986479e-06,"adore",0.471733225521255
"2306",2332,58,23,35,3.65040775054574e-06,"complain",0.454919582552174
"2307",2333,108,73,35,3.65451661708706e-06,"bush",0.45780999005002
"2308",2334,97,54,43,3.65119412303794e-06,"singer",0.455472761129454
"2309",2335,43,16,27,3.5145802361095e-06,"preference",0.359370880205184
"2310",2336,29,5,24,3.28056005721297e-06,"cooker",0.194747942729058
"2311",2337,95,50,45,3.75381011726903e-06,"guilt",0.527658614853735
"2312",2338,82,46,36,3.68727484577973e-06,"promise",0.480853967963935
"2313",2339,60,28,32,3.60786803861862e-06,"static",0.42499475995845
"2314",2340,64,20,44,3.63907640240907e-06,"realize",0.446948475852663
"2315",2341,86,50,36,3.68707091712202e-06,"habit",0.480710513092539
"2316",2342,53,18,35,3.63703814161899e-06,"kindergarten",0.445514648734902
"2317",2343,49,21,28,3.67607865337887e-06,"donation",0.472977937399953
"2318",2344,60,31,29,3.6426156894743e-06,"essential",0.449438209156845
"2319",2345,41,9,32,3.46188465000346e-06,"brow",0.322301845313806
"2320",2346,42,14,28,3.44635065928688e-06,"UK",0.311374363784014
"2321",2347,214,175,39,3.8743621831256e-06,"movement",0.612461708730947
"2322",2348,90,70,20,3.75879087215225e-06,"neat",0.531162357580495
"2323",2349,64,31,33,3.72285572817197e-06,"playground",0.505883559023227
"2324",2350,68,30,38,3.71557979764952e-06,"chore",0.500765260844308
"2325",2351,108,80,28,3.75807045630491e-06,"height",0.530655576611643
"2326",2352,83,40,43,3.70118141710834e-06,"lame",0.490636631292936
"2327",2353,106,65,41,3.64281473008564e-06,"speaker",0.449578225501893
"2328",2354,52,19,33,3.63114798743623e-06,"setting",0.441371183464831
"2329",2355,53,26,27,3.63112161715632e-06,"daughter",0.441352633128871
"2330",2356,66,26,40,3.76187341295965e-06,"management",0.533330789913973
"2331",2357,76,42,34,3.64952848092027e-06,"feminine",0.454301054913826
"2332",2358,49,17,32,3.46661304971816e-06,"surely",0.325628067241615
"2333",2359,101,60,41,3.78918490843435e-06,"turkey",0.552543229768989
"2334",2360,67,39,28,3.73802430463403e-06,"days",0.51655398764306
"2335",2361,119,83,36,3.7668756027001e-06,"couch",0.536849611123184
"2336",2362,66,30,36,3.71998898883259e-06,"items",0.503866933562759
"2337",2363,72,35,37,3.74198280184704e-06,"affection",0.519338616909947
"2338",2364,60,19,41,3.72363203068273e-06,"uncertainty",0.506429653809986
"2339",2365,70,27,43,3.64971495726184e-06,"honorable",0.45443223284585
"2340",2366,95,66,29,3.65359532047511e-06,"us",0.457161898268959
"2341",2367,106,76,30,3.63038340479138e-06,"baking",0.440833333089997
"2342",2368,79,36,43,3.73845751243037e-06,"stock",0.516858730337933
"2343",2369,482,448,34,4.09399819864079e-06,"dark",0.766966017804433
"2344",2370,60,17,43,3.64085181369033e-06,"sideways",0.448197399863096
"2345",2371,40,2,38,3.66998065920193e-06,"hopefully",0.468688265804734
"2346",2372,266,233,33,3.90027769977222e-06,"hat",0.630692138673761
"2347",2373,33,7,26,3.49511034063345e-06,"concur",0.345674662209226
"2348",2374,200,165,35,3.89874187599662e-06,"weak",0.629611753971133
"2349",2375,41,15,26,3.59268959521166e-06,"mule",0.414317390375407
"2350",2376,88,55,33,3.71204893965322e-06,"socks",0.498281457020623
"2351",2377,64,34,30,3.67275732255991e-06,"cable",0.470641526760816
"2352",2378,97,64,33,3.66883617178959e-06,"repeat",0.467883169079262
"2353",2379,36,7,29,3.61434896539261e-06,"remind",0.429553807849673
"2354",2380,79,35,44,3.6229521263106e-06,"advice",0.435605754432135
"2355",2381,76,43,33,3.5369809038401e-06,"organ",0.375128768010528
"2356",2382,68,24,44,3.64799743180981e-06,"machinery",0.453224028978831
"2357",2383,91,44,47,3.81216691191607e-06,"trap",0.568710061792141
"2358",2384,67,30,37,3.65971929952973e-06,"battery",0.461469849086561
"2359",2385,102,67,35,3.78280638840343e-06,"debt",0.548056220532473
"2360",2386,41,8,33,3.48324038886896e-06,"rental",0.337324671467465
"2361",2387,42,16,26,3.54332243171132e-06,"dial",0.379589754884263
"2362",2388,110,66,44,3.71337222471843e-06,"horn",0.499212330057217
"2363",2389,144,115,29,3.69006413331464e-06,"juice",0.482816109475095
"2364",2390,71,38,33,3.5749907943987e-06,"exit",0.401867059838217
"2365",2391,163,118,45,3.85603121842874e-06,"flag",0.599566678612616
"2366",2392,29,3,26,3.50650807899461e-06,"bestow",0.353692471521423
"2367",2393,43,14,29,3.55056897867883e-06,"resume",0.384687383020333
"2368",2394,67,30,37,3.72051491926483e-06,"fabulous",0.504236902567443
"2369",2395,100,61,39,3.66589071979764e-06,"detective",0.465811172718116
"2370",2396,31,2,29,3.35748484095594e-06,"personnel",0.248861156060474
"2371",2397,100,60,40,3.74297723895541e-06,"charity",0.520038159824095
"2372",2398,76,33,43,3.70310023551718e-06,"permission",0.491986435931301
"2373",2399,91,52,39,3.72957590992328e-06,"official",0.510610912303152
"2374",2400,63,31,32,3.63002758820967e-06,"willing",0.440583031722141
"2375",2401,46,22,24,3.58964602500547e-06,"disagreement",0.412176372151593
"2376",2402,96,65,31,3.61403546814408e-06,"grain",0.429333276277626
"2377",2403,104,78,26,3.60108608756401e-06,"waves",0.420223954681343
"2378",2404,110,68,42,3.78139026594518e-06,"outdoors",0.547060040459444
"2379",2405,118,75,43,3.82581815121164e-06,"natural",0.578313110228485
"2380",2406,58,23,35,3.7259073515878e-06,"supermarket",0.508030242327007
"2381",2407,94,66,28,3.78621514788956e-06,"darkness",0.550454133406496
"2382",2408,99,71,28,3.71631163502847e-06,"climb",0.50128007635998
"2383",2409,79,36,43,3.80904495815764e-06,"modern",0.566513904175303
"2384",2410,105,70,35,3.78968750236856e-06,"security",0.552896782570279
"2385",2411,38,10,28,3.5942003982374e-06,"cub",0.415380174077299
"2386",2412,56,32,24,3.59738110655443e-06,"lesson",0.417617662950576
"2387",2413,148,113,35,3.69157619228682e-06,"fabric",0.483879776680256
"2388",2414,68,25,43,3.76779813644704e-06,"rap",0.537498573174487
"2389",2415,74,32,42,3.61973916159602e-06,"roast",0.433345574597145
"2390",2416,38,8,30,3.55827565961535e-06,"solemn",0.390108695233421
"2391",2417,37,4,33,3.48019767522795e-06,"faculty",0.335184255799711
"2392",2418,47,8,39,3.58407523690737e-06,"aspire",0.408257566922528
"2393",2419,95,60,35,3.665742899456e-06,"sewing",0.465707187587542
"2394",2420,54,15,39,3.73060551458107e-06,"coach",0.511335194046733
"2395",2421,40,9,31,3.62613135298213e-06,"gallery",0.437842201032753
"2396",2422,82,55,27,3.77644930683273e-06,"lust",0.543584292312956
"2397",2423,210,173,37,3.93952048156698e-06,"stress",0.658297715441756
"2398",2424,75,35,40,3.59462675193121e-06,"taken",0.415680095211492
"2399",2425,80,35,45,3.81411527782016e-06,"worthless",0.570080651798187
"2400",2426,53,16,37,3.67027699580487e-06,"freak",0.468896725614862
"2401",2427,70,38,32,3.65331501804738e-06,"slip",0.456964717798226
"2402",2428,126,79,47,3.76972982346355e-06,"sexual",0.538857430314252
"2403",2429,64,35,29,3.67335094092884e-06,"complicated",0.471059111261837
"2404",2430,56,22,34,3.64091809390656e-06,"inner",0.44824402508979
"2405",2431,49,11,38,3.7099694298519e-06,"wed",0.49681861303162
"2406",2432,54,25,29,3.50368237017105e-06,"urine",0.351704709230236
"2407",2433,58,15,43,3.68147848175827e-06,"survive",0.47677647996101
"2408",2434,131,104,27,3.75634822850618e-06,"painting",0.529444064849844
"2409",2435,218,191,27,3.87050827514669e-06,"male",0.609750653405537
"2410",2436,64,32,32,3.57768952810275e-06,"geography",0.403765500698834
"2411",2437,98,67,31,3.72041802616942e-06,"spin",0.504168742522177
"2412",2438,73,43,30,3.615172154498e-06,"alphabet",0.430132885300457
"2413",2439,50,20,30,3.52698851612539e-06,"depart",0.368099561273945
"2414",2440,47,14,33,3.73341895307466e-06,"favorite",0.513314324698656
"2415",2441,74,32,42,3.7149310508797e-06,"defend",0.500308895929833
"2416",2442,436,409,27,4.018904928785e-06,"movie",0.714141194207436
"2417",2443,68,32,36,3.7077272744126e-06,"meaningful",0.495241354965947
"2418",2444,204,178,26,3.76351572585046e-06,"yummy",0.534486085041146
"2419",2445,78,41,37,3.80807311500381e-06,"married",0.565830255117754
"2420",2446,57,20,37,3.67655168864019e-06,"mall",0.473310696970584
"2421",2447,129,95,34,3.69062249729662e-06,"breakfast",0.483208894060289
"2422",2448,46,12,34,3.69721304080984e-06,"vacant",0.487845052522461
"2423",2449,97,69,28,3.61849485088183e-06,"feather",0.432470256554622
"2424",2450,46,7,39,3.57265348119355e-06,"interaction",0.400222862455546
"2425",2451,48,21,27,3.6110729942295e-06,"reflection",0.427249305740068
"2426",2452,46,12,34,3.71034109165656e-06,"optimistic",0.497080060819238
"2427",2453,55,26,29,3.5749907943987e-06,"stocks",0.401867059838217
"2428",2454,40,9,31,3.39385711861531e-06,"thrift",0.27444745899903
"2429",2455,98,54,44,3.73925431790392e-06,"bond",0.517419248060258
"2430",2456,61,21,40,3.75465577315872e-06,"perfection",0.528253496702433
"2431",2457,77,45,32,3.64602892759351e-06,"manager",0.451839272552916
"2432",2458,83,40,43,3.87094276811117e-06,"gang",0.610056300159859
"2433",2459,52,16,36,3.65607987803317e-06,"user",0.458909675599381
"2434",2460,144,107,37,3.73858330124383e-06,"weapon",0.516947217254191
"2435",2461,55,20,35,3.68489708082453e-06,"cone",0.479181314548328
"2436",2462,55,25,30,3.60435694667714e-06,"beg",0.422524860687883
"2437",2463,56,13,43,3.6244096742743e-06,"epic",0.436631075532341
"2438",2464,36,11,25,3.45804184922246e-06,"attain",0.319598603415234
"2439",2465,35,10,25,3.34234652780331e-06,"plural",0.23821201635222
"2440",2466,54,17,37,3.71215917738553e-06,"backward",0.49835900443298
"2441",2467,31,2,29,3.44835909832306e-06,"contradict",0.312787212605158
"2442",2468,96,55,41,3.68588857558836e-06,"risk",0.479878787652071
"2443",2469,43,7,36,3.63176779929398e-06,"assert",0.441807193937037
"2444",2470,39,15,24,3.44870397704543e-06,"cease",0.31302981966843
"2445",2471,149,120,29,3.82384319183839e-06,"emotion",0.57692381288262
"2446",2472,45,11,34,3.65611997923324e-06,"washer",0.458937885035772
"2447",2473,42,11,31,3.66235973162228e-06,"stroll",0.463327277319168
"2448",2474,37,6,31,3.61056451176141e-06,"somebody",0.426891610613318
"2449",2475,69,31,38,3.58994241732363e-06,"cigarettes",0.412384871154925
"2450",2476,66,36,30,3.58275262884474e-06,"cart",0.407327170127573
"2451",2477,60,23,37,3.67355335468892e-06,"used",0.471201500469157
"2452",2478,107,64,43,3.61668884902494e-06,"agreement",0.431199813415189
"2453",2479,146,104,42,3.82479384361183e-06,"magazine",0.577592554732995
"2454",2480,143,111,32,3.75655989271265e-06,"mental",0.529592961340705
"2455",2481,77,45,32,3.54846493406952e-06,"laws",0.383207279869404
"2456",2482,63,30,33,3.63377374671143e-06,"toss",0.443218290013625
"2457",2483,45,18,27,3.59363208394725e-06,"apology",0.41498038988648
"2458",2484,45,21,24,3.5983519548047e-06,"grocery",0.418300612137081
"2459",2485,38,9,29,3.44674265585309e-06,"combustion",0.311650116184997
"2460",2486,79,45,34,3.58822917302082e-06,"gravity",0.411179678888721
"2461",2487,76,31,45,3.68383826476482e-06,"planning",0.478436483863991
"2462",2488,67,32,35,3.5083041559371e-06,"scam",0.354955932918641
"2463",2489,66,26,40,3.76958772019104e-06,"blocks",0.538757466891201
"2464",2490,42,18,24,3.55137598062369e-06,"comb",0.385255073513256
"2465",2491,43,15,28,3.3950208624032e-06,"visible",0.275266101740592
"2466",2492,223,185,38,3.81858658836018e-06,"internet",0.57322602276123
"2467",2493,431,387,44,3.89862027828352e-06,"computer",0.629526215310256
"2468",2494,68,27,41,3.82241079448808e-06,"nationality",0.575916184136448
"2469",2495,153,107,46,3.80569636632111e-06,"destroy",0.5641583166053
"2470",2496,65,30,35,3.60577356463169e-06,"cord",0.423521389320833
"2471",2497,94,48,46,3.64070600570863e-06,"fraud",0.448094830339525
"2472",2498,55,15,40,3.63992414398084e-06,"approve",0.447544824887279
"2473",2499,60,25,35,3.7208194732808e-06,"monopoly",0.504451142967418
"2474",2500,55,11,44,3.73372562343884e-06,"critique",0.513530053856825
"2475",2501,216,188,28,3.81760987081208e-06,"orange",0.572538944780984
"2476",2502,114,75,39,3.73506441118577e-06,"mass",0.514471832350443
"2477",2503,235,197,38,3.83310654119631e-06,"bread",0.583440173092921
"2478",2504,63,32,31,3.54100125351444e-06,"carpenter",0.37795690777263
"2479",2505,103,62,41,3.80103844370282e-06,"insurance",0.560881672225423
"2480",2506,67,27,40,3.66477564243517e-06,"rescue",0.465026764673523
"2481",2507,205,166,39,3.82700410637541e-06,"nasty",0.579147377699331
"2482",2508,56,26,30,3.58050771599413e-06,"lid",0.40574797234391
"2483",2509,116,78,38,3.73006281425779e-06,"destruction",0.510953428158814
"2484",2510,122,87,35,3.72974283423158e-06,"amazing",0.510728336236839
"2485",2511,55,20,35,3.7096116036651e-06,"host",0.496566897994673
"2486",2512,112,83,29,3.70742485976665e-06,"fluid",0.495028619519002
"2487",2513,39,7,32,3.57168369169226e-06,"pant",0.399540658052539
"2488",2514,53,18,35,3.6646413415519e-06,"elaborate",0.464932289889283
"2489",2515,68,33,35,3.5773439651996e-06,"website",0.403522412344367
"2490",2516,58,15,43,3.7129034533715e-06,"attract",0.498882569963449
"2491",2517,48,14,34,3.71466885584485e-06,"sheriff",0.500124453216252
"2492",2518,147,104,43,3.86784352252245e-06,"bully",0.607876116744989
"2493",2519,138,93,45,3.71304131501071e-06,"pop",0.498979549583408
"2494",2521,46,16,30,3.57470964420915e-06,"handbag",0.401669283004207
"2495",2522,120,78,42,3.72221829321402e-06,"shot",0.505435151472557
"2496",2523,107,66,41,3.75775977393317e-06,"nail",0.530437025182021
"2497",2524,47,12,35,3.64944856832133e-06,"hospitality",0.454244839903477
"2498",2525,171,132,39,3.84800384800385e-06,"cream",0.593919775402019
"2499",2526,64,30,34,3.52940346022715e-06,"fraction",0.369798368589396
"2500",2527,63,32,31,3.60507161474763e-06,"that",0.423027598347679
"2501",2528,57,22,35,3.54352332524229e-06,"rhyme",0.379731074677044
"2502",2529,119,76,43,3.7664357841531e-06,"logic",0.536540218055011
"2503",2530,43,15,28,3.56709709638296e-06,"concentrate",0.396314189307871
"2504",2531,79,39,40,3.82577424106203e-06,"orgasm",0.578282221363061
"2505",2532,58,25,33,3.74639877417832e-06,"port",0.52244505986891
"2506",2533,38,6,32,3.57547652163342e-06,"recorder",0.402208747655773
"2507",2534,96,56,40,3.70188018494593e-06,"vomit",0.491128183835887
"2508",2535,64,24,40,3.75938436321668e-06,"national",0.531579852528382
"2509",2536,129,89,40,3.72001666567466e-06,"distance",0.503886403007929
"2510",2537,76,35,41,3.74324344558073e-06,"torture",0.520225424515721
"2511",2538,78,35,43,3.77736226792831e-06,"routine",0.544226520423642
"2512",2540,34,7,27,3.43926262209382e-06,"earl",0.306388240325929
"2513",2541,129,88,41,3.71714047817295e-06,"sheep",0.50186313117942
"2514",2542,43,22,21,3.49001158683847e-06,"snail",0.342087912420572
"2515",2543,217,181,36,3.82849857771278e-06,"military",0.580198672774363
"2516",2544,130,88,42,3.72526887128079e-06,"guns",0.507581099419091
"2517",2545,51,13,38,3.68001530886369e-06,"torso",0.475747201968495
"2518",2546,110,76,34,3.75088145714243e-06,"elephant",0.525598430833778
"2519",2547,44,12,32,3.56374107282861e-06,"assembly",0.393953373850156
"2520",2548,56,24,32,3.65605314438851e-06,"diaper",0.458890869652238
"2521",2549,39,14,25,3.46055486536711e-06,"haste",0.321366400113829
"2522",2550,50,18,32,3.32932704312477e-06,"definitely",0.229053379595713
"2523",2551,71,31,40,3.70592726005974e-06,"shrink",0.493975123773129
"2524",2552,51,18,33,3.53838260531111e-06,"suggestion",0.376114803551184
"2525",2553,56,23,33,3.59899947814508e-06,"scrub",0.418756116422566
"2526",2554,52,21,31,3.53693086361241e-06,"application",0.375093566903882
"2527",2555,61,31,30,3.58435786228897e-06,"ceiling",0.408456381489474
"2528",2556,107,76,31,3.62005364919508e-06,"beginning",0.433566802837386
"2529",2557,46,10,36,3.52853170738592e-06,"annual",0.369185128679261
"2530",2558,51,10,41,3.73125974791609e-06,"lives",0.511795418519314
"2531",2559,256,220,36,3.93131211473141e-06,"expensive",0.652523489190306
"2532",2560,40,10,30,3.43522201839905e-06,"shrub",0.303545852748298
"2533",2561,46,7,39,3.53862050418265e-06,"telling",0.376282154978908
"2534",2562,120,88,32,3.67146282093174e-06,"lion",0.469730901610449
"2535",2563,81,36,45,3.85510956221376e-06,"sturdy",0.598918333866579
"2536",2564,63,17,46,3.7569127194037e-06,"making",0.529841159451547
"2537",2565,67,28,39,3.83659187870231e-06,"volunteer",0.585891955247087
"2538",2566,104,65,39,3.7715639166937e-06,"stubborn",0.540147634503374
"2539",2567,81,39,42,3.72342406076628e-06,"academic",0.506283356090218
"2540",2568,72,29,43,3.63391899994549e-06,"conquer",0.443320469296544
"2541",2569,53,11,42,3.67088328793674e-06,"cooperation",0.46932322555255
"2542",2570,36,5,31,3.63485682298974e-06,"locomotive",0.443980186698288
"2543",2571,68,39,29,3.60082674982176e-06,"vase",0.420041521947854
"2544",2572,89,53,36,3.73831775700935e-06,"prevent",0.516760418525481
"2545",2573,110,77,33,3.7755082778019e-06,"useful",0.542922319640188
"2546",2574,305,272,33,4.01408139754258e-06,"smile",0.710748051420005
"2547",2575,58,27,31,3.61327807426732e-06,"turtle",0.428800482886015
"2548",2576,95,60,35,3.7474657762688e-06,"skinny",0.523195649067054
"2549",2577,64,25,39,3.69633840717385e-06,"forceful",0.487229786099497
"2550",2578,50,22,28,3.58205961263607e-06,"considerate",0.406839663603446
"2551",2579,440,407,33,3.97023908779787e-06,"sweet",0.679906908361553
"2552",2580,127,93,34,3.70655912703119e-06,"path",0.494419614489381
"2553",2581,146,102,44,3.7227171367838e-06,"honor",0.505786066056864
"2554",2582,87,43,44,3.68843086774025e-06,"pad",0.481667178738427
"2555",2583,123,86,37,3.7354829792718e-06,"fuzzy",0.514766276650852
"2556",2584,96,60,36,3.61984398472426e-06,"guilty",0.433419313072897
"2557",2585,150,113,37,3.80157309094503e-06,"event",0.561257773123822
"2558",2586,94,60,34,3.77696279313952e-06,"professional",0.543945507420888
"2559",2587,87,48,39,3.77960374634323e-06,"acting",0.54580330223235
"2560",2588,73,49,24,3.55661779873811e-06,"sail",0.388942462779345
"2561",2589,46,14,32,3.56986038276043e-06,"whenever",0.398258040144544
"2562",2590,44,21,23,3.5677461477261e-06,"profession",0.396770768476314
"2563",2591,67,26,41,3.76503188982011e-06,"crystal",0.535552639932078
"2564",2592,282,248,34,3.84865547221078e-06,"dirt",0.594378164467363
"2565",2593,46,12,34,3.70710875174234e-06,"historical",0.494806251380631
"2566",2594,42,16,26,3.51633513486903e-06,"attorney",0.360605374555756
"2567",2595,78,44,34,3.70385460148376e-06,"camp",0.492517099320832
"2568",2596,46,10,36,3.53561781385679e-06,"merit",0.374169893958921
"2569",2597,37,13,24,3.5946655163737e-06,"idiotic",0.415707364297526
"2570",2598,64,31,33,3.59373540044994e-06,"elevator",0.415053068517198
"2571",2599,56,27,29,3.55964360848192e-06,"Paris",0.39107098729641
"2572",2600,108,77,31,3.68950593825981e-06,"vision",0.482423443722749
"2573",2601,65,33,32,3.59751052271828e-06,"hint",0.417708701548831
"2574",2602,91,50,41,3.68817239993066e-06,"pin",0.481485357964435
"2575",2603,84,43,41,3.73279182966524e-06,"connect",0.512873170870364
"2576",2604,108,69,39,3.79979633091666e-06,"screen",0.560007900328922
"2577",2605,108,73,35,3.8641817401956e-06,"bitter",0.605300213393892
"2578",2606,51,15,36,3.64870288612398e-06,"lice",0.453720285164953
"2579",2607,71,38,33,3.55879484971209e-06,"lens",0.390473922707553
"2580",2608,60,21,39,3.71191115169467e-06,"recognition",0.498184529231781
"2581",2609,54,19,35,3.77753349727829e-06,"enjoyment",0.54434697276544
"2582",2610,44,14,30,3.46320346320346e-06,"ace",0.323229572589249
"2583",2611,66,39,27,3.52471352890794e-06,"pee",0.366499207491533
"2584",2612,68,37,31,3.57652511972418e-06,"rent",0.402946390446862
"2585",2613,42,6,36,3.581341212284e-06,"ample",0.406334300447159
"2586",2614,94,57,37,3.68128874556405e-06,"underwear",0.476643008865541
"2587",2615,139,109,30,3.76440827266362e-06,"joke",0.535113952599022
"2588",2616,42,10,32,3.61378732138856e-06,"lash",0.429158715912738
"2589",2617,50,12,38,3.74725513561316e-06,"representation",0.523047472599341
"2590",2618,65,22,43,3.61164683872552e-06,"diversity",0.42765298018829
"2591",2619,144,104,40,3.79701175175137e-06,"mathematics",0.558049070949393
"2592",2620,105,72,33,3.63171504111101e-06,"sink",0.441770080867996
"2593",2621,70,35,35,3.77237489861743e-06,"stab",0.540718124736967
"2594",2622,57,23,34,3.70900620887639e-06,"zone",0.496141029298568
"2595",2623,80,52,28,3.64876945250214e-06,"nerd",0.453767111694023
"2596",2624,41,11,30,3.51952810167213e-06,"daddy",0.362851486736627
"2597",2625,150,108,42,3.87781771930029e-06,"outside",0.614892526954887
"2598",2626,96,59,37,3.71662931454206e-06,"sorrow",0.501503549972168
"2599",2627,55,18,37,3.49726164413264e-06,"opaque",0.347188009917571
"2600",2628,34,4,30,3.36176263938708e-06,"trinity",0.251870399737604
"2601",2629,42,11,31,3.32682384800407e-06,"rarely",0.22729249155696
"2602",2630,51,23,28,3.60333091910162e-06,"improvement",0.421803095264872
"2603",2631,120,75,45,3.77545126081195e-06,"kindness",0.542882210687123
"2604",2632,53,17,36,3.67752517265981e-06,"patriotism",0.473995500305284
"2605",2633,202,161,41,3.85557033524184e-06,"animals",0.599242467493646
"2606",2634,66,41,25,3.54641368915684e-06,"pepper",0.381764318990556
"2607",2635,37,6,31,3.57543816994773e-06,"superlative",0.40218176892605
"2608",2636,44,11,33,3.57436465668228e-06,"platter",0.401426599401731
"2609",2637,108,71,37,3.79617573256701e-06,"yard",0.557460968100466
"2610",2638,36,9,27,3.34673141476377e-06,"earlier",0.241296592115453
"2611",2639,80,42,38,3.68202069295629e-06,"superior",0.477157901770751
"2612",2640,60,27,33,3.5800462541976e-06,"possibility",0.405423354198437
"2613",2641,90,50,40,3.75114878931673e-06,"twist",0.525786487299774
"2614",2642,74,33,41,3.74257099657181e-06,"confidence",0.519752386115043
"2615",2643,115,79,36,3.71366181910011e-06,"mask",0.499416047010226
"2616",2644,163,127,36,3.90263701182889e-06,"warmth",0.632351811284146
"2617",2645,42,7,35,3.52710047651127e-06,"memorize",0.368178320497581
"2618",2646,234,202,32,3.91651555444153e-06,"thought",0.642114757640106
"2619",2647,58,13,45,3.69904564622327e-06,"squeal",0.489134210097748
"2620",2648,79,39,40,3.71694704837235e-06,"flood",0.501727061793777
"2621",2649,102,63,39,3.77246028542435e-06,"mood",0.540778190612667
"2622",2650,60,14,46,3.668028728001e-06,"typewriter",0.467315167768645
"2623",2651,97,64,33,3.81954921680143e-06,"manners",0.573903189672408
"2624",2652,82,41,41,3.79920444658888e-06,"regret",0.55959153564984
"2625",2653,42,12,30,3.66450705051157e-06,"hugs",0.464837822029112
"2626",2654,64,21,43,3.72232913578684e-06,"satisfaction",0.505513124363703
"2627",2655,60,17,43,3.66313784387707e-06,"batter",0.463874645181517
"2628",2656,46,18,28,3.60490266762797e-06,"additional",0.422908751454874
"2629",2657,48,20,28,3.56590142422103e-06,"jog",0.395473086354766
"2630",2658,60,29,31,3.66087150707097e-06,"nurture",0.462280376584303
"2631",2659,58,22,36,3.68230541777596e-06,"coming",0.477358193200349
"2632",2660,41,5,36,3.61713363861941e-06,"scribe",0.431512703397352
"2633",2661,51,12,39,3.701140321333e-06,"reproduce",0.490607722216437
"2634",2662,60,35,25,3.57671700299729e-06,"nest",0.403081371918207
"2635",2663,426,373,53,4.00488596087226e-06,"soft",0.704279464808454
"2636",2664,35,5,30,3.66238655757638e-06,"entropy",0.46334614820195
"2637",2665,36,4,32,3.55411495429408e-06,"enforce",0.387181821426258
"2638",2666,55,23,32,3.50274965848191e-06,"faster",0.351048587442753
"2639",2667,80,39,41,3.73715819016903e-06,"facts",0.515944714083443
"2640",2668,88,42,46,3.85323787578702e-06,"intense",0.59760168451157
"2641",2669,82,31,51,3.69624276922508e-06,"capture",0.487162508994868
"2642",2670,87,44,43,3.63897046247676e-06,"wrap",0.446873951754205
"2643",2671,96,59,37,3.75447251538395e-06,"ability",0.52812458289107
"2644",2672,83,47,36,3.78783574429078e-06,"driver",0.551594151935198
"2645",2673,88,63,25,3.64854313672551e-06,"conflict",0.453607908465809
"2646",2674,117,82,35,3.73704646269867e-06,"ear",0.515866118705667
"2647",2675,113,83,30,3.80102399586449e-06,"camera",0.560871508804482
"2648",2676,75,45,30,3.55059419193802e-06,"dictionary",0.384705119442937
"2649",2677,80,44,36,3.76840867638414e-06,"rush",0.537928061256946
"2650",2678,33,7,26,3.50599173988346e-06,"gallop",0.353329249590679
"2651",2680,34,9,25,3.34390005751508e-06,"fewer",0.239304856404792
"2652",2681,184,142,42,3.82434039689005e-06,"glasses",0.577273574841258
"2653",2682,75,39,36,3.68647285650036e-06,"seeing",0.480289803661451
"2654",2683,97,68,29,3.82678442957951e-06,"passion",0.578992844703049
"2655",2684,88,43,45,3.71174581964627e-06,"regular",0.498068225383133
"2656",2685,124,72,52,3.79454799344302e-06,"cleaning",0.556315924979399
"2657",2686,124,93,31,3.73056376279583e-06,"shame",0.511305823496027
"2658",2687,39,9,30,3.26458125216279e-06,"frequently",0.18350755381421
"2659",2688,49,21,28,3.6473720684247e-06,"sole",0.452784113250487
"2660",2689,123,83,40,3.72180269235207e-06,"politician",0.505142794484218
"2661",2690,55,26,29,3.64422190396018e-06,"pumpkin",0.450568110638541
"2662",2691,37,10,27,3.57395586879293e-06,"mighty",0.401139035040976
"2663",2692,52,11,41,3.62225659341256e-06,"partnership",0.435116477527356
"2664",2693,151,111,40,3.79616132167153e-06,"unpleasant",0.557450830667199
"2665",2694,86,42,44,3.73538530499421e-06,"luxury",0.514697567078159
"2666",2695,68,26,42,3.6125209977783e-06,"elder",0.428267912762772
"2667",2696,51,19,32,3.62992217446858e-06,"digital",0.440508877776141
"2668",2697,60,14,46,3.76490431495684e-06,"hopeful",0.535462896608066
"2669",2698,159,124,35,3.81042379533452e-06,"careful",0.5674838556873
"2670",2699,78,44,34,3.7183844363301e-06,"extreme",0.502738201213524
"2671",2700,101,65,36,3.69439929067534e-06,"literature",0.485865702644815
"2672",2701,49,11,38,3.53416833950635e-06,"context",0.373150252291729
"2673",2702,47,13,34,3.6679345493759e-06,"valid",0.46724891723425
"2674",2703,34,5,29,3.50043230338947e-06,"compose",0.349418429717502
"2675",2704,70,28,42,3.63352288211035e-06,"discovery",0.443041817763522
"2676",2705,36,5,31,3.53765658552462e-06,"sober",0.375604080456781
"2677",2706,34,6,28,3.54750823021909e-06,"previously",0.382534280648163
"2678",2707,151,116,35,3.80368424856316e-06,"comfortable",0.56274287996465
"2679",2708,95,54,41,3.74402827490153e-06,"progress",0.520777517539568
"2680",2709,351,312,39,3.98185865198157e-06,"fear",0.688080762416077
"2681",2710,32,8,24,3.43835206662151e-06,"cassette",0.305747704465756
"2682",2711,157,128,29,3.83121211889017e-06,"feeling",0.582107530043389
"2683",2712,130,88,42,3.88690656653995e-06,"attention",0.621286132574372
"2684",2713,36,9,27,3.46286766997486e-06,"adhere",0.322993356772571
"2685",2714,73,32,41,3.71287588227213e-06,"inappropriate",0.498863174903633
"2686",2715,45,20,25,3.5756810778533e-06,"aunt",0.402352643989649
"2687",2716,73,35,38,3.74346764895258e-06,"relaxation",0.520383141759764
"2688",2717,62,23,39,3.64249627554756e-06,"infinity",0.449354206693945
"2689",2718,63,34,29,3.61510680833065e-06,"earn",0.430086917136207
"2690",2719,70,30,40,3.72076409611478e-06,"efficient",0.504412187558608
"2691",2720,35,6,29,3.4848305326912e-06,"somber",0.338443267941755
"2692",2721,41,10,31,3.58361285513603e-06,"narrative",0.407932301615099
"2693",2722,50,17,33,3.56915960567925e-06,"pancake",0.397765074186803
"2694",2723,34,6,28,3.52983949819802e-06,"evident",0.370105102187983
"2695",2724,90,58,32,3.74272507812939e-06,"struggle",0.519860775736568
"2696",2725,48,12,36,3.71326191492917e-06,"baggage",0.499134731955948
"2697",2726,67,25,42,3.75881912938231e-06,"carriage",0.531182235303179
"2698",2727,69,26,43,3.71574547143521e-06,"canyon",0.500881805090152
"2699",2728,153,116,37,3.77944661342686e-06,"legal",0.545692766113673
"2700",2729,115,71,44,3.81173098327412e-06,"eating",0.568403405101655
"2701",2730,104,64,40,3.78221978479169e-06,"duty",0.547643570605645
"2702",2731,81,39,42,3.69468593322225e-06,"bump",0.486067343111465
"2703",2732,41,7,34,3.67263592425556e-06,"manor",0.470556128375251
"2704",2733,78,43,35,3.71284831158223e-06,"purse",0.498843780131861
"2705",2734,72,32,40,3.75219034111162e-06,"neighbor",0.526519173330602
"2706",2735,42,12,30,3.49432870451258e-06,"least",0.345124815461552
"2707",2736,143,107,36,3.8169687161244e-06,"noisy",0.5720879205635
"2708",2737,225,188,37,3.98883127243718e-06,"alone",0.692985695258706
"2709",2738,67,40,27,3.63488324755009e-06,"pray",0.44399877521816
"2710",2739,88,53,35,3.59274122562774e-06,"oven",0.414353710109876
"2711",2740,90,50,40,3.79872818580339e-06,"bra",0.559256507064348
"2712",2741,93,58,35,3.70879986945024e-06,"famous",0.495995878557252
"2713",2742,57,26,31,3.55344559852461e-06,"worn",0.386710958983939
"2714",2743,40,13,27,3.45069134601117e-06,"foe",0.31442784661864
"2715",2744,107,82,25,3.63116117271981e-06,"pillow",0.44138045873385
"2716",2745,53,8,45,3.58650470011441e-06,"echo",0.409966587792089
"2717",2746,47,7,40,3.58833217908648e-06,"irregular",0.411252139140596
"2718",2747,87,47,40,3.70605086925423e-06,"scratch",0.494062077422991
"2719",2748,40,10,30,3.58052053607553e-06,"orb",0.405756990709206
"2720",2749,40,5,35,3.53365630952002e-06,"via",0.37279006164141
"2721",2750,75,43,32,3.69306221332605e-06,"shadow",0.484925127340964
"2722",2751,52,18,34,3.57868819605485e-06,"alternate",0.404468019826088
"2723",2752,104,69,35,3.77207607523028e-06,"gossip",0.540507915583169
"2724",2753,172,149,23,3.81069968256872e-06,"ouch",0.567677930262921
"2725",2754,219,173,46,3.90792918832311e-06,"flower",0.636074625462939
"2726",2755,60,16,44,3.69516376965827e-06,"yield",0.486403480098037
"2727",2756,76,38,38,3.72543541026357e-06,"knowing",0.507698252293173
"2728",2757,45,4,41,3.60637173758597e-06,"framework",0.423942177772994
"2729",2758,81,38,43,3.63791140230571e-06,"dictator",0.446128949348242
"2730",2759,39,5,34,3.65598631198725e-06,"diligence",0.45884385598758
"2731",2760,50,17,33,3.57492689274504e-06,"memo",0.401822107826023
"2732",2761,115,79,36,3.84381798753065e-06,"pleasant",0.590975206048164
"2733",2762,66,21,45,3.73771692774619e-06,"marker",0.51633776147647
"2734",2763,53,18,35,3.62043372796061e-06,"competent",0.433834171588015
"2735",2764,62,22,40,3.73153821468286e-06,"blend",0.51199130768302
"2736",2765,51,16,35,3.55609924361769e-06,"ultimate",0.388577681983221
"2737",2766,99,60,39,3.73732579390143e-06,"chest",0.516062615962204
"2738",2767,46,13,33,3.72451963008071e-06,"brake",0.507054041078156
"2739",2768,623,582,41,4.17264746136128e-06,"pain",0.822292326503238
"2740",2769,63,34,29,3.67380977747734e-06,"accurate",0.471381882660403
"2741",2770,40,6,34,3.40352537157988e-06,"furthermore",0.281248651147484
"2742",2771,51,18,33,3.57173472011887e-06,"obtain",0.399576554313801
"2743",2772,75,38,37,3.72485258895879e-06,"hike",0.507288263053488
"2744",2773,168,134,34,3.86975937836185e-06,"mom",0.609223837345623
"2745",2774,43,11,32,3.68667671900519e-06,"accountant",0.480433211997195
"2746",2775,120,84,36,3.75309160921309e-06,"butt",0.527153175932498
"2747",2776,74,38,36,3.7217611373702e-06,"bare",0.505113562376057
"2748",2777,129,86,43,3.67902697094672e-06,"cotton",0.475051949568141
"2749",2778,81,45,36,3.57298537219789e-06,"purchase",0.400456333228506
"2750",2779,100,58,42,3.73134328358209e-06,"praise",0.51185418219852
"2751",2780,172,140,32,3.80724671339427e-06,"knife",0.565248917811125
"2752",2781,50,6,44,3.63067338099197e-06,"habitual",0.44103731863588
"2753",2782,32,9,23,3.48836803678135e-06,"pasture",0.340931747001131
"2754",2783,44,14,30,3.58279113760784e-06,"fib",0.407354259354366
"2755",2784,41,11,30,3.52486261847944e-06,"multitude",0.366604085469681
"2756",2785,172,134,38,3.84426128675114e-06,"fix",0.591287047617557
"2757",2786,62,37,25,3.6444476839535e-06,"quit",0.450726936966677
"2758",2787,91,57,34,3.63369452256888e-06,"princess",0.44316255930216
"2759",2788,50,11,39,3.66989984843314e-06,"enlighten",0.468631418971266
"2760",2789,36,12,24,3.45100096282927e-06,"teller",0.31464564847798
"2761",2790,59,22,37,3.68378398290724e-06,"imaginary",0.478398298956651
"2762",2791,77,39,38,3.64811720670962e-06,"theft",0.453308285370461
"2763",2792,303,270,33,3.81686673409798e-06,"delicious",0.572016180678338
"2764",2793,54,14,40,3.59020018956257e-06,"quaint",0.412566202625462
"2765",2794,40,22,18,3.5390838727487e-06,"leap",0.37660811445316
"2766",2795,64,30,34,3.59462675193121e-06,"caution",0.415680095211492
"2767",2796,43,9,34,3.56344899100942e-06,"factual",0.393747907093888
"2768",2797,49,13,36,3.52006082665108e-06,"stair",0.363226235407089
"2769",2798,178,141,37,3.80313454349075e-06,"hide",0.562356186542771
"2770",2799,47,13,34,3.60811537309717e-06,"identification",0.425168748922095
"2771",2800,180,136,44,3.74313135396547e-06,"pie",0.520146572977975
"2772",2801,97,64,33,3.67889162353166e-06,"letters",0.474956738594658
"2773",2802,52,11,41,3.55460766017951e-06,"somewhat",0.387528418418675
"2774",2803,95,55,40,3.73567834315194e-06,"pond",0.514903706576666
"2775",2804,30,2,28,3.4794711203897e-06,"stow",0.334673156319852
"2776",2805,65,26,39,3.7196845707484e-06,"font",0.503652788784831
"2777",2806,81,47,34,3.69396258754691e-06,"defeat",0.485558501137044
"2778",2807,66,28,38,3.75636233871119e-06,"glory",0.529453990760546
"2779",2808,35,7,28,3.32358415315076e-06,"approximately",0.225013508241104
"2780",2809,34,9,25,3.50316686284401e-06,"dine",0.351342072423155
"2781",2810,69,32,37,3.67821503580742e-06,"compassion",0.474480788789177
"2782",2811,45,12,33,3.43300490919702e-06,"infer",0.301986213612628
"2783",2812,51,19,32,3.74241692770025e-06,"chorus",0.519644005417579
"2784",2813,35,2,33,3.461333444096e-06,"contra",0.321914096120262
"2785",2814,247,202,45,3.91413943730331e-06,"pink",0.640443263391516
"2786",2815,106,65,41,3.73687888401849e-06,"blonde",0.515748234450046
"2787",2816,44,10,34,3.60340882474821e-06,"acquaintance",0.421857898472222
"2788",2817,84,56,28,3.61202515414317e-06,"addition",0.427919108500985
"2789",2818,64,23,41,3.80199224393582e-06,"charm",0.561552628879087
"2790",2819,65,26,39,3.67544362604566e-06,"determination",0.472531223507746
"2791",2820,79,34,45,3.62233531958053e-06,"noble",0.435171857935526
"2792",2821,112,78,34,3.76335992774349e-06,"response",0.534376487902371
"2793",2822,55,18,37,3.59290903472906e-06,"estimate",0.414471756456667
"2794",2823,50,18,32,3.70072941376745e-06,"gratitude",0.490318666756387
"2795",2824,72,35,37,3.64561687483139e-06,"whip",0.451549411497278
"2796",2825,111,79,32,3.75908759425912e-06,"desk",0.531371088575738
"2797",2826,55,18,37,3.70190759298266e-06,"respond",0.491147464188283
"2798",2827,64,32,32,3.6346190192344e-06,"crude",0.44381290218064
"2799",2828,99,70,29,3.7067102575793e-06,"grammar",0.494525928205096
"2800",2829,67,21,46,3.80504472830078e-06,"creativity",0.563699917822839
"2801",2830,65,32,33,3.62229595606879e-06,"chill",0.435144167430534
"2802",2831,87,49,38,3.78385127950931e-06,"discussion",0.548791255622199
"2803",2832,72,32,40,3.64512519182471e-06,"rank",0.451203534055222
"2804",2833,56,30,26,3.49112033542684e-06,"ponder",0.34286786845001
"2805",2834,88,49,39,3.69441293931188e-06,"online",0.485875303862329
"2806",2835,409,361,48,4.00110430478812e-06,"clothes",0.701619235523819
"2807",2836,100,60,40,3.7632607902095e-06,"silent",0.534306748992948
"2808",2837,55,24,31,3.75896042190572e-06,"triumph",0.531281628399774
"2809",2838,56,19,37,3.77066797383156e-06,"vibrant",0.539517377973914
"2810",2839,110,60,50,3.75502234238294e-06,"high school",0.528511362082948
"2811",2840,58,26,32,3.68404183597909e-06,"heroin",0.478579687289593
"2812",2841,48,14,34,3.5057582078564e-06,"horizontal",0.353164970046624
"2813",2842,94,57,37,3.69755480700613e-06,"program",0.488085470060079
"2814",2843,83,35,48,3.62757830127763e-06,"attach",0.438860065731024
"2815",2844,135,94,41,3.80381446514565e-06,"birds",0.56283448162233
"2816",2845,58,27,31,3.61671501009064e-06,"phrase",0.431218216578123
"2817",2846,23,4,19,3.53940955569792e-06,"pane",0.376837218131479
"2818",2847,47,18,29,3.51075519855076e-06,"sketch",0.356680133954816
"2819",2848,66,31,35,3.58945275203343e-06,"expert",0.412040413087962
"2820",2849,45,11,34,3.45288367580185e-06,"century",0.315970054524636
"2821",2850,61,26,35,3.5568328537537e-06,"reveal",0.389093744555782
"2822",2851,37,6,31,3.52964015318638e-06,"remainder",0.369964871710675
"2823",2852,38,3,35,3.61976536680892e-06,"plaza",0.433364008815709
"2824",2853,47,14,33,3.55165347227402e-06,"comma",0.385450276725291
"2825",2854,38,11,27,3.50666792906712e-06,"immediately",0.353804919040334
"2826",2855,37,9,28,3.49010903100613e-06,"deity",0.342156460121013
"2827",2856,77,43,34,3.5974069890423e-06,"greedy",0.417635870146223
"2828",2857,209,168,41,3.78575646985781e-06,"oil",0.550131473517509
"2829",2858,68,37,31,3.56704620038239e-06,"whisper",0.396278386202515
"2830",2859,84,53,31,3.70377229207948e-06,"complex",0.492459198262989
"2831",2860,49,20,29,3.46162100788557e-06,"lung",0.322116384640739
"2832",2861,61,29,32,3.65184746963489e-06,"icy",0.455932361820672
"2833",2862,50,14,36,3.6147670463377e-06,"adultery",0.429847909467781
"2834",2863,62,25,37,3.59824837269217e-06,"gasoline",0.418227746661487
"2835",2864,106,60,46,3.82420877120524e-06,"imagination",0.577180981941865
"2836",2865,232,197,35,3.85326757090012e-06,"teeth",0.597622573721937
"2837",2866,50,25,25,3.46089021017986e-06,"ordinary",0.321602300489611
"2838",2867,111,71,40,3.77841842961373e-06,"wonderful",0.544969483872027
"2839",2868,55,20,35,3.57929022674804e-06,"rotate",0.404891522028461
"2840",2869,87,52,35,3.72263398690377e-06,"perfume",0.50572757376118
"2841",2870,106,74,32,3.73275002892881e-06,"lift",0.512843765884639
"2842",2871,79,51,28,3.56107601472861e-06,"awake",0.3920786223008
"2843",2872,424,391,33,3.86280849354332e-06,"gross",0.604334194570878
"2844",2873,127,89,38,3.71701612813298e-06,"steel",0.501775656377239
"2845",2874,64,22,42,3.77677735142158e-06,"potential",0.543815057301232
"2846",2875,508,469,39,3.9908051848541e-06,"animal",0.694374256116689
"2847",2876,53,20,33,3.65854104700128e-06,"trend",0.460641000082015
"2848",2877,52,24,28,3.68040808364831e-06,"challenging",0.476023501812026
"2849",2878,117,81,36,3.79982520804043e-06,"powerful",0.56002821411965
"2850",2879,33,5,28,3.46563991308175e-06,"duct",0.324943508275772
"2851",2880,55,22,33,3.59964723457101e-06,"elbow",0.419211784673523
"2852",2881,53,20,33,3.56450325082696e-06,"marathon",0.394489532661588
"2853",2882,52,10,42,3.64451409515826e-06,"merchandise",0.450773654338066
"2854",2883,216,176,40,3.79295042234503e-06,"band",0.555192103742194
"2855",2884,73,43,30,3.67853976685415e-06,"bubble",0.474709222845821
"2856",2885,43,7,36,3.57681934916195e-06,"peg",0.403153367958658
"2857",2886,72,32,40,3.75426108633299e-06,"mentor",0.527975851821803
"2858",2887,173,127,46,3.87157220675744e-06,"caring",0.610499082655789
"2859",2888,44,7,37,3.68501929107599e-06,"attribute",0.479267284103087
"2860",2889,52,14,38,3.39880565969118e-06,"probably",0.277928540724433
"2861",2890,62,25,37,3.58539882183795e-06,"mission",0.409188650901258
"2862",2891,37,8,29,3.55136336839713e-06,"initiate",0.38524620136473
"2863",2892,56,17,39,3.7903913579077e-06,"fussy",0.553391914088253
"2864",2893,61,19,42,3.7553325722526e-06,"puff",0.528729595197192
"2865",2894,23,3,20,3.50320367976515e-06,"sesame",0.351367971513287
"2866",2895,63,33,30,3.50464014355006e-06,"vodka",0.352378460817952
"2867",2896,66,32,34,3.65602641113479e-06,"required",0.458872063980115
"2868",2897,67,35,32,3.58923373449002e-06,"jet",0.41188634384691
"2869",2898,26,4,22,3.4888670253222e-06,"wager",0.341282763566233
"2870",2899,100,56,44,3.72564360493275e-06,"acid",0.507844708116635
"2871",2900,55,17,38,3.72284186856879e-06,"exclude",0.505873809399935
"2872",2901,57,30,27,3.56708437224666e-06,"everyone",0.396305238435748
"2873",2902,74,25,49,3.82650620850632e-06,"crisis",0.578797128374003
"2874",2903,185,142,43,3.88887160501509e-06,"mine",0.622668451003303
"2875",2904,115,86,29,3.6265916203974e-06,"birthday",0.438165978983372
"2876",2905,117,72,45,3.79325256234211e-06,"center",0.555404645985698
"2877",2906,44,4,40,3.60379840351731e-06,"commission",0.422131950058924
"2878",2907,59,16,43,3.72535213891093e-06,"advise",0.507639674546825
"2879",2908,61,31,30,3.56083508704461e-06,"pussy",0.391909140236279
"2880",2909,60,21,39,3.6410639188771e-06,"channel",0.448346606564261
"2881",2910,98,62,36,3.7051171372783e-06,"strict",0.493405237908472
"2882",2911,52,7,45,3.7397157816006e-06,"beloved",0.517743867542404
"2883",2912,115,75,40,3.718951404462e-06,"competition",0.503137038441014
"2884",2913,85,40,45,3.72680992524019e-06,"gate",0.508665163326755
"2885",2914,41,9,32,3.60795915790233e-06,"cradle",0.425058858380289
"2886",2915,48,13,35,3.55357187276791e-06,"mundane",0.386799787378816
"2887",2916,88,53,35,3.74667950528844e-06,"puppy",0.522642541898905
"2888",2917,76,33,43,3.71089183863558e-06,"punish",0.497467487176745
"2889",2918,42,14,28,3.50637283262329e-06,"nickel",0.353597331627783
"2890",2919,224,189,35,3.77933234314826e-06,"ice",0.545612381981764
"2891",2920,61,26,35,3.66567571233243e-06,"outstanding",0.465659924391287
"2892",2921,45,9,36,3.66980557370071e-06,"chamber",0.468565100829576
"2893",2922,62,29,33,3.6556388228843e-06,"dawn",0.458599412635993
"2894",2923,74,49,25,3.55314257695219e-06,"booze",0.386497796590823
"2895",2924,66,33,33,3.66088490910023e-06,"rug",0.4622898043244
"2896",2925,80,48,32,3.71455846900758e-06,"needy",0.500046800915092
"2897",2926,46,14,32,3.5756810778533e-06,"adjacent",0.402352643989649
"2898",2927,61,36,25,3.65112746816217e-06,"isolated",0.455425872346195
"2899",2928,201,167,34,3.89556762315837e-06,"wine",0.627378806244199
"2900",2929,41,9,32,3.66480250379307e-06,"frigid",0.465045660461327
"2901",2930,61,35,26,3.63886452871246e-06,"bulb",0.446799431994676
"2902",2931,59,34,25,3.63465865103279e-06,"loan",0.443840781413526
"2903",2932,92,43,49,3.76506024096386e-06,"protest",0.53557258371892
"2904",2933,81,46,35,3.67360733545913e-06,"rocket",0.471239473574725
"2905",2934,51,12,39,3.78389423258841e-06,"abroad",0.548821471230479
"2906",2935,92,56,36,3.69368970051564e-06,"breast",0.485366537072666
"2907",2936,124,91,33,3.75687037670139e-06,"search",0.529811373216583
"2908",2937,50,10,40,3.56623206185273e-06,"reserve",0.395705675435021
"2909",2938,127,95,32,3.71843974268397e-06,"trash",0.50277710680909
"2910",2939,79,33,46,3.70327851246709e-06,"delivery",0.492111845950716
"2911",2940,47,19,28,3.66504427373483e-06,"her",0.46521573501726
"2912",2941,52,20,32,3.57852171268049e-06,"maintain",0.404350906070096
"2913",2942,213,178,35,3.8350028379021e-06,"truth",0.584774134700441
"2914",2943,133,102,31,3.78081839594999e-06,"protection",0.546657754986001
"2915",2944,34,6,28,3.33809568317466e-06,"girth",0.235221733493612
"2916",2945,62,35,27,3.68352616592812e-06,"profit",0.478216936013359
"2917",2946,82,49,33,3.65182079784981e-06,"spread",0.455913599389038
"2918",2947,57,30,27,3.55838961519575e-06,"currency",0.390188857988936
"2919",2948,49,19,30,3.62317527835044e-06,"abnormal",0.435762732110193
"2920",2949,231,188,43,3.88268091351717e-06,"calm",0.618313570906202
"2921",2950,76,43,33,3.67171895194454e-06,"hook",0.469911078550337
"2922",2951,43,8,35,3.61199906088024e-06,"miniature",0.427900753034324
"2923",2952,126,83,43,3.73185850285301e-06,"knight",0.512216616370746
"2924",2953,104,56,48,3.76855069077534e-06,"whiskey",0.538027962155896
"2925",2954,82,54,28,3.70627063929462e-06,"alert",0.49421667601269
"2926",2955,144,107,37,3.73665546915578e-06,"shopping",0.515591071887616
"2927",2956,72,40,32,3.63862620029182e-06,"cattle",0.446631778397985
"2928",2957,77,40,37,3.60351270418404e-06,"clue",0.421930973101725
"2929",2958,43,14,29,3.6992098487763e-06,"toil",0.489249719395912
"2930",2959,65,35,30,3.46770697876029e-06,"lettuce",0.326397598369893
"2931",2960,38,5,33,3.6473986752648e-06,"harder",0.452802829996176
"2932",2961,70,38,32,3.72214901995816e-06,"gloves",0.505386420773682
"2933",2962,214,181,33,3.80779760794154e-06,"hole",0.565636447976424
"2934",2963,62,35,27,3.54885531671759e-06,"capitalism",0.383481896949727
"2935",2964,47,13,34,3.57491411268844e-06,"preposition",0.401813117616424
"2936",2965,73,38,35,3.52288820466571e-06,"lamb",0.36521517190102
"2937",2966,87,47,40,3.74069502113493e-06,"bat",0.518432719629408
"2938",2967,41,13,28,3.61207734180004e-06,"third",0.427955820229923
"2939",2968,50,27,23,3.49942784354758e-06,"select",0.348711836249673
"2940",2969,71,38,33,3.62435712965413e-06,"knot",0.436594112695364
"2941",2970,49,20,29,3.55719977233921e-06,"eternal",0.389351855696651
"2942",2971,63,32,31,3.60737347137549e-06,"beverage",0.424646853582483
"2943",2972,48,5,43,3.67217738085621e-06,"seriously",0.470233563194259
"2944",2973,78,50,28,3.69717203311187e-06,"cap",0.487816205404533
"2945",2974,74,43,31,3.69306221332605e-06,"sofa",0.484925127340964
"2946",2975,88,52,36,3.75622124143112e-06,"release",0.529354735009077
"2947",2976,66,25,41,3.694249162329e-06,"decline",0.485760093934112
"2948",2977,69,37,32,3.6611529702934e-06,"is",0.46247837362322
"2949",2978,78,37,41,3.69051353495839e-06,"collection",0.483132243831756
"2950",2979,39,16,23,3.459980139714e-06,"arid",0.320962105810215
"2951",2980,87,44,43,3.75166949292435e-06,"curtain",0.526152779462465
"2952",2981,67,35,32,3.6200405444541e-06,"Nazi",0.433557584226556
"2953",2982,44,19,25,3.45559218483271e-06,"hop",0.317875371899166
"2954",2983,85,36,49,3.78443838934302e-06,"statement",0.549204261653996
"2955",2984,47,15,32,3.72435317296269e-06,"institution",0.506936945792347
"2956",2985,143,111,32,3.78357926598562e-06,"text",0.548599906032117
"2957",2986,113,70,43,3.75292258846577e-06,"shell",0.527034277245857
"2958",2987,81,35,46,3.62423890982894e-06,"bean",0.43651095023056
"2959",2988,130,87,43,3.83052236833537e-06,"polite",0.581622320763603
"2960",2989,43,5,38,3.42142358592563e-06,"neuter",0.293839260363612
"2961",2990,31,3,28,3.42619462841206e-06,"trillion",0.297195479612067
"2962",2991,83,37,46,3.74153477756576e-06,"lively",0.519023451467404
"2963",2992,34,6,28,3.51455553173468e-06,"fret",0.359353501760424
"2964",2993,57,27,30,3.56148186137288e-06,"sidewalk",0.392364117624577
"2965",2994,107,68,39,3.77045471683885e-06,"concrete",0.539367361027754
"2966",2995,36,6,30,3.57190057257566e-06,"occur",0.399693224246941
"2967",2996,51,9,42,3.73721405640951e-06,"breaker",0.515984013534698
"2968",2997,72,44,28,3.63105569313222e-06,"worship",0.441306258467724
"2969",2998,161,125,36,3.82464755872746e-06,"goal",0.577489649729306
"2970",2999,123,83,40,3.75093773443361e-06,"wool",0.525638019441183
"2971",3000,125,85,40,3.8099592334362e-06,"proud",0.567157056756111
"2972",3001,277,242,35,3.91412411687575e-06,"cute",0.6404324861423
"2973",3002,130,95,35,3.74159077473379e-06,"selfish",0.519062843020452
"2974",3003,52,16,36,3.59780821523528e-06,"snuggle",0.417918115185058
"2975",3004,94,60,34,3.65895602666647e-06,"angle",0.460932920085663
"2976",3005,30,8,22,3.43747744155429e-06,"tug",0.305132444070542
"2977",3006,63,25,38,3.6992372172858e-06,"helping",0.489268971942631
"2978",3007,127,85,42,3.7908655304179e-06,"teenager",0.553725473663618
"2979",3008,64,36,28,3.57587287056771e-06,"alternative",0.402487561756912
"2980",3009,67,37,30,3.55095982444055e-06,"luggage",0.384962325880802
"2981",3010,95,54,41,3.80569636632111e-06,"stretch",0.5641583166053
"2982",3011,76,45,31,3.65823321968422e-06,"lab",0.460424457058213
"2983",3012,183,135,48,3.85997552775515e-06,"drunk",0.602341327323209
"2984",3013,71,35,36,3.64851651318574e-06,"compass",0.453589179972638
"2985",3014,96,58,38,3.73696267147987e-06,"situation",0.51580717525627
"2986",3015,73,36,37,3.6757948906451e-06,"architecture",0.472778322755613
"2987",3016,86,51,35,3.69933301025825e-06,"pale",0.489336358099625
"2988",3017,137,99,38,3.79636308416537e-06,"thoughtful",0.55759276173727
"2989",3018,68,28,40,3.72660160020273e-06,"infinite",0.508518615794918
"2990",3019,112,73,39,3.8132280882381e-06,"poverty",0.569456552817555
"2991",3020,84,48,36,3.62922396303998e-06,"pest",0.440017716642529
"2992",3021,51,13,38,3.47624162660298e-06,"apathy",0.332401349007177
"2993",3022,36,7,29,3.58583594800538e-06,"entity",0.409496149998429
"2994",3023,71,29,42,3.63854676442229e-06,"uneven",0.446575898745879
"2995",3024,56,23,33,3.52024669888866e-06,"probability",0.36335698837843
"2996",3025,38,16,22,3.41798543938203e-06,"snug",0.291420674982854
"2997",3026,55,21,34,3.68202069295629e-06,"corporate",0.477157901770751
"2998",3027,63,27,36,3.57197712505849e-06,"belong",0.399747075562899
"2999",3028,53,24,29,3.6122469621003e-06,"dew",0.428075140675777
"3000",3030,37,6,31,3.60498064125396e-06,"studio",0.422963602482745
"3001",3031,135,106,29,3.70314137482827e-06,"shape",0.492015375633294
"3002",3032,57,19,38,3.61399628481182e-06,"ambulance",0.429305712520996
"3003",3033,190,153,37,3.81277737955436e-06,"cloth",0.569139499015561
"3004",3034,132,96,36,3.72199662787106e-06,"hero",0.505279219620576
"3005",3035,76,47,29,3.60684001139761e-06,"envelope",0.424271587872499
"3006",3036,82,41,41,3.72214901995816e-06,"volume",0.505386420773682
"3007",3037,26,3,23,3.53884591157132e-06,"imbibe",0.376440719196005
"3008",3038,119,75,44,3.88265076332914e-06,"spirit",0.618292361570573
"3009",3039,63,33,30,3.686500036865e-06,"remote",0.480308923856513
"3010",3040,34,4,30,3.5860416913207e-06,"snapshot",0.40964088140191
"3011",3041,52,14,38,3.62148263499076e-06,"insight",0.434572031704428
"3012",3042,60,27,33,3.56674085487645e-06,"bind",0.396063589024041
"3013",3043,100,66,34,3.71226942166555e-06,"native",0.498436556451369
"3014",3044,42,13,29,3.53611790831553e-06,"durable",0.374521688488785
"3015",3045,95,49,46,3.69683033766848e-06,"musical",0.487575837638479
"3016",3046,229,184,45,3.80698581897782e-06,"criminal",0.565065390025574
"3017",3047,41,13,28,3.49975851666235e-06,"elementary",0.348944450290712
"3018",3048,78,50,28,3.70686140045224e-06,"difficulty",0.494632250590796
"3019",3049,44,13,31,3.51544510808236e-06,"avenue",0.359979279726047
"3020",3050,36,6,30,3.55309207838121e-06,"afterwards",0.386462273059769
"3021",3051,61,22,39,3.67606513987428e-06,"reference",0.472968431241845
"3022",3052,35,3,32,3.58086671297921e-06,"impose",0.406000510986124
"3023",3053,67,28,39,3.72148412787019e-06,"influence",0.504918698335634
"3024",3054,60,34,26,3.69341685379979e-06,"appointment",0.48517460136842
"3025",3055,79,43,36,3.69314404739042e-06,"breathing",0.484982694018022
"3026",3056,47,11,36,3.56240804534233e-06,"surplus",0.393015647447402
"3027",3057,44,14,30,3.66918617450649e-06,"adequate",0.468129380648085
"3028",3058,114,70,44,3.8183970369239e-06,"loose",0.573092681634875
"3029",3059,66,34,32,3.64786435781172e-06,"portion",0.453130417254533
"3030",3060,131,91,40,3.72637941249902e-06,"cancer",0.508362316485057
"3031",3061,82,55,27,3.65304810333742e-06,"tear",0.456776955000099
"3032",3062,31,10,21,3.54611186564491e-06,"authentic",0.381551999380483
"3033",3063,56,24,32,3.65624028811173e-06,"guest",0.459022517058001
"3034",3064,42,18,24,3.52659049231203e-06,"freezing",0.367819568968797
"3035",3065,46,14,32,3.63713074030159e-06,"stingy",0.445579787849008
"3036",3066,67,31,36,3.68467983816886e-06,"upright",0.479028493862991
"3037",3067,40,16,24,3.56508780811271e-06,"conductor",0.394900743087787
"3038",3068,134,100,34,3.65327497835435e-06,"steal",0.456936551629337
"3039",3069,44,7,37,3.56059419195875e-06,"diplomatic",0.391739681103119
"3040",3070,62,22,40,3.79062124491583e-06,"shallow",0.55355362952127
"3041",3071,64,32,32,3.68105837790481e-06,"suitcase",0.476480955315539
"3042",3072,88,51,37,3.69997632015155e-06,"fox",0.48978889840979
"3043",3073,57,23,34,3.66080449839657e-06,"journalist",0.462233238919214
"3044",3074,115,80,35,3.74870201192837e-06,"laughter",0.524065286662628
"3045",3075,48,13,35,3.57537425229986e-06,"inn",0.402136805662634
"3046",3076,87,42,45,3.78317847522775e-06,"tease",0.548317967302791
"3047",3077,64,16,48,3.66497711221793e-06,"scan",0.465168489834181
"3048",3078,58,25,33,3.5227144628565e-06,"request",0.365092952154286
"3049",3079,55,31,24,3.65422281989067e-06,"mug",0.457603316601087
"3050",3080,51,11,40,3.66867465459428e-06,"campaign",0.467769548812543
"3051",3081,87,51,36,3.67240663824224e-06,"curious",0.470394835715735
"3052",3082,36,13,23,3.31556192143444e-06,"identical",0.219370219886737
"3053",3083,50,15,35,3.60923531131459e-06,"certificate",0.425956576365066
"3054",3084,149,111,38,3.85107136805459e-06,"toy",0.596077641291625
"3055",3085,78,44,34,3.71319297463889e-06,"cigarette",0.499086235483765
"3056",3086,74,33,41,3.73396263050199e-06,"broke",0.513696777936448
"3057",3087,238,198,40,3.81125157690534e-06,"beer",0.568066163736204
"3058",3088,75,42,33,3.70422503907957e-06,"bucket",0.492777685931189
"3059",3089,62,32,30,3.66439962476548e-06,"comic",0.464762252725795
"3060",3090,57,26,31,3.5685737124586e-06,"demand",0.397352923988969
"3061",3091,75,43,32,3.71675363870181e-06,"motor",0.501591006568753
"3062",3092,68,43,25,3.47548048517708e-06,"refuse",0.331865919379022
"3063",3093,108,62,46,3.68792756910254e-06,"jelly",0.48131313020912
"3064",3094,65,32,33,3.67736288952466e-06,"fee",0.473881341233463
"3065",3095,35,6,29,3.66590415860168e-06,"campus",0.465820626327658
"3066",3096,50,20,30,3.6848427677591e-06,"surgeon",0.479143107687633
"3067",3097,45,20,25,3.4712459343032e-06,"rectangle",0.328887098462652
"3068",3098,171,123,48,3.77233220666345e-06,"muscle",0.540688092818764
"3069",3099,53,21,32,3.62893421830942e-06,"bench",0.439813893925669
"3070",3100,111,71,40,3.87427212112524e-06,"chaos",0.612398354061602
"3071",3101,42,12,30,3.62297837806504e-06,"railway",0.435624221390624
"3072",3102,78,41,37,3.70596846220839e-06,"spontaneous",0.494004107678588
"3073",3103,54,30,24,3.51204984301137e-06,"alike",0.357590859581546
"3074",3104,51,20,31,3.57008978775816e-06,"nearby",0.398419416504379
"3075",3105,134,102,32,3.7862581546535e-06,"cloud",0.550484386779705
"3076",3106,41,14,27,3.71581450653983e-06,"taxi",0.500930368260072
"3077",3107,78,49,29,3.6485564486411e-06,"flame",0.453617272814893
"3078",3108,60,28,32,3.70270260262966e-06,"garage",0.491706718625346
"3079",3109,53,13,40,3.72417286120753e-06,"compete",0.506810104376637
"3080",3110,75,45,30,3.61719905808137e-06,"transportation",0.431558723121145
"3081",3111,321,278,43,3.86031824463609e-06,"rude",0.602582413625801
"3082",3112,41,2,39,3.45413598242536e-06,"ascertain",0.316850997338863
"3083",3113,72,39,33,3.61399628481182e-06,"sew",0.429305712520996
"3084",3114,62,13,49,3.75135986795213e-06,"manufacturing",0.525934971867056
"3085",3115,62,29,33,3.64589599717078e-06,"slim",0.451745761827591
"3086",3116,39,4,35,3.54391262129041e-06,"classify",0.380004927381934
"3087",3117,130,100,30,3.82108167179965e-06,"ass",0.574981204587816
"3088",3118,94,57,37,3.78608613345954e-06,"belt",0.550363377410376
"3089",3119,72,35,37,3.68931537374609e-06,"harmony",0.482289389940831
"3090",3120,45,9,36,3.68313272537089e-06,"Orient",0.47794016782799
"3091",3121,73,40,33,3.7085385391325e-06,"jazz",0.495812044134247
"3092",3122,37,4,33,3.6696843704473e-06,"profound",0.468479839653801
"3093",3123,50,18,32,3.5507706947793e-06,"bay",0.384829281454698
"3094",3124,33,3,30,3.58223925776003e-06,"semester",0.406966036073323
"3095",3125,47,12,35,3.48457552643225e-06,"innocence",0.338263882216897
"3096",3126,46,12,34,3.4074568786332e-06,"nevertheless",0.28401429402015
"3097",3127,34,11,23,3.57154337103693e-06,"papa",0.399441948622527
"3098",3128,103,65,38,3.72214901995816e-06,"focus",0.505386420773682
"3099",3129,53,21,32,3.63623140976692e-06,"stall",0.444947148240415
"3100",3130,45,13,32,3.45968087903572e-06,"till",0.320751589041269
"3101",3131,93,59,34,3.75716679566273e-06,"lovely",0.530019890962226
"3102",3132,101,65,36,3.76547138053477e-06,"Facebook",0.535861802384576
"3103",3133,48,17,31,3.60582557179379e-06,"contrast",0.423557974079615
"3104",3134,48,9,39,3.63814963709457e-06,"finances",0.446296537079081
"3105",3135,54,21,33,3.63464544033729e-06,"coarse",0.443831488268344
"3106",3136,42,9,33,3.68187156895593e-06,"understandable",0.477052999573412
"3107",3137,138,102,36,3.74901119829645e-06,"attack",0.524282785719251
"3108",3138,45,7,38,3.57219404158034e-06,"defer",0.399899666827388
"3109",3139,70,30,40,3.61372202527437e-06,"excessive",0.42911278295869
"3110",3140,96,67,29,3.71857801576677e-06,"bow",0.502874375861579
"3111",3141,182,140,42,3.85476776951573e-06,"relax",0.598677897686147
"3112",3142,45,16,29,3.63010665253345e-06,"span",0.440638650008102
"3113",3143,40,10,30,3.4194463916292e-06,"prior",0.292448390847251
"3114",3144,96,66,30,3.72515785356404e-06,"blank",0.507503003321874
"3115",3145,55,31,24,3.64829022878428e-06,"parking",0.453429998815488
"3116",3146,102,49,53,3.74764835065996e-06,"physical",0.523324082148008
"3117",3147,69,40,29,3.65351522967823e-06,"stamp",0.45710555790417
"3118",3148,45,8,37,3.65831351746845e-06,"frontier",0.460480943029527
"3119",3149,46,6,40,3.72871370563297e-06,"nourish",0.510004389380021
"3120",3150,162,130,32,3.69540956224178e-06,"rope",0.486576384406112
"3121",3151,86,48,38,3.63995064226929e-06,"element",0.44756346527164
"3122",3152,72,37,35,3.53414335899121e-06,"chop",0.373132679594364
"3123",3153,48,20,28,3.53783180440036e-06,"permit",0.375727339255066
"3124",3154,46,9,37,3.54504332042938e-06,"mingle",0.380800324661502
"3125",3155,56,22,34,3.5676952332024e-06,"blues",0.396734952340753
"3126",3156,110,74,36,3.74132480311278e-06,"organization",0.518875743644059
"3127",3157,45,3,42,3.60413610659593e-06,"conditional",0.422369509371371
"3128",3158,274,242,32,3.79725686164315e-06,"plant",0.558221495013759
"3129",3159,40,9,31,3.57073992872803e-06,"assumption",0.398876762177467
"3130",3160,37,9,28,3.4384348244679e-06,"academia",0.305805920982967
"3131",3161,66,28,38,3.71217295756244e-06,"pump",0.498368698183378
"3132",3162,72,28,44,3.77769047115356e-06,"athletic",0.544457397005672
"3133",3163,47,11,36,3.49019429911663e-06,"ion",0.342216442498987
"3134",3164,35,7,28,3.52441538759758e-06,"occupied",0.366289478148854
"3135",3165,46,11,35,3.60759470838008e-06,"forbid",0.424802484117191
"3136",3166,87,51,36,3.57067617894801e-06,"burger",0.398831917001719
"3137",3167,83,54,29,3.5414276203023e-06,"bee",0.378256838117909
"3138",3168,47,12,35,3.6391955922063e-06,"justify",0.447032320650277
"3139",3169,121,78,43,3.80138522477591e-06,"material",0.561125617509039
"3140",3170,175,136,39,3.78379401025408e-06,"argument",0.548750969211568
"3141",3171,62,26,36,3.65140743499582e-06,"convince",0.455622816741199
"3142",3172,41,10,31,3.49177860726918e-06,"optimism",0.343330933835462
"3143",3173,117,84,33,3.70918505495158e-06,"trick",0.496266839672663
"3144",3174,138,102,36,3.71287588227213e-06,"blanket",0.498863174903633
"3145",3175,52,12,40,3.72120715960258e-06,"capacity",0.50472386330039
"3146",3176,51,22,29,3.62127280496549e-06,"decrease",0.434424425479638
"3147",3177,103,66,37,3.67225829195922e-06,"excitement",0.470290480608458
"3148",3178,25,4,21,3.59616504959112e-06,"Cain",0.416762220183279
"3149",3179,64,37,27,3.51757203108127e-06,"swear",0.361475476821172
"3150",3180,60,16,44,3.63001441115721e-06,"agency",0.440573762243359
"3151",3181,47,7,40,3.65075424582719e-06,"ecosystem",0.455163326793902
"3152",3182,70,37,33,3.63178098907923e-06,"multiple",0.44181647237278
"3153",3183,149,112,37,3.79528246389738e-06,"fashion",0.556832592748202
"3154",3184,83,40,43,3.61993570994179e-06,"glow",0.433483837742615
"3155",3185,89,57,32,3.73781472399976e-06,"hello",0.516406556853912
"3156",3186,64,28,36,3.68901595499401e-06,"global",0.482078761973889
"3157",3187,45,7,38,3.5928444909119e-06,"chunk",0.414426352710602
"3158",3188,47,20,27,3.62594727872657e-06,"liberty",0.437712712862941
"3159",3189,66,33,33,3.71444808873074e-06,"advance",0.499969153228899
"3160",3190,64,26,38,3.58907914996249e-06,"persuade",0.411777600408073
"3161",3192,68,30,38,3.75516334960571e-06,"mechanical",0.528610554483053
"3162",3193,53,12,41,3.62186301389709e-06,"persist",0.43483961159095
"3163",3194,62,24,38,3.68506002962788e-06,"parts",0.479295941888552
"3164",3195,93,55,38,3.75251418450362e-06,"conservative",0.526746982961051
"3165",3196,43,14,29,3.55456975487687e-06,"portrait",0.387501753699865
"3166",3197,35,5,30,3.37596046075108e-06,"ensemble",0.261857944699427
"3167",3198,79,42,37,3.68598367846427e-06,"hatred",0.479945688356398
"3168",3199,37,5,32,3.56567255715773e-06,"overdue",0.395312088408224
"3169",3200,45,16,29,3.58512888538343e-06,"definition",0.408998762438289
"3170",3201,48,9,39,3.71268289604117e-06,"provider",0.498727417549785
"3171",3202,60,24,36,3.57135204245623e-06,"coast",0.399307357352982
"3172",3203,81,39,42,3.725782414307e-06,"tank",0.507942354426651
"3173",3204,74,51,23,3.56784798113322e-06,"ache",0.396842403814313
"3174",3205,34,10,24,3.45983648812757e-06,"lend",0.320861053216194
"3175",3206,115,74,41,3.73318201502232e-06,"drawing",0.513147649165123
"3176",3207,63,36,27,3.55641541777212e-06,"autumn",0.388800096641227
"3177",3208,92,53,39,3.7705400167412e-06,"statue",0.539427365769896
"3178",3209,93,66,27,3.63580834927029e-06,"vehicle",0.444649543726083
"3179",3210,54,26,28,3.56309347775739e-06,"sushi",0.393497819105165
"3180",3211,49,7,42,3.61406159083763e-06,"mistress",0.429351652447437
"3181",3212,43,12,31,3.65235430758667e-06,"cubicle",0.456288900102286
"3182",3213,52,15,37,3.63389258940284e-06,"briefcase",0.443301890637508
"3183",3214,43,9,34,3.65087420182763e-06,"visitor",0.455247710581887
"3184",3215,154,115,39,3.78466755480199e-06,"hidden",0.549365469508809
"3185",3216,116,79,37,3.75365512167473e-06,"bath",0.527549582247446
"3186",3217,82,35,47,3.73795444181126e-06,"higher",0.516504842209712
"3187",3218,57,28,29,3.62931616424833e-06,"cube",0.440082576150922
"3188",3219,33,8,25,3.51407386583266e-06,"fetch",0.359014670912391
"3189",3220,30,5,25,3.30049342376685e-06,"a few",0.208770192311817
"3190",3221,42,4,38,3.56806439642623e-06,"aristocrat",0.396994642486284
"3191",3222,103,67,36,3.75172579386518e-06,"statistics",0.52619238470636
"3192",3223,70,34,36,3.68145137539023e-06,"obstacle",0.476757411819313
"3193",3224,37,6,31,3.51712664821348e-06,"forgot",0.361162169497235
"3194",3225,50,16,34,3.62253214997283e-06,"accounting",0.43531031948836
"3195",3226,39,17,22,3.6273151338842e-06,"erection",0.438674939005804
"3196",3227,80,41,39,3.80300437345503e-06,"root",0.562264617628705
"3197",3228,122,87,35,3.82083347661459e-06,"ignorant",0.574806610154868
"3198",3229,78,37,41,3.81892199469934e-06,"memories",0.573461966418139
"3199",3230,135,100,35,3.76520200308747e-06,"fool",0.535672307158674
"3200",3231,59,20,39,3.54553351415554e-06,"evaluate",0.381145154460003
"3201",3232,71,36,35,3.67870215388011e-06,"van",0.474823455000278
"3202",3233,44,9,35,3.56750431668022e-06,"deposit",0.396600650936312
"3203",3234,66,28,38,3.62980359132767e-06,"slap",0.440425459734658
"3204",3235,56,25,31,3.62888154241981e-06,"chef",0.439776838746397
"3205",3236,57,22,35,3.60351270418404e-06,"determine",0.421930973101725
"3206",3237,79,41,38,3.69539590624042e-06,"lean",0.486566778007766
"3207",3238,400,355,45,4.09212184702012e-06,"boring",0.765646086689988
"3208",3239,108,73,35,3.74342560877459e-06,"communication",0.5203535683374
"3209",3240,124,82,42,3.75468396825039e-06,"measurement",0.528273330713482
"3210",3241,83,45,38,3.63263853067037e-06,"entry",0.442419715291429
"3211",3242,33,5,28,3.44336016858691e-06,"ledger",0.309270684666064
"3212",3243,38,5,33,3.53091136353204e-06,"damnation",0.37085911246478
"3213",3244,44,9,35,3.72422833988797e-06,"slaughter",0.506849131196401
"3214",3245,47,14,33,3.57643558124231e-06,"waitress",0.402883404049826
"3215",3246,38,9,29,3.59145091025323e-06,"gregarious",0.413446029805452
"3216",3247,183,148,35,3.83476753639194e-06,"candy",0.584608610402591
"3217",3248,158,119,39,3.77590744495671e-06,"technology",0.543203116235929
"3218",3249,70,35,35,3.58377981256832e-06,"combine",0.408049748850057
"3219",3250,58,23,35,3.77170616900261e-06,"enjoyable",0.540247702767002
"3220",3251,288,253,35,3.9152428233599e-06,"dance",0.641219447114913
"3221",3252,121,81,40,3.67538959129668e-06,"piano",0.472493212430471
"3222",3253,31,6,25,3.48031879720182e-06,"visage",0.335269459798894
"3223",3254,60,30,30,3.65775150699362e-06,"dense",0.460085593296463
"3224",3255,83,40,43,3.6906633598323e-06,"daily",0.483237639062911
"3225",3256,97,65,32,3.76464919116512e-06,"guide",0.535283428204059
"3226",3257,28,4,24,3.49588010529591e-06,"sans",0.346216157906291
"3227",3258,48,15,33,3.57909806728704e-06,"vocabulary",0.404756346271048
"3228",3259,155,120,35,3.78096134723215e-06,"injury",0.546758314946668
"3229",3260,37,7,30,3.28758116215994e-06,"forty",0.199686982286027
"3230",3261,63,22,41,3.69385342789598e-06,"stern",0.485481712107674
"3231",3262,49,12,37,3.55673164815388e-06,"forth",0.389022550852697
"3232",3263,63,31,32,3.60046373972968e-06,"looking",0.419786160260782
"3233",3264,260,230,30,3.89927395518954e-06,"forest",0.629986048359432
"3234",3265,119,81,38,3.74538849042117e-06,"monkey",0.521734369531987
"3235",3266,66,30,36,3.63186012980268e-06,"tricky",0.441872144402556
"3236",3267,45,14,31,3.57575779247017e-06,"discount",0.402406609359794
"3237",3268,52,12,40,3.59892176303979e-06,"ward",0.418701447252675
"3238",3269,55,23,32,3.61437509261836e-06,"herd",0.429572187207692
"3239",3270,132,96,36,3.68698935197475e-06,"salad",0.48065313558688
"3240",3271,196,166,30,3.73578998882999e-06,"phone",0.514982244417134
"3241",3272,70,25,45,3.70687514132462e-06,"motivation",0.494641916692177
"3242",3273,124,91,33,3.80313454349075e-06,"horrible",0.562356186542771
"3243",3274,80,41,39,3.61938542835427e-06,"investigate",0.433096738767627
"3244",3275,67,30,37,3.69993525113311e-06,"jobs",0.489760008155592
"3245",3276,38,6,32,3.61514601574758e-06,"vitality",0.430114497835339
"3246",3277,59,24,35,3.56788617015963e-06,"related",0.396869268120358
"3247",3278,63,30,33,3.69213501399319e-06,"obligation",0.484272883254492
"3248",3279,81,37,44,3.7182323523397e-06,"discover",0.502631216792942
"3249",3280,95,53,42,3.70285341884456e-06,"connection",0.491812811221435
"3250",3281,62,22,40,3.74569713042143e-06,"shooting",0.521951484242799
"3251",3282,332,289,43,3.88571339755122e-06,"math",0.620446790493888
"3252",3283,42,19,23,3.60703516137875e-06,"cardboard",0.424408867329745
"3253",3284,58,18,40,3.82016205127422e-06,"importance",0.574334291860141
"3254",3285,54,27,27,3.58533454756663e-06,"truthful",0.40914343676888
"3255",3286,61,31,30,3.57649953684331e-06,"display",0.402928394011607
"3256",3287,482,438,44,4.16793441338407e-06,"children",0.818976903849801
"3257",3288,43,8,35,3.7441123832773e-06,"flawless",0.520836684094991
"3258",3289,49,10,39,3.5628268893671e-06,"nobody",0.393310285858616
"3259",3290,54,24,30,3.62254527275955e-06,"assistant",0.435319550793571
"3260",3291,356,307,49,3.99482270976814e-06,"skin",0.697200408783746
"3261",3292,38,8,30,3.43650878199819e-06,"comforter",0.304451034534446
"3262",3293,69,31,38,3.59784704832628e-06,"expand",0.417945432562312
"3263",3294,51,18,33,3.583304666896e-06,"internal",0.407715504697802
"3264",3295,57,23,34,3.70188018494593e-06,"consequence",0.491128183835887
"3265",3296,91,59,32,3.58438355771574e-06,"opposite",0.408474457095838
"3266",3297,81,44,37,3.66996719049332e-06,"bullet",0.468678791158634
"3267",3298,143,112,31,3.82575960456949e-06,"wealth",0.578271925232152
"3268",3299,159,120,39,3.80164535210839e-06,"meeting",0.561308605684645
"3269",3300,60,30,30,3.67206950493159e-06,"texture",0.47015767721008
"3270",3301,114,81,33,3.74324344558073e-06,"bite",0.520225424515721
"3271",3302,40,7,33,3.56629565304223e-06,"confidential",0.395750409049286
"3272",3303,135,97,38,3.68103127772277e-06,"sandwich",0.476461891525417
"3273",3304,61,22,39,3.74864580170413e-06,"label",0.524025745233878
"3274",3305,103,66,37,3.69187602680302e-06,"deer",0.484090697119024
"3275",3306,74,45,29,3.66932080871831e-06,"sweets",0.468224089914344
"3276",3307,60,20,40,3.65953179950157e-06,"sacrifice",0.461337951035901
"3277",3308,41,5,36,3.67716005574575e-06,"enable",0.473738656561303
"3278",3309,96,49,47,3.79034825719787e-06,"guard",0.553361594628224
"3279",3310,46,16,30,3.47391092892378e-06,"dash",0.330761805357019
"3280",3311,64,31,33,3.75808457945155e-06,"stranger",0.530665511626204
"3281",3312,50,16,34,3.71964306305167e-06,"preserve",0.503623589939689
"3282",3313,154,117,37,3.9563378554275e-06,"awesome",0.670128000755643
"3283",3314,421,387,34,4.04233129330347e-06,"hurt",0.730620614741175
"3284",3315,57,20,37,3.53304456582415e-06,"continent",0.372359726767419
"3285",3316,71,38,33,3.71228320266096e-06,"option",0.498446250777549
"3286",3317,68,25,43,3.7146964535793e-06,"quest",0.500143867012678
"3287",3318,114,81,33,3.69695334075189e-06,"hammer",0.487662364915759
"3288",3319,60,17,43,3.70388203876483e-06,"precision",0.492536400245336
"3289",3320,76,37,39,3.74359377515227e-06,"symbol",0.520471866012451
"3290",3321,56,11,45,3.66123339630655e-06,"den",0.462534949797956
"3291",3322,257,227,30,3.78420925163478e-06,"snow",0.5490430733206
"3292",3323,68,30,38,3.74870201192837e-06,"international",0.524065286662628
"3293",3324,130,91,39,3.71523469137545e-06,"holy",0.500522493708385
"3294",3325,45,5,40,3.67955492103675e-06,"deprived",0.47542333931355
"3295",3326,140,103,37,3.75341560820347e-06,"restaurant",0.52738109501959
"3296",3327,37,5,32,3.53699341411826e-06,"fourteen",0.375137568442822
"3297",3328,81,51,30,3.5555049883735e-06,"navy",0.388159649468372
"3298",3329,162,115,47,3.83998033930066e-06,"sweat",0.588275588743364
"3299",3330,67,38,29,3.51699058149922e-06,"void",0.361066452528302
"3300",3331,75,40,35,3.64036141508129e-06,"credit",0.447852425938474
"3301",3332,43,5,38,3.72087485209522e-06,"confess",0.504490099535814
"3302",3333,110,68,42,3.7351062637732e-06,"swing",0.514501273811076
"3303",3334,66,22,44,3.63543825208129e-06,"affair",0.444389196576991
"3304",3335,39,13,26,3.47739001015398e-06,"elevate",0.333209186495405
"3305",3336,49,19,30,3.71873012803588e-06,"paycheck",0.502981380174988
"3306",3337,61,24,37,3.70410155164814e-06,"found",0.492690817936301
"3307",3338,69,35,34,3.75319021167993e-06,"sincere",0.527222538445637
"3308",3339,146,105,41,3.82122768403033e-06,"behavior",0.575083917791583
"3309",3340,139,106,33,3.78644452858766e-06,"flight",0.5506154926726
"3310",3341,53,15,38,3.5716326647237e-06,"means",0.399504762816943
"3311",3342,65,24,41,3.60321406694772e-06,"investment",0.421720894896868
"3312",3343,44,10,34,3.5738664589059e-06,"finite",0.401076139104768
"3313",3344,252,212,40,3.902895948794e-06,"brain",0.632533962088486
"3314",3345,66,32,34,3.64507204484897e-06,"shave",0.451166147487505
"3315",3346,71,30,41,3.6623999707008e-06,"heritage",0.46335558374701
"3316",3347,190,151,39,3.87718624839581e-06,"murder",0.614448314854396
"3317",3348,106,68,38,3.76184510978945e-06,"blind",0.533310879874416
"3318",3349,75,38,37,3.51047173719204e-06,"drum",0.356480731314613
"3319",3350,74,25,49,3.7788324919133e-06,"detailed",0.545260758549169
"3320",3351,45,10,35,3.58122578196065e-06,"blueprint",0.40625310027462
"3321",3352,83,45,38,3.6497815605736e-06,"older",0.454479085356089
"3322",3353,229,193,36,3.91851065247121e-06,"peace",0.643518221647988
"3323",3354,91,55,36,3.73572020949919e-06,"robot",0.514933157716726
"3324",3355,77,37,40,3.64672032207834e-06,"economics",0.45232563826541
"3325",3356,51,15,36,3.65455668400145e-06,"others",0.457838175367941
"3326",3357,97,66,31,3.72138718428681e-06,"punch",0.504850502774291
"3327",3358,48,11,37,3.62042062046769e-06,"panel",0.433824951041316
"3328",3359,39,4,35,3.43452591521529e-06,"onto",0.303056174672515
"3329",3360,67,38,29,3.70378601005948e-06,"something",0.492468848260585
"3330",3361,66,29,37,3.67480881807124e-06,"instructions",0.472084663924827
"3331",3362,36,4,32,3.47545632741579e-06,"scrap",0.331848925452923
"3332",3363,64,30,34,3.64963503649635e-06,"grip",0.454376012090691
"3333",3364,81,39,42,3.69613347477204e-06,"opening",0.487085625138124
"3334",3365,50,18,32,3.67909464838892e-06,"principal",0.475099557682058
"3335",3366,109,67,42,3.77204761832913e-06,"skill",0.540487897400629
"3336",3367,44,15,29,3.58150795811068e-06,"monitor",0.406451598826853
"3337",3368,36,2,34,3.5207796414438e-06,"chairwoman",0.363731890104202
"3338",3369,55,14,41,3.57210471982197e-06,"invent",0.399836832885831
"3339",3370,95,59,36,3.65288797323164e-06,"storage",0.456664310490052
"3340",3371,121,77,44,3.79544091637126e-06,"loving",0.556944057117742
"3341",3372,56,27,29,3.75928543502451e-06,"frail",0.531510260881752
"3342",3373,84,49,35,3.70403295107713e-06,"pretend",0.492642560441734
"3343",3374,96,51,45,3.87858478198475e-06,"popular",0.615432121928876
"3344",3375,127,87,40,3.78661658235134e-06,"driving",0.550736524953297
"3345",3376,68,37,31,3.69029562958289e-06,"nap",0.482978956952067
"3346",3377,57,24,33,3.65431629569266e-06,"preacher",0.457669072730235
"3347",3378,37,9,28,3.61223391381932e-06,"dusk",0.428065961782084
"3348",3379,73,32,41,3.69172610345693e-06,"comparison",0.483985232617007
"3349",3380,30,9,21,3.52678949298874e-06,"carton",0.36795955722158
"3350",3381,81,34,47,3.70818098889771e-06,"hobby",0.495560523217443
"3351",3383,33,5,28,3.52260278074264e-06,"banquet",0.365014388682818
"3352",3384,63,28,35,3.65116746079559e-06,"click",0.455454005410712
"3353",3385,93,55,38,3.76204324092501e-06,"shelter",0.533450256443118
"3354",3386,70,35,35,3.72794918059677e-06,"flesh",0.509466579530347
"3355",3387,55,23,32,3.49025520746077e-06,"enlarge",0.342259288849143
"3356",3388,31,5,26,3.39725841246114e-06,"Euro",0.276840120122363
"3357",3389,182,162,20,3.82782445597045e-06,"done",0.579724457679058
"3358",3390,105,71,34,3.72882493539811e-06,"soda",0.510082634643991
"3359",3391,60,28,32,3.52807109768876e-06,"delete",0.368861109948336
"3360",3392,93,50,43,3.7737415515361e-06,"poke",0.541679505157423
"3361",3393,77,31,46,3.78805097201388e-06,"goodness",0.551745555203793
"3362",3394,42,12,30,3.49093752618203e-06,"partial",0.34273927015981
"3363",3395,399,366,33,3.97949762821941e-06,"color",0.686419885695914
"3364",3396,106,67,39,3.8013274235363e-06,"roof",0.561084956870717
"3365",3397,87,46,41,3.75630589852715e-06,"cop",0.529414287565154
"3366",3398,106,75,31,3.7098593221345e-06,"anxious",0.496741157079054
"3367",3399,58,30,28,3.72807426323932e-06,"deaf",0.509554569686331
"3368",3400,52,11,41,3.65330167138551e-06,"festive",0.456955329006663
"3369",3401,300,267,33,3.95313167090969e-06,"song",0.667872590491875
"3370",3402,73,45,28,3.58358717075793e-06,"disagree",0.407914233780988
"3371",3403,49,12,37,3.70714998016675e-06,"kite",0.494835253769935
"3372",3404,61,18,43,3.76068504638805e-06,"essence",0.532494826123421
"3373",3405,88,42,46,3.69107203496183e-06,"analysis",0.483525124102086
"3374",3406,283,247,36,3.77690573220983e-06,"tasty",0.543905367558138
"3375",3407,95,60,35,3.67740345896569e-06,"notes",0.473909880056848
"3376",3408,54,20,34,3.60664488253158e-06,"electron",0.424134323268801
"3377",3409,72,31,41,3.67466027765733e-06,"handshake",0.471980172254976
"3378",3410,67,31,36,3.55582105686113e-06,"automatic",0.388381989794422
"3379",3411,35,3,32,3.60983463347544e-06,"notify",0.426378173233673
"3380",3412,51,10,41,3.73841558470689e-06,"calling",0.516829236022383
"3381",3413,91,63,28,3.62401562675538e-06,"lemon",0.436353880376027
"3382",3414,74,43,31,3.64052044880336e-06,"jury",0.447964299190638
"3383",3415,58,24,34,3.6582867511487e-06,"plaid",0.460462114096899
"3384",3416,58,29,29,3.65330167138551e-06,"mat",0.456955329006663
"3385",3417,61,18,43,3.71134632799394e-06,"fixed",0.497787200517612
"3386",3418,40,8,32,3.59560904223762e-06,"prosper",0.416371093382921
"3387",3419,33,10,23,3.45133445846837e-06,"supper",0.314880248041158
"3388",3420,44,7,37,3.6850871891629e-06,"madam",0.479315047430883
"3389",3421,57,16,41,3.62460673016978e-06,"downhill",0.436769695716775
"3390",3422,57,14,43,3.73474357250631e-06,"hoard",0.514246136403548
"3391",3423,39,13,26,3.52744884317315e-06,"leash",0.368423381173406
"3392",3424,58,22,36,3.6740662360661e-06,"estate",0.471562290035622
"3393",3425,61,22,39,3.615172154498e-06,"feast",0.430132885300457
"3394",3426,55,20,35,3.39559726858156e-06,"was",0.275671578220048
"3395",3427,25,7,18,3.51477788361165e-06,"initial",0.359509916558978
"3396",3428,36,9,27,3.36962418581456e-06,"decimal",0.257400653034982
"3397",3429,36,10,26,3.49693144265907e-06,"kilometer",0.346955727655436
"3398",3430,71,35,36,3.67615973649287e-06,"ribbon",0.473034975816339
"3399",3431,179,146,33,3.78665959823542e-06,"yum",0.550766784742126
"3400",3432,134,103,31,3.75458528728209e-06,"jerk",0.528203912978007
"3401",3433,79,50,29,3.6803403578763e-06,"scale",0.475975859700201
"3402",3434,110,74,36,3.77396942329973e-06,"sight",0.541839802954279
"3403",3435,80,41,39,3.71639450270925e-06,"ahead",0.501338370140871
"3404",3436,181,135,46,3.84130788850988e-06,"success",0.589209461418345
"3405",3437,125,91,34,3.77650635397194e-06,"lots",0.543624422474704
"3406",3438,166,127,39,3.82698946047103e-06,"queen",0.579137074947609
"3407",3439,32,7,25,3.41598887754021e-06,"neither",0.290016181247306
"3408",3440,384,352,32,3.88832724162065e-06,"sea",0.622285515217728
"3409",3441,213,170,43,3.8752630334784e-06,"store",0.613095417464966
"3410",3442,202,169,33,3.87706599154024e-06,"false",0.614363719428013
"3411",3443,133,103,30,3.82479384361183e-06,"huge",0.577592554732995
"3412",3444,138,100,38,3.70205834443951e-06,"president",0.491253511229916
"3413",3445,125,95,30,3.77667750573111e-06,"meal",0.543744820234766
"3414",3446,95,67,28,3.67351287015234e-06,"length",0.471173021372328
"3415",3447,289,254,35,3.88663464079723e-06,"fruit",0.621094844734348
"3416",3448,240,211,29,3.8221478177447e-06,"sky",0.575731191525181
"3417",3449,143,103,40,3.75657400450789e-06,"opinion",0.529602888370059
"3418",3450,162,127,35,3.86406228868409e-06,"human",0.605216184491754
"3419",3451,543,516,27,4.25914331591344e-06,"me",0.883138368596807
"3420",3452,194,171,23,3.79228876003534e-06,"winter",0.554726653311589
"3421",3453,208,170,38,3.78967314069162e-06,"cow",0.552886679760102
"3422",3454,63,23,40,3.6539691239609e-06,"weekend",0.457424852635371
"3423",3455,148,103,45,3.78502568139925e-06,"direction",0.549617395871346
"3424",3456,68,32,36,3.48945138845271e-06,"multiply",0.341693837412732
"3425",3457,230,190,40,3.91660759116883e-06,"empty",0.642179501443297
"3426",3458,128,97,31,3.80840667689859e-06,"mouse",0.566064901288898
"3427",3459,72,34,38,3.5917476007126e-06,"submit",0.413654738538061
"3428",3460,96,66,30,3.76957351045303e-06,"closed",0.538747470963397
"3429",3461,209,169,40,3.83560592984677e-06,"information",0.585198383446714
"3430",3462,322,285,37,3.9208459617247e-06,"politics",0.645161009338511
"3431",3463,180,136,44,3.9383258176949e-06,"loss",0.65745732177636
"3432",3464,90,54,36,3.70870358557463e-06,"precise",0.495928147071401
"3433",3465,82,47,35,3.66586384248516e-06,"article",0.465792265706965
"3434",3466,182,148,34,3.84627219299055e-06,"freedom",0.592701632008026
"3435",3467,260,223,37,3.83796127497074e-06,"ship",0.586855265493835
"3436",3468,623,585,38,4.06315772365652e-06,"sad",0.745271095558796
"3437",3469,212,181,31,3.83294492824727e-06,"star",0.583326485467645
"3438",3470,133,103,30,3.72147027847762e-06,"finger",0.504908955895052
"3439",3471,68,38,30,3.66589071979764e-06,"slice",0.465811172718116
"3440",3472,98,61,37,3.66374177947938e-06,"email",0.464299487403964
"3441",3473,48,21,27,3.60002304014746e-06,"quantity",0.41947614742295
"3442",3474,143,104,39,3.72558808407907e-06,"shirt",0.507805651629852
"3443",3475,67,41,26,3.69353962983346e-06,"globe",0.485260968926166
"3444",3476,52,20,32,3.4907425507554e-06,"OK",0.342602113494006
"3445",3477,415,380,35,3.96009805202777e-06,"metal",0.672773134234057
"3446",3478,385,344,41,3.97699704906819e-06,"fat",0.684660837877016
"3447",3479,52,28,24,3.4178452536383e-06,"sometimes",0.291322060457243
"3448",3480,54,25,29,3.630343866171e-06,"happening",0.440805519403755
"3449",3481,114,77,37,3.78571347448997e-06,"pleasure",0.550101228160956
"3450",3482,106,68,38,3.7538382996614e-06,"grade",0.527678439931383
"3451",3483,124,91,33,3.7592289069666e-06,"task",0.531470495870946
"3452",3484,67,39,28,3.62278149917944e-06,"election",0.435485725724877
"3453",3485,116,75,41,3.95172571862132e-06,"living",0.666883564687543
"3454",3486,204,169,35,3.89538552630554e-06,"strength",0.627250709090527
"3455",3487,137,110,27,3.74729726184989e-06,"better",0.523077106560256
"3456",3488,51,20,31,3.65950501535162e-06,"customer",0.461319109560507
"3457",3489,63,16,47,3.61987019145493e-06,"relate",0.433437748359144
"3458",3490,146,102,44,3.92928852372701e-06,"memory",0.651099981623711
"3459",3491,139,110,29,3.70072941376745e-06,"pencil",0.490318666756387
"3460",3492,252,218,34,3.95121045332237e-06,"men",0.666521098136615
"3461",3493,147,107,40,3.76320414253512e-06,"fail",0.534266899837196
"3462",3494,56,34,22,3.71631163502847e-06,"myself",0.50128007635998
"3463",3495,55,12,43,3.70959784249789e-06,"topic",0.496557217616774
"3464",3496,136,103,33,3.79777602236131e-06,"trip",0.558586701821343
"3465",3497,64,31,33,3.53275749386183e-06,"immediate",0.372157784225853
"3466",3498,54,24,30,3.49704150288856e-06,"subtract",0.347033150202343
"3467",3499,254,213,41,3.9344829892628e-06,"sports",0.654754060426453
"3468",3500,209,169,40,3.75447251538395e-06,"river",0.52812458289107
"3469",3501,188,144,44,3.92480081635857e-06,"pants",0.647943076210643
"3470",3502,176,138,38,3.89386871432243e-06,"comfort",0.62618369835053
"3471",3503,134,98,36,3.70009953267743e-06,"mail",0.48987557302067
"3472",3504,141,100,41,3.73598538482517e-06,"data",0.515119696934479
"3473",3505,74,45,29,3.70430736860822e-06,"my",0.492835601145639
"3474",3506,45,22,23,3.62351662288251e-06,"him",0.436002853025514
"3475",3507,168,129,39,3.83998033930066e-06,"England",0.588275588743364
"3476",3508,142,99,43,3.76221308422466e-06,"crowd",0.533569733759268
"3477",3509,169,133,36,3.78107571604121e-06,"wedding",0.546838768390439
"3478",3510,114,75,39,3.7173892032148e-06,"container",0.502038098343388
"3479",3511,126,91,35,3.80400257150574e-06,"youth",0.562966806200928
"3480",3512,160,134,26,3.76076990481491e-06,"strange",0.532554520306913
"3481",3513,108,83,25,3.70458182680339e-06,"things",0.493028670454947
"3482",3514,338,299,39,3.99670671366794e-06,"friends",0.698525722941113
"3483",3515,94,55,39,3.61562964382432e-06,"later",0.430454708987281
"3484",3516,46,16,30,3.5091905701031e-06,"greet",0.355579486428064
"3485",3517,238,200,38,3.95929841232134e-06,"race",0.67221062275314
"3486",3518,72,41,31,3.60700914016116e-06,"halt",0.424390562543821
"3487",3519,157,112,45,3.77398366619869e-06,"iron",0.541849822209353
"3488",3520,210,170,40,3.85058201547164e-06,"plane",0.595733403200503
"3489",3521,85,53,32,3.68153269569187e-06,"arrow",0.476814617086804
"3490",3522,81,42,39,3.67964969734881e-06,"method",0.475490010294524
"3491",3523,120,85,35,3.74854743786783e-06,"shine",0.523956550586858
"3492",3524,124,83,41,3.71748593860944e-06,"witch",0.502106147453078
"3493",3525,91,59,32,3.73665546915578e-06,"being",0.515591071887616
"3494",3526,60,21,39,3.69599686579466e-06,"someone",0.486989526710849
"3495",3527,46,10,36,3.55617512028762e-06,"anti",0.388631057894431
"3496",3528,36,7,29,3.47881748036208e-06,"weekday",0.334213349213016
"3497",3529,173,140,33,3.80361190986961e-06,"taste",0.562691992864738
"3498",3530,159,127,32,3.93053950585257e-06,"education",0.651979992711693
"3499",3531,192,149,43,3.77083859679554e-06,"speech",0.539637403749739
"3500",3532,147,101,46,3.77236066785873e-06,"moving",0.540708114022038
"3501",3533,35,12,23,3.57028098111321e-06,"entire",0.398553912648613
"3502",3534,80,47,33,3.57408360496369e-06,"lower",0.401228891837731
"3503",3535,64,31,33,3.64327924278084e-06,"foundation",0.449904989820847
"3504",3536,81,41,40,3.67189422007131e-06,"identity",0.470034371994561
"3505",3537,87,46,41,3.68090933184134e-06,"network",0.476376107943383
"3506",3539,180,145,35,3.71090560940492e-06,"desert",0.497477174309328
"3507",3540,59,26,33,3.72248155510389e-06,"forgive",0.50562034467188
"3508",3541,247,211,36,3.86669192905394e-06,"lost",0.607066021220494
"3509",3542,152,119,33,3.85050788198963e-06,"worker",0.595681253545587
"3510",3543,576,533,43,4.04714109952729e-06,"death",0.734004102579659
"3511",3544,231,185,46,3.84753007806639e-06,"cheese",0.593586499018927
"3512",3545,192,159,33,3.73828980717901e-06,"liquid",0.516740757045035
"3513",3546,26,7,19,3.37749977201877e-06,"nor",0.262940782699854
"3514",3547,379,341,38,3.93180674383493e-06,"yellow",0.652871439082345
"3515",3548,92,55,37,3.65164744074289e-06,"average",0.455791650263506
"3516",3549,188,155,33,3.74666546773372e-06,"circle",0.522632667094502
"3517",3550,63,29,34,3.64839671206488e-06,"mature",0.453504905135651
"3518",3551,104,65,39,3.71774853148933e-06,"annoy",0.502290870033208
"3519",3553,160,124,36,3.78482512215523e-06,"spring",0.549476311234782
"3520",3554,81,48,33,3.62351662288251e-06,"toes",0.436002853025514
"3521",3555,110,67,43,3.79952202012987e-06,"master",0.559814934714945
"3522",3556,87,54,33,3.68996881976347e-06,"apartment",0.482749060569963
"3523",3557,130,99,31,3.76626555938459e-06,"unique",0.536420472392244
"3524",3558,245,205,40,3.90345963627563e-06,"shoes",0.632930491522321
"3525",3559,94,46,48,3.66567571233243e-06,"gather",0.465659924391287
"3526",3560,75,37,38,3.52149874986794e-06,"plot",0.364237751358152
"3527",3561,203,163,40,3.81622582897966e-06,"leader",0.571565332021955
"3528",3562,80,56,24,3.59061270215149e-06,"web",0.4128563871491
"3529",3563,145,106,39,3.71929720160079e-06,"remove",0.503380291569981
"3530",3564,75,43,32,3.747760712974e-06,"salary",0.523403124110482
"3531",3565,105,75,30,3.69853944677247e-06,"forever",0.488778120973584
"3532",3566,97,60,37,3.74849123227901e-06,"bell",0.523917012418921
"3533",3567,42,12,30,3.65686869647258e-06,"hire",0.459464574793302
"3534",3568,34,10,24,3.17174357087578e-06,"thus",0.11820031460944
"3535",3569,44,11,33,3.49081566398805e-06,"twice",0.342653545448225
"3536",3570,141,110,31,3.74442081298865e-06,"voice",0.521053650876774
"3537",3571,112,67,45,3.7324992441689e-06,"fiction",0.512667349799303
"3538",3572,451,405,46,4.07328657200349e-06,"dirty",0.752396296368362
"3539",3573,105,61,44,3.63685295839804e-06,"ego",0.445384380456551
"3540",3574,134,96,38,3.73406023039152e-06,"justice",0.513765435180392
"3541",3575,73,51,22,3.67721414256559e-06,"tidy",0.473776704268145
"3542",3576,40,12,28,3.53355641852856e-06,"duo",0.372719792707678
"3543",3577,174,138,36,3.8432270809153e-06,"relationship",0.590559529146916
"3544",3578,312,271,41,3.88429463151639e-06,"crime",0.619448750780617
"3545",3579,338,299,39,4.05037040637366e-06,"beautiful",0.736275778387992
"3546",3580,34,8,26,3.51852503430562e-06,"dozen",0.362145872814188
"3547",3581,221,187,34,3.79474958447492e-06,"alcohol",0.556457735433509
"3548",3582,57,23,34,3.6919032869015e-06,"given",0.484109873403344
"3549",3583,38,10,28,3.48348306504708e-06,"imply",0.337495383520957
"3550",3584,54,16,38,3.56007447675805e-06,"pastor",0.391374084241371
"3551",3585,68,28,40,3.54577237559658e-06,"access",0.381313183013173
"3552",3586,79,42,37,3.67107195301028e-06,"awe",0.469455943161566
"3553",3587,57,24,33,3.69452213203483e-06,"lasting",0.485952116156416
"3554",3588,71,30,41,3.63021207698954e-06,"edit",0.440712811491631
"3555",3589,122,72,50,3.78803662273807e-06,"Australia",0.551735461117267
"3556",3590,44,11,33,3.67822856512304e-06,"verify",0.474490306069648
"3557",3591,180,143,37,3.82575960456949e-06,"feet",0.578271925232152
"3558",3592,103,68,35,3.78472485050337e-06,"brush",0.549405774523149
"3559",3593,78,50,28,3.65870167312427e-06,"aim",0.460753993518427
"3560",3594,67,35,32,3.58627318077327e-06,"quiz",0.409803724084351
"3561",3595,59,21,38,3.66507113903081e-06,"threat",0.465234633575331
"3562",3596,43,6,37,3.448573152858e-06,"suddenly",0.312937790587315
"3563",3597,61,39,22,3.60490266762797e-06,"bark",0.422908751454874
"3564",3598,96,60,36,3.67693020451086e-06,"junk",0.473576966293189
"3565",3599,49,11,38,3.46835644992907e-06,"did",0.326854472867273
"3566",3600,38,9,29,3.50460329642986e-06,"similarity",0.352352540484101
"3567",3601,77,49,28,3.59771760794952e-06,"crown",0.417854376931335
"3568",3602,97,55,42,3.72519948443239e-06,"elegant",0.507532288812849
"3569",3603,46,11,35,3.5369809038401e-06,"utility",0.375128768010528
"3570",3604,51,19,32,3.68169534707342e-06,"hey",0.476929035203829
"3571",3605,57,16,41,3.72655993799004e-06,"inclusive",0.508489308254576
"3572",3606,141,102,39,3.74488355284592e-06,"horror",0.521379168081963
"3573",3607,52,20,32,3.5155686959701e-06,"pace",0.360066218387545
"3574",3608,78,49,29,3.71632544605196e-06,"girlfriend",0.501289791809597
"3575",3609,81,45,36,3.709460236441e-06,"writer",0.496460417787768
"3576",3610,43,11,32,3.45703766442535e-06,"purr",0.318892203429354
"3577",3611,48,14,34,3.66356728874039e-06,"hearty",0.464176740817963
"3578",3612,100,67,33,3.5555429136252e-06,"Halloween",0.388186328220471
"3579",3613,84,50,34,3.70638053408943e-06,"pub",0.494293982183553
"3580",3614,77,42,35,3.68896152044238e-06,"fragile",0.482040469652984
"3581",3615,39,5,34,3.64377042788796e-06,"dispose",0.45025051701239
"3582",3616,54,11,43,3.56456678037635e-06,"universal",0.394534222914733
"3583",3617,220,177,43,3.81893657892023e-06,"silly",0.573472225778235
"3584",3618,52,16,36,3.70192129715322e-06,"consume",0.491157104471542
"3585",3619,118,74,44,3.75338743215752e-06,"hairy",0.527361274406378
"3586",3620,54,14,40,3.60728238167212e-06,"suburb",0.424582775969118
"3587",3621,57,22,35,3.72374295747113e-06,"repetition",0.506507685943103
"3588",3622,78,40,38,3.67624082318385e-06,"con",0.47309201674897
"3589",3623,310,278,32,3.95967467312886e-06,"rich",0.672475305737672
"3590",3624,161,116,45,3.86183885318833e-06,"safety",0.60365209508576
"3591",3625,214,176,38,3.8226445819747e-06,"sand",0.576080643385106
"3592",3626,50,15,35,3.64114346469365e-06,"transfer",0.448402563559282
"3593",3627,101,62,39,3.68968290865083e-06,"essay",0.482547934635259
"3594",3628,113,74,39,3.74024730515182e-06,"shake",0.518117771061118
"3595",3629,102,73,29,3.77244605402143e-06,"rubbish",0.540768179444554
"3596",3630,64,35,29,3.67007494293033e-06,"sphere",0.468754590274701
"3597",3631,49,15,34,3.60815442900956e-06,"destiny",0.425196223044429
"3598",3632,64,21,43,3.67693020451086e-06,"champion",0.473576966293189
"3599",3633,44,5,39,3.71080921616577e-06,"collective",0.497409365891026
"3600",3634,108,67,41,3.67115281540709e-06,"award",0.469512826313086
"3601",3635,144,115,29,3.78486809734681e-06,"battle",0.54950654239822
"3602",3636,42,11,31,3.37015792560039e-06,"recline",0.2577761155776
"3603",3637,138,98,40,3.80100954813598e-06,"crash",0.560861345460804
"3604",3638,47,23,24,3.4525498807144e-06,"monarch",0.315735244312674
"3605",3639,204,156,48,3.86255484827885e-06,"magic",0.604155766245975
"3606",3640,55,16,39,3.78839538724978e-06,"abundant",0.551987836224653
"3607",3641,60,25,35,3.67565978093068e-06,"fold",0.472683278994109
"3608",3642,47,13,34,3.6313589634649e-06,"manufacture",0.441519595852773
"3609",3643,71,34,37,3.66762513936976e-06,"parliament",0.467031260858051
"3610",3644,40,9,31,3.54358610914245e-06,"indicate",0.37977524039865
"3611",3645,49,13,36,3.67874275287678e-06,"behave",0.474852014614757
"3612",3646,36,4,32,3.6135914401246e-06,"cram",0.42902092203008
"3613",3647,41,11,30,3.63238782278306e-06,"timber",0.442243353282601
"3614",3648,81,37,44,3.78780704910892e-06,"stories",0.551573966132621
"3615",3649,33,9,24,3.56017587268811e-06,"regulation",0.391445411833431
"3616",3650,101,67,34,3.77797591162559e-06,"kiss",0.544658191865338
"3617",3651,67,37,30,3.69456308097004e-06,"fist",0.485980921937323
"3618",3652,94,55,39,3.78067545547687e-06,"attitude",0.546557202629025
"3619",3653,126,86,40,3.79359792414322e-06,"block",0.555647592873692
"3620",3654,98,56,42,3.69154893701848e-06,"grave",0.483860603793727
"3621",3655,101,65,36,3.69722671024465e-06,"wisdom",0.487854668370643
"3622",3656,42,18,24,3.50212403822919e-06,"squid",0.350608491019302
"3623",3657,133,93,40,3.70708126663553e-06,"stomach",0.494786916812809
"3624",3658,65,26,39,3.71050629858444e-06,"whistle",0.497196276651087
"3625",3659,105,68,37,3.82606699443307e-06,"hotel",0.578488160526613
"3626",3660,44,13,31,3.52977720046311e-06,"greetings",0.370061278462322
"3627",3661,77,47,30,3.64280146003483e-06,"fuel",0.449568890602842
"3628",3662,68,35,33,3.72714329375107e-06,"appearance",0.508899673460803
"3629",3663,49,27,22,3.4793984815905e-06,"thirsty",0.33462205810877
"3630",3664,62,22,40,3.65538493031009e-06,"admire",0.458420810339528
"3631",3665,182,146,36,3.8239894151973e-06,"accident",0.577026674605847
"3632",3666,70,23,47,3.74042917684375e-06,"everyday",0.518245709823967
"3633",3667,90,58,32,3.7139652521411e-06,"pure",0.499629498853445
"3634",3668,145,107,38,3.77533723199825e-06,"pig",0.542801996415188
"3635",3669,80,50,30,3.71459986330272e-06,"frog",0.500075919987187
"3636",3670,66,29,37,3.71348254106183e-06,"maid",0.499289932769033
"3637",3671,55,19,36,3.62375297600713e-06,"rugby",0.436169117088044
"3638",3672,189,149,40,3.83356206920346e-06,"violence",0.58376061707768
"3639",3673,136,101,35,3.71902055874565e-06,"leather",0.503185685448153
"3640",3674,84,65,19,3.55131292038667e-06,"royalty",0.385210713400781
"3641",3675,53,18,35,3.64642777702823e-06,"gesture",0.452119845646503
"3642",3676,44,15,29,3.51830220808647e-06,"frugal",0.361989124336699
"3643",3677,34,9,25,3.48866011031143e-06,"median",0.341137207926371
"3644",3678,31,3,28,3.55316782677596e-06,"concerning",0.386515558735012
"3645",3679,126,82,44,3.83416470804753e-06,"creative",0.584184547087542
"3646",3680,108,69,39,3.85154601056864e-06,"greed",0.596411531494096
"3647",3681,85,47,38,3.70296311108149e-06,"grandmother",0.491889974901705
"3648",3682,75,41,34,3.68883904857463e-06,"tap",0.481954316062632
"3649",3683,66,24,42,3.60446088078606e-06,"connected",0.422597973777509
"3650",3684,53,15,38,3.73216491690335e-06,"tramp",0.512432165223367
"3651",3685,117,66,51,3.68728844182565e-06,"handle",0.480863532186251
"3652",3686,60,34,26,3.63950022382926e-06,"route",0.447246615643372
"3653",3687,42,20,22,3.4331227684702e-06,"kettle",0.302069122444898
"3654",3688,74,36,38,3.7171819300352e-06,"kick",0.501892290747453
"3655",3689,138,93,45,3.74373392534246e-06,"chemical",0.520570455527703
"3656",3690,93,56,37,3.72410351518131e-06,"insult",0.506761322487007
"3657",3691,80,41,39,3.74923609314602e-06,"scene",0.524440989387561
"3658",3692,110,79,31,3.73606913222322e-06,"mirror",0.515178609557901
"3659",3693,62,33,29,3.49907274572238e-06,"recycle",0.348462040495517
"3660",3694,52,24,28,3.65482381921779e-06,"glad",0.458026093282652
"3661",3695,65,30,35,3.62237468394781e-06,"atmosphere",0.43519954904235
"3662",3696,104,70,34,3.7459637240873e-06,"rat",0.522139021200486
"3663",3697,134,103,31,3.70955655960886e-06,"Christian",0.496528176913995
"3664",3698,46,8,38,3.5131973257542e-06,"transmit",0.358398063390712
"3665",3699,73,47,26,3.55778193642955e-06,"dough",0.389761382614785
"3666",3700,84,47,37,3.8020211544457e-06,"pregnancy",0.561572966155483
"3667",3701,48,22,26,3.55209502564613e-06,"transparent",0.385760890166882
"3668",3702,54,14,40,3.6130822482043e-06,"absence",0.428662727834802
"3669",3703,55,20,35,3.72537989561486e-06,"printer",0.507659200171309
"3670",3704,68,31,37,3.62089255001358e-06,"doing",0.434156932789612
"3671",3705,45,15,30,3.61591726781291e-06,"spare",0.43065703985513
"3672",3706,47,15,32,3.576064683858e-06,"omit",0.402622493998415
"3673",3707,78,38,40,3.70655912703119e-06,"cement",0.494419614489381
"3674",3708,98,63,35,3.69796500985508e-06,"fishing",0.488374029782892
"3675",3709,75,41,34,3.68939704184145e-06,"giant",0.482346839865958
"3676",3710,59,27,32,3.56685535331486e-06,"waiter",0.396144133656372
"3677",3711,107,65,42,3.74718492732335e-06,"abuse",0.522998084145067
"3678",3712,33,8,25,3.53964759268567e-06,"weighty",0.377004666717908
"3679",3713,110,71,39,3.69081319687167e-06,"wow",0.483343042851935
"3680",3714,94,56,38,3.71468265466081e-06,"rage",0.500134160078407
"3681",3715,67,22,45,3.64994141844023e-06,"analyze",0.454591538357826
"3682",3716,130,102,28,3.66299024545698e-06,"sickness",0.463770816163026
"3683",3717,73,29,44,3.80176097568394e-06,"equality",0.561389941801631
"3684",3718,49,16,33,3.62938202512258e-06,"commerce",0.440128906388917
"3685",3719,45,14,31,3.60582557179379e-06,"noon",0.423557974079615
"3686",3720,113,68,45,3.83487047724963e-06,"friendship",0.584681024783517
"3687",3721,108,75,33,3.56796255066507e-06,"geometry",0.396922998457762
"3688",3722,54,22,32,3.63187332025859e-06,"adjust",0.441881423310079
"3689",3723,72,44,28,3.64920885152099e-06,"poker",0.454076209642532
"3690",3724,48,13,35,3.5277599429914e-06,"ratio",0.368642226258346
"3691",3725,70,37,33,3.74017735921037e-06,"stable",0.518068567157423
"3692",3726,70,31,39,3.65112746816217e-06,"urban",0.455425872346195
"3693",3727,54,21,33,3.58397247509139e-06,"genuine",0.408185278489594
"3694",3728,97,64,33,3.68290212687598e-06,"confident",0.477777951895205
"3695",3729,81,42,39,3.7703409896391e-06,"stiff",0.539287358928013
"3696",3730,63,27,36,3.62498776566629e-06,"examine",0.437037737485714
"3697",3731,64,26,38,3.63627107673623e-06,"pour",0.444975052214506
"3698",3732,56,23,33,3.60096938095735e-06,"beyond",0.420141856699446
"3699",3733,32,3,29,3.53915902503247e-06,"gal",0.37666098079046
"3700",3734,143,110,33,3.7749239352827e-06,"idiot",0.542511260292846
"3701",3735,131,87,44,3.81141136562869e-06,"castle",0.568178568098674
"3702",3736,65,29,36,3.67382327440521e-06,"shelf",0.471391377157514
"3703",3737,60,30,30,3.7030865226166e-06,"wing",0.491976789506858
"3704",3738,114,79,35,3.81207971821107e-06,"journey",0.568648724842845
"3705",3739,62,34,28,3.66317810005605e-06,"incorrect",0.463902963638783
"3706",3740,59,11,48,3.78746274083529e-06,"welfare",0.551331760355026
"3707",3741,112,66,46,3.76891997829102e-06,"wire",0.538287739735296
"3708",3742,66,24,42,3.67055990720825e-06,"made",0.469095741385588
"3709",3743,251,222,29,3.87412202709561e-06,"bright",0.612292769491192
"3710",3744,35,11,24,3.49285187863038e-06,"weary",0.344085933190742
"3711",3745,75,38,37,3.79021896094937e-06,"treatment",0.553270640385164
"3712",3746,76,36,40,3.76822407367632e-06,"neighborhood",0.537798201344136
"3713",3747,132,96,36,3.7464268453962e-06,"lake",0.522464806740176
"3714",3748,46,17,29,3.54793616553251e-06,"resolve",0.382835314382418
"3715",3749,97,58,39,3.65870167312427e-06,"bull",0.460753993518427
"3716",3750,55,23,32,3.58923373449002e-06,"rear",0.41188634384691
"3717",3751,107,68,39,3.68286143602133e-06,"bend",0.477749327662662
"3718",3752,59,19,40,3.70352538581476e-06,"representative",0.492285510528999
"3719",3753,52,23,29,3.57366211024748e-06,"saddle",0.400932388781283
"3720",3754,53,12,41,3.6477712117896e-06,"platform",0.453064893111067
"3721",3755,43,9,34,3.57731837060303e-06,"pint",0.403504407667631
"3722",3756,65,26,39,3.72499133939514e-06,"boot",0.507385867903269
"3723",3757,98,57,41,3.698662563617e-06,"performance",0.488864728276827
"3724",3758,45,27,18,3.61022560299793e-06,"dairy",0.426653203154424
"3725",3759,40,10,30,3.65674834623556e-06,"comply",0.459379913677161
"3726",3760,63,27,36,3.66481593461968e-06,"suspect",0.465055108459103
"3727",3761,67,25,42,3.62810475064036e-06,"financial",0.439230399780563
"3728",3762,71,31,40,3.68863494686521e-06,"carnival",0.481810739456943
"3729",3763,107,71,36,3.7291169451074e-06,"sin",0.510288050674103
"3730",3764,50,17,33,3.62720987761794e-06,"crayon",0.438600895836442
"3731",3765,36,7,29,3.57037021168725e-06,"trio",0.398616682445986
"3732",3766,95,59,36,3.71658787500372e-06,"graph",0.501474399073467
"3733",3767,43,16,27,3.63414350505873e-06,"intercourse",0.443478398802426
"3734",3768,83,45,38,3.73648792553927e-06,"teen",0.515473212297751
"3735",3769,41,6,35,3.58713509868209e-06,"acre",0.41041004555065
"3736",3770,58,19,39,3.74131080565387e-06,"dependable",0.518865897045298
"3737",3771,55,20,35,3.70025013690926e-06,"participate",0.489981516495957
"3738",3772,49,22,27,3.49802012061173e-06,"pronoun",0.34772156487246
"3739",3773,97,59,38,3.85261438412106e-06,"balloon",0.5971630854556
"3740",3774,65,34,31,3.5873023844799e-06,"scissors",0.410527723776362
"3741",3775,228,199,29,3.83788762665029e-06,"beach",0.586803457128809
"3742",3776,56,25,31,3.66753098146797e-06,"serene",0.466965024901595
"3743",3777,124,85,39,3.72556032427277e-06,"pride",0.507786123822982
"3744",3778,63,25,38,3.72198277466372e-06,"sculpture",0.505269474496477
"3745",3779,173,137,36,3.83642997172551e-06,"clever",0.585778060786171
"3746",3780,49,12,37,3.49804459307247e-06,"heir",0.347738780175828
"3747",3781,55,19,36,3.70311394851931e-06,"background",0.491996082427187
"3748",3782,56,25,31,3.61278202279665e-06,"reverse",0.428451532421038
"3749",3783,109,74,35,3.81599282593349e-06,"sunny",0.571401424592767
"3750",3784,72,35,37,3.568904845859e-06,"division",0.397585861820769
"3751",3785,62,24,38,3.66061688715782e-06,"leisure",0.462101262636779
"3752",3786,81,41,40,3.66991331664746e-06,"explore",0.468640893269659
"3753",3787,55,13,42,3.72576853290412e-06,"closer",0.507932589468223
"3754",3788,62,18,44,3.68058418232142e-06,"retreat",0.476147379509192
"3755",3789,65,26,39,3.7176656034143e-06,"sunset",0.502232533767616
"3756",3790,49,28,21,3.54914501096686e-06,"cinema",0.38368568415521
"3757",3791,32,6,26,3.46287966146888e-06,"tactic",0.323001792262965
"3758",3792,51,19,32,3.72016889566786e-06,"twilight",0.503993490135077
"3759",3793,38,12,26,3.49978301345317e-06,"barter",0.348961682709224
"3760",3794,133,86,47,3.86359948382311e-06,"understanding",0.604890621559306
"3761",3795,78,46,32,3.71337222471843e-06,"sneeze",0.499212330057217
"3762",3796,61,32,29,3.60303231199377e-06,"classroom",0.421593038254078
"3763",3797,45,18,27,3.48523133222968e-06,"swift",0.338725212847853
"3764",3798,86,46,40,3.6654204237226e-06,"opera",0.465480340044959
"3765",3799,77,36,41,3.54172864691799e-06,"possession",0.378468597146413
"3766",3800,46,11,35,3.62836803262629e-06,"remain",0.439415607116579
"3767",3801,65,28,37,3.6003600360036e-06,"shining",0.419713209235385
"3768",3802,82,47,35,3.56125356125356e-06,"package",0.392203518498272
"3769",3803,88,43,45,3.63924856795569e-06,"rotten",0.447069586767757
"3770",3804,104,70,34,3.68946510134961e-06,"planet",0.482394716746526
"3771",3805,64,30,34,3.59061270215149e-06,"wagon",0.4128563871491
"3772",3806,99,49,50,3.87164715356501e-06,"energetic",0.610551804449588
"3773",3807,49,12,37,3.37156690200204e-06,"besides",0.258767268713055
"3774",3808,49,19,30,3.5443522519042e-06,"odds",0.380314188247336
"3775",3809,53,25,28,3.70915753904816e-06,"donate",0.496247483440779
"3776",3810,88,57,31,3.72807426323932e-06,"career",0.509554569686331
"3777",3811,44,17,27,3.49808130240563e-06,"menstruation",0.347764603582535
"3778",3812,32,11,21,3.3415758871884e-06,"kilt",0.237669904461
"3779",3813,47,16,31,3.51312327198249e-06,"dialogue",0.358345969808497
"3780",3814,74,39,35,3.61663652802893e-06,"known",0.431163007888011
"3781",3815,45,13,32,3.5117415077311e-06,"intersection",0.357373959227887
"3782",3816,58,26,32,3.70218169567326e-06,"trunk",0.491340283415705
"3783",3817,45,12,33,3.66571602431103e-06,"dime",0.465688282101136
"3784",3818,42,11,31,3.59178630308211e-06,"yeah",0.413681963958475
"3785",3819,57,14,43,3.67774157245519e-06,"territory",0.474147728075353
"3786",3820,137,101,36,3.75749149867548e-06,"artist",0.530248305298201
"3787",3821,57,17,40,3.6918487671071e-06,"strive",0.484071521117888
"3788",3822,108,78,30,3.66159535709709e-06,"flavor",0.46278957334739
"3789",3823,53,17,36,3.48034302260831e-06,"assess",0.335286501310424
"3790",3824,51,22,29,3.6430403357426e-06,"oval",0.449736929192037
"3791",3825,137,82,55,3.7828350078683e-06,"pattern",0.548076353071461
"3792",3826,44,24,20,3.55651660537603e-06,"speedy",0.388871277684976
"3793",3827,82,36,46,3.70984555912937e-06,"belonging",0.496731475408252
"3794",3828,104,77,27,3.75285216764741e-06,"depressed",0.526984739287071
"3795",3829,117,73,44,3.82515960478451e-06,"political",0.577849851684674
"3796",3830,54,23,31,3.41596553973964e-06,"fry",0.289999764127621
"3797",3831,107,77,30,3.62902640479612e-06,"cell",0.439878743078025
"3798",3832,102,75,27,3.64160755123742e-06,"error",0.448729028099384
"3799",3833,64,26,38,3.69043181742696e-06,"creation",0.483074759130518
"3800",3834,41,13,28,3.63677359993308e-06,"costly",0.445328555255168
"3801",3835,35,8,27,3.6441422235827e-06,"residence",0.450512058985813
"3802",3836,114,81,33,3.78170486818868e-06,"breath",0.547281349347019
"3803",3837,82,41,41,3.75186655361042e-06,"valuable",0.526291403016873
"3804",3838,75,43,32,3.65951840737759e-06,"shield",0.461328530263728
"3805",3839,46,19,27,3.57334286224763e-06,"wrist",0.400707811807769
"3806",3840,138,102,36,3.75795747495321e-06,"purple",0.530576099183309
"3807",3841,65,35,30,3.59718699976618e-06,"tedious",0.417481117333803
"3808",3842,81,48,33,3.63699845791265e-06,"democracy",0.445486732987047
"3809",3843,41,12,29,3.50580736990825e-06,"snore",0.353199553395059
"3810",3844,72,28,44,3.71086429740351e-06,"waist",0.497448113127265
"3811",3845,55,24,31,3.65807263469023e-06,"delight",0.460311492554257
"3812",3846,96,55,41,3.6918351374101e-06,"worm",0.484061933223512
"3813",3847,62,17,45,3.65359532047511e-06,"endure",0.457161898268959
"3814",3848,327,290,37,4.01338866458506e-06,"scary",0.710260744150642
"3815",3849,48,8,40,3.59683766032904e-06,"omen",0.41723537235322
"3816",3850,175,136,39,3.85295579503816e-06,"silver",0.597403253069881
"3817",3851,62,17,45,3.70551528895608e-06,"advantage",0.493685320160641
"3818",3852,68,39,29,3.58324046768455e-06,"verb",0.407670343366745
"3819",3853,130,90,40,3.63971217156147e-06,"vegetable",0.447395711582159
"3820",3854,79,55,24,3.69296674483446e-06,"candle",0.484857969442038
"3821",3855,46,10,36,3.69370334390964e-06,"slam",0.485376134602279
"3822",3856,46,12,34,3.59120585510203e-06,"majority",0.413273644248678
"3823",3857,123,78,45,3.70122251379631e-06,"talking",0.490665541011428
"3824",3858,176,139,37,3.70580365911053e-06,"salt",0.493888175923465
"3825",3859,121,76,45,3.73896071847869e-06,"cookie",0.517212713734667
"3826",3860,100,57,43,3.701989819528e-06,"reward",0.491205306958487
"3827",3861,84,56,28,3.70666903893485e-06,"experiment",0.494496932695567
"3828",3862,75,41,34,3.6667375569261e-06,"antique",0.466406885516507
"3829",3863,80,48,32,3.59324469996407e-06,"net",0.414707882235462
"3830",3864,81,45,36,3.65983984540836e-06,"highway",0.461554647828002
"3831",3865,58,24,34,3.48030668462505e-06,"equation",0.335260939132093
"3832",3866,85,49,36,3.61807590723253e-06,"saw",0.432175548061923
"3833",3867,64,23,41,3.69103116337611e-06,"passage",0.483496372733155
"3834",3868,43,15,28,3.49537910881814e-06,"mandatory",0.345863728845583
"3835",3869,63,23,40,3.67536257451798e-06,"thesis",0.472474207310948
"3836",3870,39,15,24,3.42066285604824e-06,"assignment",0.293304120241799
"3837",3871,105,68,37,3.74388810267239e-06,"frown",0.520678912520876
"3838",3872,47,22,25,3.66344649719563e-06,"offspring",0.464091769261175
"3839",3873,39,10,29,3.51102637834118e-06,"terminate",0.356870897050091
"3840",3874,36,11,25,3.56220500489803e-06,"soar",0.392872817395206
"3841",3875,57,29,28,3.53656811430188e-06,"depth",0.374838388665202
"3842",3876,79,37,42,3.64899579635684e-06,"review",0.453926334673921
"3843",3877,83,41,42,3.73661358184305e-06,"western",0.51556160599926
"3844",3878,66,31,35,3.7641107100242e-06,"beast",0.534904630325981
"3845",3879,65,28,37,3.57712642280203e-06,"glove",0.403369380803748
"3846",3880,55,20,35,3.5936191698021e-06,"sock",0.414971305351467
"3847",3881,136,96,40,3.8215489502205e-06,"pool",0.575309914473529
"3848",3882,103,70,33,3.68530447985613e-06,"glue",0.479467901908538
"3849",3883,55,13,42,3.69378520639025e-06,"decorate",0.485433721268911
"3850",3884,69,35,34,3.65713616980815e-06,"gown",0.459652730560058
"3851",3885,71,39,32,3.61985708804216e-06,"ending",0.433428530682653
"3852",3886,116,81,35,3.67096414202226e-06,"naughty",0.469380102857437
"3853",3887,81,46,35,3.66084470330684e-06,"super",0.462261521311191
"3854",3888,56,20,36,3.63728949187066e-06,"agenda",0.445691462618901
"3855",3889,206,163,43,3.84451253503312e-06,"fancy",0.591463789770353
"3856",3890,149,106,43,3.75777389474475e-06,"China",0.530446958553976
"3857",3891,89,48,41,3.72979847898818e-06,"Asia",0.510767479883895
"3858",3892,50,11,39,3.71214539731092e-06,"familiar",0.498349310754552
"3859",3893,49,14,35,3.54747047617696e-06,"civil",0.382507722334488
"3860",3894,57,24,33,3.67398524527526e-06,"perform",0.471505316564527
"3861",3895,92,48,44,3.73039676499993e-06,"relaxing",0.511188347867027
"3862",3896,44,21,23,3.55000177500089e-06,"enormous",0.384288380096521
"3863",3898,129,96,33,3.76062847623095e-06,"universe",0.532455031497678
"3864",3899,49,20,29,3.56215424840326e-06,"selection",0.392837112426071
"3865",3900,32,7,25,3.53383113234551e-06,"commence",0.372913041835704
"3866",3901,50,11,39,3.66723508810532e-06,"versus",0.466756876891592
"3867",3902,96,62,34,3.71524849439555e-06,"skirt",0.500532203527959
"3868",3903,78,36,42,3.78242006800791e-06,"origin",0.547784461068752
"3869",3904,172,127,45,3.81267562137081e-06,"soup",0.569067916594046
"3870",3905,58,26,32,3.64851651318574e-06,"employee",0.453589179972638
"3871",3906,67,38,29,3.59288321692392e-06,"fantastic",0.414453594762484
"3872",3907,185,140,45,3.88139994333156e-06,"sadness",0.617412464532521
"3873",3908,75,42,33,3.6897373644944e-06,"officer",0.482586241934111
"3874",3909,38,4,34,3.6375408768656e-06,"suspend",0.445868300943273
"3875",3910,76,45,31,3.51308624626735e-06,"oxygen",0.358319923840931
"3876",3911,56,23,33,3.56236997349597e-06,"caffeine",0.392988865572383
"3877",3912,44,14,30,3.37190796040031e-06,"certainly",0.259007188345797
"3878",3913,50,17,33,3.72432543155621e-06,"sample",0.506917430928947
"3879",3914,113,74,39,3.77767620026217e-06,"pipe",0.544447358059154
"3880",3915,52,25,27,3.49393801753957e-06,"peer",0.344849984301978
"3881",3916,66,30,36,3.66695268897641e-06,"automobile",0.466558221483489
"3882",3917,54,21,33,3.55030426107517e-06,"requirement",0.384501165790171
"3883",3918,46,19,27,3.56889210882266e-06,"width",0.397576901874036
"3884",3919,70,43,27,3.53610540422989e-06,"coins",0.374512892412655
"3885",3920,42,13,29,3.58699356134656e-06,"proposal",0.410310480239457
"3886",3921,51,11,40,3.59748463874059e-06,"oversee",0.417690493305164
"3887",3922,54,22,32,3.4000652812534e-06,"punctuation",0.278814629277386
"3888",3923,76,40,36,3.65891586322972e-06,"integrity",0.460904666868494
"3889",3924,97,55,42,3.68008302267299e-06,"yoga",0.475794835665077
"3890",3925,84,51,33,3.72874151245213e-06,"generous",0.510023950258378
"3891",3926,63,23,40,3.70870358557463e-06,"substance",0.495928147071401
"3892",3927,61,24,37,3.74219285016634e-06,"twins",0.519486376695013
"3893",3928,82,36,46,3.77287304282211e-06,"growing",0.541068547348592
"3894",3929,87,52,35,3.67937892083816e-06,"courage",0.47529953088889
"3895",3930,91,47,44,3.65692218800968e-06,"lace",0.459502203744826
"3896",3931,98,58,40,3.73428333501376e-06,"winner",0.513922379502252
"3897",3932,78,38,40,3.65598631198725e-06,"engineer",0.45884385598758
"3898",3933,101,61,40,3.77663471633697e-06,"drama",0.543714719771679
"3899",3934,68,38,30,3.65522459527526e-06,"beak",0.458308021670881
"3900",3935,28,8,20,3.20419364864735e-06,"Xerox",0.141027521858291
"3901",3936,122,77,45,3.80264283677156e-06,"personality",0.562010292420002
"3902",3937,49,12,37,3.62567120238134e-06,"occupy",0.437518505256002
"3903",3938,41,6,35,3.58084106795004e-06,"articulate",0.405982470832264
"3904",3939,79,51,28,3.68057063567135e-06,"circus",0.476137850034696
"3905",3940,68,26,42,3.63098977150181e-06,"cast",0.441259885490436
"3906",3941,45,13,32,3.61376120265973e-06,"retain",0.42914034253193
"3907",3942,51,27,24,3.54431456500627e-06,"server",0.380287677166664
"3908",3943,38,13,25,3.46878956588099e-06,"digit",0.327159150953616
"3909",3944,45,7,38,3.60870130057595e-06,"deficit",0.425580923219027
"3910",3945,124,94,30,3.7179835144611e-06,"tongue",0.502456170253264
"3911",3947,39,9,30,3.27934439346886e-06,"vowel",0.193892776574232
"3912",3948,290,241,49,3.96745103173564e-06,"dangerous",0.677945633137442
"3913",3949,73,38,35,3.63118754357425e-06,"closet",0.441399009473969
"3914",3950,65,26,39,3.51674321444397e-06,"gambling",0.360892440648374
"3915",3951,34,7,27,3.28197049508525e-06,"hence",0.195740123945043
"3916",3952,94,55,39,3.77861831042861e-06,"firm",0.545110091263429
"3917",3953,81,39,42,3.69726771915554e-06,"backpack",0.487883516341816
"3918",3954,50,13,37,3.64825029915652e-06,"haul",0.453401910072695
"3919",3955,102,68,34,3.83210769755473e-06,"wolf",0.58273753037582
"3920",3956,68,32,36,3.68851249668034e-06,"shift",0.481724601119541
"3921",3957,51,20,31,3.73347470757559e-06,"expectation",0.513353545546041
"3922",3958,63,28,35,3.75403558825738e-06,"clarity",0.527817223810418
"3923",3959,70,37,33,3.69029562958289e-06,"longing",0.482978956952067
"3924",3960,55,29,26,3.61836392056968e-06,"era",0.432378152819411
"3925",3961,48,14,34,3.61130772675401e-06,"demonstrate",0.427414429781455
"3926",3962,68,37,31,3.63008029737618e-06,"alter",0.440620110310249
"3927",3963,96,53,43,3.72621278910753e-06,"squeeze",0.508245104233155
"3928",3964,76,41,35,3.64781113093088e-06,"dot",0.45309297447709
"3929",3965,126,85,41,3.75029064752518e-06,"punishment",0.525182822166446
"3930",3966,57,23,34,3.60112499144733e-06,"ray",0.420251321857889
"3931",3967,44,9,35,3.77502368827364e-06,"evolve",0.542581432149256
"3932",3968,82,38,44,3.72674048097313e-06,"Ireland",0.508616312328994
"3933",3969,120,83,37,3.86501810760983e-06,"intelligence",0.605888561207268
"3934",3970,40,13,27,3.54485482047083e-06,"attire",0.380667723203642
"3935",3971,64,22,42,3.73371168278386e-06,"keeper",0.513520247217141
"3936",3972,69,21,48,3.59875339182507e-06,"muscular",0.418583005483745
"3937",3973,77,51,26,3.69408539986627e-06,"stream",0.485644894220182
"3938",3974,58,26,32,3.64802404777452e-06,"tobacco",0.453242752143286
"3939",3975,69,29,40,3.80639169293077e-06,"skip",0.564647448395248
"3940",3976,124,88,36,3.76280765656102e-06,"pizza",0.533987989334554
"3941",3977,44,7,37,3.6796903172629e-06,"participant",0.475518584623492
"3942",3978,61,28,33,3.54469147005445e-06,"celebrate",0.380552813346255
"3943",3979,99,49,50,3.78845279587816e-06,"grace",0.552028220678191
"3944",3980,76,47,29,3.69540956224178e-06,"solution",0.486576384406112
"3945",3981,42,21,21,3.57821439945039e-06,"cousin",0.404134724683928
"3946",3982,80,46,34,3.63489645997434e-06,"vast",0.444008069579447
"3947",3983,74,37,37,3.65226093213004e-06,"lack",0.456223214561698
"3948",3984,89,54,35,3.80087952352174e-06,"tip",0.560769878844371
"3949",3985,40,8,32,3.47365751821065e-06,"darling",0.3305835420287
"3950",3986,32,7,25,3.5672116176948e-06,"tint",0.396394750030654
"3951",3987,48,15,33,3.57352163409997e-06,"skate",0.400833569969348
"3952",3988,156,118,38,3.76086891115323e-06,"pot",0.532624166925935
"3953",3989,89,49,40,3.75452890048621e-06,"ladder",0.528164247338844
"3954",3990,185,148,37,3.90079498201734e-06,"happiness",0.631056024057903
"3955",3991,50,18,32,3.64439455673229e-06,"eternity",0.450689564295413
"3956",3992,245,213,32,3.8753681599752e-06,"funny",0.613169369347199
"3957",3993,69,34,35,3.65403588263237e-06,"nun",0.457471814434351
"3958",3994,105,57,48,3.71852270529964e-06,"snack",0.502835467372511
"3959",3995,57,28,29,3.8101915002248e-06,"patience",0.567320446260373
"3960",3996,69,43,26,3.49169326173034e-06,"author",0.343270896990047
"3961",3997,82,40,42,3.66075089322322e-06,"cheer",0.462195530029568
"3962",3998,71,41,30,3.63693232032645e-06,"genius",0.445440208094324
"3963",3999,61,31,30,3.65374216272306e-06,"dump",0.457265195353495
"3964",4000,36,6,30,3.70611954459203e-06,"coworker",0.494110387512719
"3965",4001,33,4,29,3.49006030824213e-06,"legislature",0.342122185792321
"3966",4002,36,11,25,3.45025083323558e-06,"toffee",0.314117965191079
"3967",4004,54,14,40,3.67667334595658e-06,"cabbage",0.473396277559761
"3968",4005,74,35,39,3.70895118278453e-06,"playful",0.496102320855037
"3969",4006,58,21,37,3.70275744346815e-06,"asylum",0.491745296751253
"3970",4007,35,8,27,3.62043372796061e-06,"stroller",0.433834171588015
"3971",4008,50,15,35,3.55132553225491e-06,"added",0.385219585297247
"3972",4009,73,29,44,3.72655993799004e-06,"revenge",0.508489308254576
"3973",4010,55,10,45,3.7134549613615e-06,"vest",0.499270531658817
"3974",4011,49,10,39,3.49569679724259e-06,"entertain",0.346087208726173
"3975",4012,48,11,37,3.65116746079559e-06,"sexuality",0.455454005410712
"3976",4013,38,3,35,3.54783546558245e-06,"condo",0.382764476381776
"3977",4014,43,7,36,3.70323737010895e-06,"fickle",0.492082904105259
"3978",4015,48,15,33,3.61417914763199e-06,"gifted",0.429434348499114
"3979",4016,43,10,33,3.55172915934122e-06,"informative",0.385503519259295
"3980",4017,51,4,47,3.73893275903326e-06,"moonlight",0.517193045490422
"3981",4018,65,16,49,3.80015732651332e-06,"daydream",0.560261844906768
"3982",4019,52,10,42,3.64306687942177e-06,"innate",0.449755601506783
"3983",4020,31,9,22,3.46916261352835e-06,"spanner",0.327421573620826
"3984",4021,55,16,39,3.66992678496064e-06,"therapist",0.46865036763759
"3985",4022,65,18,47,3.56367757270793e-06,"buffalo",0.393908704298812
"3986",4023,63,22,41,3.61687198443298e-06,"marshmallow",0.431328641146926
"3987",4024,56,13,43,3.53421830159605e-06,"tilt",0.373185398431726
"3988",4025,37,2,35,3.52354609679181e-06,"export",0.365677970172739
"3989",4026,48,15,33,3.42066285604824e-06,"multiplication",0.293304120241799
"3990",4027,32,4,28,3.60537055998615e-06,"kinetic",0.423237893218587
"3991",4028,50,13,37,3.77273070248246e-06,"buff",0.540968417159198
"3992",4029,41,6,35,3.53530532664454e-06,"absurd",0.373950072903112
"3993",4030,68,24,44,3.75067043233978e-06,"moody",0.52544998413548
"3994",4031,40,6,34,3.59392913490532e-06,"incentive",0.415189352214124
"3995",4032,43,7,36,3.45547277778546e-06,"monocle",0.317791374275681
"3996",4033,50,26,24,3.55670634765382e-06,"puddle",0.389004753059964
"3997",4034,49,12,37,3.67331046085353e-06,"kissing",0.471030635303316
"3998",4035,43,15,28,3.59644958496972e-06,"clarify",0.416962378349391
"3999",4036,40,8,32,3.59199272980672e-06,"locker",0.413827176110428
"4000",4037,96,51,45,3.6803809930404e-06,"papers",0.476004444756887
"4001",4038,59,25,34,3.55836429110267e-06,"stench",0.390171043599547
"4002",4039,121,83,38,3.76180265583268e-06,"excited",0.533281015376813
"4003",4040,59,26,33,3.65206085794214e-06,"Zen",0.456082471140851
"4004",4041,38,9,29,3.55467083748045e-06,"salutation",0.387572860880483
"4005",4042,87,44,43,3.70897869562637e-06,"emergency",0.496121674933234
"4006",4043,94,54,40,3.68799557440531e-06,"fairytale",0.481360968958575
"4007",4044,72,31,41,3.6231490237425e-06,"needles",0.435744263144386
"4008",4045,56,15,41,3.72334087930418e-06,"flap",0.506224841577928
"4009",4046,36,7,29,3.39352312176979e-06,"sip",0.274212506859109
"4010",4047,58,14,44,3.57274283039833e-06,"almond",0.400285715704442
"4011",4048,83,46,37,3.67814739072224e-06,"addiction",0.474433203437003
"4012",4049,40,8,32,3.55422864352864e-06,"density",0.387261796819151
"4013",4050,47,8,39,3.6385864819235e-06,"disable",0.446603838266948
"4014",4051,40,7,33,3.55483510897347e-06,"ammo",0.38768841867491
"4015",4052,42,13,29,3.67913525604942e-06,"drab",0.475128123391161
"4016",4053,48,7,41,3.63661489339263e-06,"tolerance",0.445216912160933
"4017",4054,60,25,35,3.6914262932912e-06,"pottery",0.483774329307726
"4018",4055,53,17,36,3.65059431675477e-06,"hail",0.455050823702015
"4019",4056,45,6,39,3.60468176067076e-06,"gruesome",0.422753353094027
"4020",4057,45,9,36,3.65224759316884e-06,"breed",0.456213831187213
"4021",4058,46,9,37,3.5781119734361e-06,"coyote",0.404062672472765
"4022",4059,45,9,36,3.6024482238129e-06,"stewardess",0.421182157822597
"4023",4060,53,18,35,3.59090925413224e-06,"ecology",0.413064998468066
"4024",4061,48,8,40,3.5728960108616e-06,"auditorium",0.400393471445625
"4025",4062,65,29,36,3.66356728874039e-06,"corpse",0.464176740817963
"4026",4063,36,4,32,3.50887042443297e-06,"conceive",0.355354277982852
"4027",4064,52,18,34,3.60010080282248e-06,"pistol",0.419530850056066
"4028",4065,61,17,44,3.55735162286381e-06,"perception",0.38945867588427
"4029",4066,53,25,28,3.72045955116376e-06,"nutrition",0.504197953535428
"4030",4067,62,23,39,3.62546088671522e-06,"scar",0.437370557404168
"4031",4068,58,14,44,3.63029114935018e-06,"attic",0.44076843543117
"4032",4069,74,34,40,3.74068102838803e-06,"decay",0.518422876345343
"4033",4070,52,17,35,3.64860969727485e-06,"bandit",0.453654730894564
"4034",4071,46,7,39,3.67325648880759e-06,"secondary",0.470992668334884
"4035",4072,42,8,34,3.53693086361241e-06,"brighten",0.375093566903882
"4036",4073,37,10,27,3.62211227099195e-06,"cologne",0.435014953030891
"4037",4074,55,19,36,3.72203818811181e-06,"chubby",0.505308455428136
"4038",4075,42,11,31,3.55992239369182e-06,"rival",0.391267100470902
"4039",4076,41,13,28,3.47753512310474e-06,"bits",0.333311267095178
"4040",4077,54,9,45,3.535980368237e-06,"categorize",0.374424935072662
"4041",4078,46,4,42,3.53685580592565e-06,"extension",0.375040767111433
"4042",4079,34,5,29,3.66384916665751e-06,"anthem",0.46437502957641
"4043",4080,37,10,27,3.5446286469798e-06,"plank",0.380508620067118
"4044",4081,66,24,42,3.69404446151914e-06,"vain",0.485616095887523
"4045",4082,57,12,45,3.81093203964894e-06,"arousal",0.567841383283381
"4046",4083,39,5,34,3.54101379224872e-06,"retrieve",0.377965728222553
"4047",4084,56,14,42,3.67244709839955e-06,"abs",0.470423297662813
"4048",4085,44,12,32,3.46038721732962e-06,"buyer",0.321248467068378
"4049",4086,34,3,31,3.50064061723295e-06,"turf",0.349564969374865
"4050",4087,35,4,31,3.39083051611831e-06,"tuition",0.272318376814849
"4051",4088,49,13,36,3.4536349507857e-06,"patio",0.316498543543309
"4052",4089,119,79,40,3.71028602594974e-06,"singing",0.497041324508323
"4053",4090,122,69,53,3.74035922409988e-06,"fighting",0.518196501135065
"4054",4091,44,13,31,3.50524208954491e-06,"merge",0.352801903438764
"4055",4092,57,30,27,3.58232908707926e-06,"monarchy",0.407029227061694
"4056",4093,43,10,33,3.57339393809452e-06,"input",0.400743741427124
"4057",4094,45,8,37,3.67103152314769e-06,"hostile",0.469427502525495
"4058",4096,28,9,19,3.3657907757138e-06,"tortoise",0.25470401706832
"4059",4097,35,6,29,3.63748795082116e-06,"viper",0.445831069791046
"4060",4098,64,29,35,3.58421654402672e-06,"rifle",0.408356970286731
"4061",4099,45,9,36,3.51722561243691e-06,"fees",0.361231786490281
"4062",4100,43,6,37,3.74386006948604e-06,"problematic",0.52065919240313
"4063",4101,49,9,40,3.67885102124904e-06,"inefficient",0.474928176668655
"4064",4102,45,8,37,3.54945994966866e-06,"shawl",0.383907229726449
"4065",4103,50,12,38,3.59417456187012e-06,"sugary",0.415361999325464
"4066",4104,44,7,37,3.56989861487934e-06,"spurt",0.398284934764274
"4067",4105,61,17,44,3.59823542534741e-06,"scandal",0.418218638771998
"4068",4106,35,11,24,3.55952957257169e-06,"prod",0.390990768032378
"4069",4107,58,22,36,3.59695409926874e-06,"clap",0.417317282043146
"4070",4108,50,25,25,3.48863576898254e-06,"fragrant",0.341120084868507
"4071",4110,39,7,32,3.52447749621119e-06,"urn",0.366333168835966
"4072",4111,39,8,31,3.51629804142199e-06,"cerebral",0.360579280941769
"4073",4112,47,10,37,3.66789418858845e-06,"serving",0.46722052518951
"4074",4113,52,5,47,3.61381344049495e-06,"blackberries",0.429177089559138
"4075",4114,56,12,44,3.63955320844813e-06,"obscene",0.447283888000141
"4076",4115,31,3,28,3.32476651827125e-06,"embark",0.225845250273878
"4077",4116,52,13,39,3.55014040805314e-06,"cling",0.384385902371739
"4078",4117,79,46,33,3.65188747804303e-06,"strawberry",0.455960505982011
"4079",4118,39,8,31,3.48969493086914e-06,"ingredient",0.341865158826905
"4080",4119,45,4,41,3.71644974988293e-06,"divorced",0.501377234105771
"4081",4120,81,54,27,3.61827227498869e-06,"gum",0.432313684170515
"4082",4121,129,92,37,3.79536889087935e-06,"weed",0.556893390341455
"4083",4122,44,19,25,3.41888523827921e-06,"refrigerator",0.292053644063938
"4084",4123,67,21,46,3.67445774189874e-06,"excite",0.471837697227051
"4085",4124,32,4,28,3.371419131455e-06,"thaw",0.258663318610804
"4086",4125,56,18,38,3.62164002346823e-06,"weakness",0.434682747599129
"4087",4126,52,14,38,3.62488264442439e-06,"told",0.43696378930007
"4088",4127,43,9,34,3.64264222696575e-06,"gamer",0.4494568771188
"4089",4128,47,10,37,3.62681522101812e-06,"boundaries",0.438323272218415
"4090",4130,46,12,34,3.75209179117358e-06,"fascinating",0.526449847769167
"4091",4131,101,66,35,3.72156722639038e-06,"bacteria",0.504977154501923
"4092",4132,52,11,41,3.69318496578264e-06,"recover",0.485011478313271
"4093",4133,44,6,38,3.64012289054878e-06,"responsive",0.447684634385685
"4094",4134,71,35,36,3.65947823159374e-06,"pine",0.461300268360913
"4095",4135,58,27,31,3.6982658831274e-06,"spoil",0.488585680941061
"4096",4136,64,18,46,3.70940519687668e-06,"ongoing",0.496421699866956
"4097",4137,47,13,34,3.63816287327551e-06,"breakup",0.446305848152157
"4098",4138,119,72,47,3.68568480023588e-06,"potato",0.479735440624187
"4099",4139,43,15,28,3.47843025399498e-06,"ale",0.333940952438
"4100",4140,47,14,33,3.53420581094119e-06,"disguise",0.373176611803567
"4101",4141,41,7,34,3.63666779403368e-06,"surrounding",0.445254125442988
"4102",4142,63,24,39,3.52962769487075e-06,"barrel",0.369956107831739
"4103",4143,45,6,39,3.64199216971684e-06,"paper clip",0.448999590339733
"4104",4144,29,6,23,3.4272397011447e-06,"optical",0.297930642468253
"4105",4145,34,7,27,3.58873138345595e-06,"soy",0.411532961915216
"4106",4146,55,19,36,3.69752746338523e-06,"chivalry",0.488066235021401
"4107",4147,36,5,31,3.62795996183386e-06,"infamous",0.439128547202072
"4108",4148,34,5,29,3.49014557397189e-06,"elevation",0.342182166495549
"4109",4149,65,22,43,3.73652981003482e-06,"offensive",0.515502676204348
"4110",4150,55,7,48,3.63924856795569e-06,"complaint",0.447069586767757
"4111",4151,75,31,44,3.76185926132132e-06,"bossy",0.533320834856745
"4112",4152,47,7,40,3.72961763959959e-06,"propaganda",0.510640267301195
"4113",4153,62,19,43,3.76862170198493e-06,"roller coaster",0.538077915429036
"4114",4154,52,15,37,3.61004314001552e-06,"glare",0.426524848444645
"4115",4155,58,24,34,3.71661550125993e-06,"tub",0.501493832933706
"4116",4156,54,10,44,3.6407987912548e-06,"remarkable",0.448160100903963
"4117",4157,40,6,34,3.45852023753117e-06,"walrus",0.31993512862005
"4118",4158,49,10,39,3.68012365215471e-06,"wrestle",0.475823416724457
"4119",4159,30,7,23,3.59599693621061e-06,"jigsaw",0.416643959789417
"4120",4160,49,8,41,3.7228834476879e-06,"reception",0.505903058487591
"4121",4161,39,6,33,3.6909357998627e-06,"sleeve",0.483429288681769
"4122",4162,61,24,37,3.65290131687092e-06,"joined",0.456673697155366
"4123",4163,59,19,40,3.54308390022676e-06,"primitive",0.379421958441007
"4124",4164,38,5,33,3.61992260605468e-06,"goldfish",0.433474619732449
"4125",4165,50,7,43,3.62486950469783e-06,"citation",0.436954546078424
"4126",4166,29,2,27,3.50247975566701e-06,"dungarees",0.350858722643782
"4127",4167,70,26,44,3.80766711850983e-06,"irresponsible",0.565544654381276
"4128",4168,41,13,28,3.51738644117875e-06,"binder",0.361344922460164
"4129",4169,41,13,28,3.36905656309064e-06,"mound",0.257001355330697
"4130",4170,38,10,28,3.5656471292975e-06,"diesel",0.395294201023191
"4131",4171,49,20,29,3.61406159083763e-06,"venom",0.429351652447437
"4132",4172,46,6,40,3.61195992169271e-06,"whisk",0.427873220331576
"4133",4174,55,14,41,3.76552809648789e-06,"respectful",0.535901699571427
"4134",4175,38,16,22,3.55372341370671e-06,"moan",0.386906389786397
"4135",4176,50,12,38,3.64803735590252e-06,"suffer",0.453252113827967
"4136",4177,44,5,39,3.60047670311549e-06,"improper",0.419795279434446
"4137",4178,91,62,29,3.58739246791077e-06,"afraid",0.410591093521139
"4138",4179,41,8,33,3.69692600602599e-06,"workplace",0.48764313613432
"4139",4180,68,23,45,3.7333213867049e-06,"faint",0.513245691034393
"4140",4181,39,11,28,3.45560412599133e-06,"radius",0.317883771980804
"4141",4182,32,7,25,3.43661507161906e-06,"escalator",0.304525804623473
"4142",4183,56,17,39,3.7038957575578e-06,"savage",0.492546050814821
"4143",4184,37,9,28,3.3963122841219e-06,"chameleon",0.276174560309658
"4144",4185,43,9,34,3.45210889332293e-06,"ascend",0.315425029013651
"4145",4186,45,10,35,3.59013574303244e-06,"melon",0.412520867316561
"4146",4187,51,7,44,3.55333195937831e-06,"resident",0.386631018825938
"4147",4188,59,13,46,3.71852270529964e-06,"trauma",0.502835467372511
"4148",4189,41,11,30,3.57662745490767e-06,"navel",0.40301837876254
"4149",4190,45,8,37,3.60849294900478e-06,"preparation",0.425434357021891
"4150",4191,41,8,33,3.53429324737932e-06,"whack",0.373238119504974
"4151",4192,39,5,34,3.4875164349212e-06,"theorem",0.340332682422856
"4152",4193,36,3,33,3.5643634937891e-06,"satisfactory",0.394391219711759
"4153",4194,43,6,37,3.4536349507857e-06,"periodic",0.316498543543309
"4154",4195,35,5,30,3.60737347137549e-06,"pubes",0.424646853582483
"4155",4196,34,2,32,3.55727569598099e-06,"relay",0.389405264650494
"4156",4197,31,7,24,3.42499768812656e-06,"thesaurus",0.296353484589621
"4157",4198,25,5,20,3.4230046450173e-06,"epoch",0.294951466128181
"4158",4199,65,29,36,3.52339711856584e-06,"flute",0.365573170521292
"4159",4200,52,11,41,3.52127554685409e-06,"stationary",0.36408073782211
"4160",4201,49,17,32,3.5535466172013e-06,"bagel",0.386782021194791
"4161",4202,68,32,36,3.65064762488866e-06,"shovel",0.45508832363742
"4162",4203,57,14,43,3.47317493340187e-06,"buns",0.330244064770042
"4163",4204,43,12,31,3.5463759584081e-06,"wrath",0.381737777062764
"4164",4205,40,6,34,3.5837669691366e-06,"apricot",0.408040714058842
"4165",4206,42,11,31,3.5540391655116e-06,"warn",0.387128507340019
"4166",4207,33,4,29,3.64770468182896e-06,"papyrus",0.453018092200128
"4167",4208,68,44,24,3.54992616153584e-06,"fork",0.38423518933841
"4168",4209,40,8,32,3.65457003983481e-06,"mirage",0.457847570611256
"4169",4210,43,9,34,3.6123644008713e-06,"splendid",0.428157753703194
"4170",4211,39,6,33,3.51522267178014e-06,"adept",0.359822805538031
"4171",4212,43,7,36,3.70546036639592e-06,"tolerate",0.493646684547122
"4172",4213,44,10,34,3.6390366742116e-06,"pristine",0.446920528807249
"4173",4214,60,29,31,3.67159762227338e-06,"ripe",0.469825728445214
"4174",4215,40,6,34,3.51918129766291e-06,"nope",0.36260752531845
"4175",4216,84,42,42,3.70994190230981e-06,"ignore",0.496799248612443
"4176",4217,50,11,39,3.67636245992765e-06,"expose",0.473177582866236
"4177",4218,40,7,33,3.59383872289347e-06,"potent",0.415125751327041
"4178",4219,96,60,36,3.75016406967805e-06,"drinking",0.525093780199582
"4179",4220,72,38,34,3.60283759488974e-06,"snot",0.421456063306896
"4180",4221,51,15,36,3.66485622769019e-06,"mama",0.465083452867938
"4181",4222,39,6,33,3.74052711508106e-06,"phantom",0.518314605080747
"4182",4223,43,9,34,3.54583523921977e-06,"ancestry",0.381357404816438
"4183",4224,36,9,27,3.55675694901389e-06,"regulations",0.38904034889864
"4184",4225,38,7,31,3.67737641257221e-06,"stride",0.473890854104627
"4185",4226,57,8,49,3.66223901969186e-06,"unequal",0.463242361767578
"4186",4227,33,2,31,3.61487158168706e-06,"upside",0.429921445503704
"4187",4228,45,7,38,3.59297358086526e-06,"systematic",0.414517161834076
"4188",4229,97,53,44,3.73685095569963e-06,"rape",0.515728588101979
"4189",4230,63,24,39,3.65868828707532e-06,"betray",0.460744577019769
"4190",4231,39,11,28,3.55253668882265e-06,"tumor",0.38607158085107
"4191",4232,35,5,30,3.53101110502993e-06,"aspiration",0.370929276236329
"4192",4233,72,33,39,3.69251674556344e-06,"crowded",0.484541414680791
"4193",4234,50,11,39,3.80090841711169e-06,"replacement",0.560790204218335
"4194",4235,40,13,27,3.51214852173669e-06,"clutch",0.35766027573918
"4195",4236,70,42,28,3.70015429643416e-06,"unkind",0.489914096922938
"4196",4237,37,5,32,3.55880751477795e-06,"glimpse",0.390482832026203
"4197",4238,41,7,34,3.33131233718211e-06,"deduce",0.23044994693881
"4198",4239,57,18,39,3.63758057240968e-06,"password",0.445896225018459
"4199",4240,84,49,35,3.68360757791751e-06,"racism",0.478274205779165
"4200",4241,46,13,33,3.51671847965227e-06,"inferior",0.360875040806673
"4201",4242,81,37,44,3.73936617743293e-06,"handsome",0.517497936335499
"4202",4243,49,11,38,3.58974911243453e-06,"smirk",0.412248889639052
"4203",4244,47,13,34,3.55275125056844e-06,"conscience",0.386222515633822
"4204",4245,48,21,27,3.55068244116519e-06,"wardrobe",0.384767198905808
"4205",4246,57,23,34,3.60479870804014e-06,"pointless",0.42283562044195
"4206",4247,54,20,34,3.53656811430188e-06,"leak",0.374838388665202
"4207",4248,32,5,27,3.4823427809293e-06,"polygon",0.336693243628954
"4208",4249,42,5,37,3.48250043531255e-06,"networking",0.336804146576726
"4209",4250,48,12,36,3.69029562958289e-06,"immobile",0.482978956952067
"4210",4252,36,11,25,3.42363747787474e-06,"substitute",0.295396636302883
"4211",4253,44,4,40,3.52522297035288e-06,"max",0.366857577216456
"4212",4254,54,15,39,3.69795133496043e-06,"lumberjack",0.488364410093955
"4213",4255,75,35,40,3.77868970155909e-06,"tablet",0.545160311794259
"4214",4256,41,6,35,3.57510582313236e-06,"handwriting",0.401947977510011
"4215",4257,55,8,47,3.74790117534181e-06,"intern",0.523501933229007
"4216",4258,35,13,22,3.48035513543802e-06,"soot",0.335295022155155
"4217",4259,34,4,30,3.50170708220257e-06,"conserve",0.350315180732031
"4218",4260,37,6,31,3.57221956290321e-06,"lag",0.399917619959292
"4219",4261,37,4,33,3.53788187012436e-06,"pricey",0.375762558297248
"4220",4262,63,25,38,3.61293865591456e-06,"Superman",0.428561716953404
"4221",4263,50,11,39,3.64347835591683e-06,"detention",0.450045057183801
"4222",4264,62,27,35,3.71024472774224e-06,"coward",0.497012273029673
"4223",4265,30,4,26,3.46497945267185e-06,"smooch",0.324478903328976
"4224",4266,35,11,24,3.23999974080002e-06,"snort",0.166215538111879
"4225",4267,52,20,32,3.55807308993741e-06,"calculator",0.389966196344723
"4226",4268,74,46,28,3.61433590192138e-06,"medal",0.429544618270307
"4227",4269,71,34,37,3.67432273046271e-06,"cocktail",0.471742722600089
"4228",4270,36,6,30,3.57359825608405e-06,"obligatory",0.400887470176388
"4229",4271,99,63,36,3.80186215208209e-06,"homeless",0.561461114962619
"4230",4272,42,8,34,3.66781346967819e-06,"adoration",0.46716374297449
"4231",4273,100,66,34,3.77300115831136e-06,"boots",0.541158670979278
"4232",4274,59,30,29,3.57634604724353e-06,"mobile",0.402820420806447
"4233",4275,32,6,26,3.53523033793267e-06,"respiration",0.373897321631477
"4234",4276,46,7,39,3.66911886110551e-06,"textbook",0.468082028621201
"4235",4277,72,28,44,3.66096532333646e-06,"valley",0.462346372214594
"4236",4278,45,10,35,3.63936776903116e-06,"iffy",0.447153439499123
"4237",4279,36,9,27,3.41097857564357e-06,"flaw",0.286491653491804
"4238",4280,63,23,40,3.74578131379534e-06,"hot dog",0.522010703556129
"4239",4281,42,15,27,3.53346901854365e-06,"null",0.37265831064951
"4240",4282,31,6,25,3.48750427219273e-06,"stork",0.340324126476539
"4241",4283,69,43,26,3.658112779617e-06,"lawn",0.460339732750463
"4242",4284,57,13,44,3.73655773355354e-06,"holding",0.515522319175726
"4243",4285,46,11,35,3.52673974071409e-06,"collector",0.367924558677278
"4244",4286,70,36,34,3.66558165449694e-06,"sloppy",0.465593758827081
"4245",4287,48,9,39,3.72936727554803e-06,"suite",0.510464147165742
"4246",4288,42,2,40,3.62286024816593e-06,"mandate",0.435541122184874
"4247",4289,68,20,48,3.68943787724502e-06,"housing",0.482375565782332
"4248",4290,45,14,31,3.52677705478848e-06,"kneel",0.36795080749293
"4249",4291,53,11,42,3.64731885590902e-06,"prophet",0.452746680578301
"4250",4292,49,9,40,3.62913176651618e-06,"blinds",0.439952860429508
"4251",4293,121,80,41,3.82789771857296e-06,"creepy",0.579775994708426
"4252",4295,39,17,22,3.3722263438322e-06,"chick",0.25923115713365
"4253",4296,71,34,37,3.61510680833065e-06,"cautious",0.430086917136207
"4254",4297,55,18,37,3.53746887027394e-06,"beginner",0.375472031006512
"4255",4298,73,31,42,3.66199761970155e-06,"crab",0.463072547456269
"4256",4299,82,38,44,3.63292886725278e-06,"forbidden",0.442623954350124
"4257",4300,64,17,47,3.69088130863888e-06,"teachers",0.483390956494458
"4258",4301,73,32,41,3.66637457882522e-06,"spaceship",0.466151546333843
"4259",4302,68,33,35,3.73620871956391e-06,"miserable",0.515276803133202
"4260",4303,33,3,30,3.5331943610218e-06,"allegiance",0.372465101122625
"4261",4304,35,11,24,3.40016932843256e-06,"hamster",0.278887821906968
"4262",4306,37,9,28,3.56508780811271e-06,"satchel",0.394900743087787
"4263",4307,41,10,31,3.5472313859033e-06,"swerve",0.382339532807596
"4264",4308,40,4,36,3.59489812058726e-06,"flop",0.415870991165459
"4265",4309,30,8,22,3.52960277850331e-06,"atlas",0.369938580259467
"4266",4310,39,3,36,3.45774292372911e-06,"drawback",0.319388322434191
"4267",4311,56,23,33,3.67970385743355e-06,"daisy",0.475528109540008
"4268",4312,45,10,35,3.59087057066115e-06,"medieval",0.413037786341863
"4269",4313,62,29,33,3.60047670311549e-06,"syrup",0.419795279434446
"4270",4314,58,22,36,3.70868983114335e-06,"aggression",0.495918471431931
"4271",4315,33,8,25,3.52303713985753e-06,"siesta",0.365319941279822
"4272",4316,66,25,41,3.70818098889771e-06,"uptight",0.495560523217443
"4273",4317,60,30,30,3.48531636216619e-06,"knit",0.338785027680867
"4274",4318,48,9,39,3.53979794833311e-06,"stash",0.377110435324974
"4275",4319,44,13,31,3.643133240312e-06,"shaft",0.449802283484098
"4276",4320,48,14,34,3.70725992711527e-06,"petal",0.494912596628648
"4277",4321,111,71,40,3.78519760624103e-06,"loser",0.549738337461141
"4278",4322,50,7,43,3.54982534859285e-06,"shortage",0.384164271852195
"4279",4323,72,34,38,3.68851249668034e-06,"germs",0.481724601119541
"4280",4324,34,4,30,3.59341255610215e-06,"apprehend",0.414825961670557
"4281",4325,75,38,37,3.69957935782702e-06,"galaxy",0.489509652815497
"4282",4326,63,18,45,3.7178867531695e-06,"studious",0.502388102926199
"4283",4327,52,16,36,3.61380038089456e-06,"extrovert",0.429167902702739
"4284",4328,45,9,36,3.48830719428476e-06,"comprehensive",0.340888946971834
"4285",4329,98,52,46,3.69919616467342e-06,"pan",0.489240093229381
"4286",4330,32,6,26,3.43154412622592e-06,"revolve",0.300958616826524
"4287",4331,56,15,41,3.68016428253357e-06,"cheerleader",0.475851998414935
"4288",4332,61,26,35,3.60452584264803e-06,"wiggle",0.422643671599771
"4289",4333,72,34,38,3.65570564258166e-06,"barbecue",0.458646417364015
"4290",4334,48,18,30,3.52508627648662e-06,"saliva",0.36676141907358
"4291",4335,43,9,34,3.62089255001358e-06,"medic",0.434156932789612
"4292",4336,45,10,35,3.59921968917139e-06,"dent",0.418911025226529
"4293",4337,44,2,42,3.74672161858374e-06,"proactive",0.522672166756095
"4294",4339,52,5,47,3.69760949546118e-06,"cultural",0.488123940990919
"4295",4340,75,26,49,3.71651881115996e-06,"arch",0.501425815686831
"4296",4341,43,2,41,3.62801261097184e-06,"empower",0.439165583562739
"4297",4342,51,11,40,3.60846690675e-06,"flourish",0.425416037437227
"4298",4343,48,15,33,3.63076565586151e-06,"candidate",0.441102229961688
"4299",4344,48,11,37,3.5485404852984e-06,"yearly",0.383260426847096
"4300",4345,26,4,22,3.62190236799977e-06,"herring",0.434867295477081
"4301",4346,44,13,31,3.46709381262438e-06,"resilient",0.325966262871686
"4302",4347,41,6,35,3.64576307644071e-06,"interpret",0.451652257920626
"4303",4348,42,9,33,3.49146163058241e-06,"strife",0.343107954631129
"4304",4349,45,6,39,3.58429362533379e-06,"investigator",0.408411193607357
"4305",4350,79,35,44,3.75071263540073e-06,"electronics",0.525479672138866
"4306",4351,33,7,26,3.44357360294219e-06,"ambiguous",0.309420826379011
"4307",4352,44,18,26,3.48952444760828e-06,"vintage",0.341745231326097
"4308",4353,41,2,39,3.68074674990062e-06,"adversity",0.476261738674939
"4309",4354,68,22,46,3.63902343167188e-06,"berries",0.446911213261044
"4310",4355,27,9,18,3.30521695444089e-06,"martini",0.212092989082954
"4311",4356,54,19,35,3.67895929599435e-06,"crossing",0.475004343205706
"4312",4357,44,9,35,3.58126425790833e-06,"coil",0.406280166417201
"4313",4358,51,21,30,3.44950102967606e-06,"are",0.313590511254927
"4314",4359,56,28,28,3.6407457703636e-06,"stumble",0.448122803031197
"4315",4360,53,21,32,3.6400963897524e-06,"ninja",0.447665992237103
"4316",4361,36,7,29,3.28848930090006e-06,"adverb",0.200325818081039
"4317",4362,43,12,31,3.585797373762e-06,"independence",0.409469014709133
"4318",4363,99,60,39,3.69688500469504e-06,"Italy",0.487614293495312
"4319",4364,60,18,42,3.69810176436435e-06,"mummy",0.488470230585474
"4320",4365,42,5,37,3.70798849040373e-06,"companionship",0.495425108965184
"4321",4366,41,5,36,3.54787322739384e-06,"adobe",0.382791040160784
"4322",4367,55,15,40,3.48909831232315e-06,"Sweden",0.341445463832833
"4323",4369,49,7,42,3.71442049468652e-06,"superiority",0.499949742028391
"4324",4370,56,20,36,3.61039504942631e-06,"tuxedo",0.426772401289028
"4325",4371,42,8,34,3.56369027255103e-06,"motel",0.39391763808173
"4326",4372,54,16,38,3.6852229928433e-06,"fearless",0.479410579367032
"4327",4373,63,22,41,3.48439340195265e-06,"insects",0.33813576562901
"4328",4374,42,13,29,3.57788153634233e-06,"chuck",0.403900570078613
"4329",4375,72,33,39,3.72507459461876e-06,"robbery",0.507444434303557
"4330",4376,52,10,42,3.60292846025249e-06,"crutch",0.421519983106473
"4331",4377,120,82,38,3.77035520516388e-06,"rubber",0.539297358926549
"4332",4378,78,44,34,3.69482244530739e-06,"flash",0.486163373379296
"4333",4379,35,9,26,3.56407130993877e-06,"nostril",0.394185681181062
"4334",4380,39,6,33,3.63118754357425e-06,"leech",0.441399009473969
"4335",4381,43,12,31,3.54602384346432e-06,"leopard",0.381490079634929
"4336",4382,46,11,35,3.6088315325264e-06,"upgrade",0.425672535687393
"4337",4383,44,11,33,3.5151732453134e-06,"courtesy",0.359788036185304
"4338",4384,49,11,38,3.53862050418265e-06,"gorge",0.376282154978908
"4339",4385,40,7,33,3.53763155567348e-06,"gust",0.375586473053699
"4340",4386,56,11,45,3.6817224570343e-06,"numb",0.47694810587293
"4341",4387,29,7,22,3.47856335333507e-06,"origami",0.334034581989289
"4342",4388,35,7,28,3.62756514200104e-06,"bachelor",0.438850808756781
"4343",4389,52,17,35,3.74565504015342e-06,"ethics",0.521921875584302
"4344",4390,44,9,35,3.52260278074264e-06,"hardly",0.365014388682818
"4345",4391,52,23,29,3.49143725014402e-06,"detergent",0.34309080406145
"4346",4392,55,23,32,3.65058098996455e-06,"anticipation",0.455041448889285
"4347",4393,89,52,37,3.70186648107976e-06,"stripes",0.491118543766749
"4348",4394,65,20,45,3.78187649147754e-06,"misunderstood",0.547402078807552
"4349",4395,54,9,45,3.64378370499927e-06,"prone",0.450259856878189
"4350",4396,62,22,40,3.61935922864216e-06,"unconscious",0.433078308418637
"4351",4397,39,13,26,3.49937886025231e-06,"trek",0.348677378648651
"4352",4398,52,14,38,3.7152622975182e-06,"protector",0.500541913419682
"4353",4399,51,17,34,3.51591478828919e-06,"aspirin",0.360309679162914
"4354",4400,37,12,25,3.56963100724278e-06,"quirky",0.398096684522655
"4355",4401,33,5,28,3.5643761985215e-06,"nitrogen",0.394400156934085
"4356",4402,48,12,36,3.68340405469118e-06,"compulsive",0.478131036110974
"4357",4403,63,31,32,3.63551755227874e-06,"contest",0.444444980789741
"4358",4404,47,9,38,3.6981564690002e-06,"intricate",0.488508712898793
"4359",4405,38,5,33,3.69832059261889e-06,"clan",0.488624166670109
"4360",4406,37,5,32,3.38119985257969e-06,"sooner",0.265543627179802
"4361",4407,26,2,24,3.40147624068846e-06,"leek",0.279807177389922
"4362",4408,91,59,32,3.60294144139275e-06,"tomato",0.421529114769612
"4363",4409,29,4,25,3.29694603888418e-06,"centipede",0.206274762548036
"4364",4410,46,13,33,3.46087823246027e-06,"fiddle",0.321593874688926
"4365",4411,48,14,34,3.70646295946241e-06,"boxer",0.494351964820292
"4366",4412,62,35,27,3.48166381750511e-06,"timid",0.336215622622698
"4367",4413,47,8,39,3.53922165437377e-06,"terrain",0.376705037786678
"4368",4414,62,21,41,3.5929993999691e-06,"survey",0.414535324441836
"4369",4415,76,41,35,3.59431666648695e-06,"trumpet",0.415461963694185
"4370",4416,72,38,34,3.62749934705012e-06,"mustache",0.43880452489296
"4371",4417,59,11,48,3.75743502455484e-06,"cheesy",0.530208578229895
"4372",4418,38,7,31,3.53403095104307e-06,"chapel",0.373053605530296
"4373",4419,39,6,33,3.33326666799997e-06,"rib",0.231824733000225
"4374",4420,47,18,29,3.57151785937506e-06,"illusion",0.399424002286716
"4375",4421,48,13,35,3.55623835331939e-06,"predict",0.388675539560433
"4376",4422,33,3,30,3.45270484897869e-06,"insinuate",0.315844257693498
"4377",4423,50,12,38,3.7030865226166e-06,"nostalgia",0.491976789506858
"4378",4424,41,9,32,3.53413086886607e-06,"snout",0.373123893338838
"4379",4425,56,14,42,3.64505875834718e-06,"humidity",0.451156801015921
"4380",4426,49,9,40,3.62471183540908e-06,"devotion",0.436843632645294
"4381",4427,51,17,34,3.73192813799178e-06,"shouting",0.512265601638384
"4382",4428,49,8,41,3.56080972813218e-06,"sensory",0.391891301352999
"4383",4429,51,15,36,3.68107192814548e-06,"woe",0.476490487315864
"4384",4430,38,2,36,3.6725280213888e-06,"pigment",0.470480223438459
"4385",4431,38,8,30,3.50487352663879e-06,"hatchet",0.352542635590424
"4386",4432,32,7,25,3.38699461806555e-06,"brim",0.269619990683011
"4387",4433,44,21,23,3.50981871786322e-06,"wand",0.356021360842176
"4388",4434,53,17,36,3.61430977526222e-06,"vegetarian",0.42952623931086
"4389",4435,56,8,48,3.76520200308747e-06,"avoidance",0.535672307158674
"4390",4436,68,23,45,3.71928336848056e-06,"fluff",0.503370560576284
"4391",4437,46,6,40,3.62413383201415e-06,"armchair",0.43643703259399
"4392",4438,34,7,27,3.41643235634756e-06,"baguette",0.290328149148185
"4393",4439,50,13,37,3.40046994494639e-06,"mumble",0.279099292446795
"4394",4440,106,61,45,3.66727543438878e-06,"potatoes",0.466785258733403
"4395",4441,46,14,32,3.4101759650798e-06,"barley",0.28592705214298
"4396",4442,56,9,47,3.62723619111182e-06,"intuitive",0.438619406225925
"4397",4443,41,7,34,3.60474673049471e-06,"burner",0.422799056517199
"4398",4444,47,8,39,3.59297358086526e-06,"foresight",0.414517161834076
"4399",4446,51,6,45,3.67952784298719e-06,"stability",0.475404291092661
"4400",4447,48,23,25,3.66902462649329e-06,"overweight",0.468015738702325
"4401",4448,61,15,46,3.75276766615379e-06,"mild",0.526925296190467
"4402",4449,47,10,37,3.51838885937352e-06,"perky",0.362050079718741
"4403",4450,57,19,38,3.59374831543048e-06,"watching",0.415062153639875
"4404",4451,98,73,25,3.7259489992101e-06,"finished",0.508059539603655
"4405",4452,45,12,33,3.59349003345539e-06,"vapor",0.414880463592307
"4406",4453,55,10,45,3.67232572060211e-06,"dome",0.470337913702967
"4407",4454,96,51,45,3.85081926179795e-06,"Irish",0.595900295591265
"4408",4455,44,14,30,3.658929250944e-06,"mimic",0.460914084538633
"4409",4456,31,3,28,3.40996665052616e-06,"nominate",0.28577980852989
"4410",4457,59,34,25,3.510249929795e-06,"volcano",0.356324699533818
"4411",4458,41,5,36,3.64040117220918e-06,"facility",0.447880393335172
"4412",4459,45,4,41,3.55330670722174e-06,"portfolio",0.386613255040732
"4413",4460,47,15,32,3.70388203876483e-06,"anything",0.492536400245336
"4414",4461,45,14,31,3.49416997739272e-06,"tweet",0.345013157890607
"4415",4462,42,15,27,3.60440891298236e-06,"anime",0.422561416705637
"4416",4463,41,8,33,3.54719363775349e-06,"gait",0.38231297863891
"4417",4464,56,20,36,3.6619305697964e-06,"obscure",0.463025380787158
"4418",4465,58,15,43,3.62764409909273e-06,"hardship",0.438906351609665
"4419",4466,49,5,44,3.63023843406035e-06,"reduction",0.440731352535573
"4420",4467,45,21,24,3.59005841025033e-06,"unwell",0.412466467094263
"4421",4468,38,10,28,3.66095192071843e-06,"breakable",0.462336944060318
"4422",4469,38,4,34,3.51935469112384e-06,"palindrome",0.362729500017431
"4423",4470,49,10,39,3.7021679895747e-06,"temptation",0.491330641776178
"4424",4471,45,10,35,3.54058752509391e-06,"diploma",0.377665867964755
"4425",4472,51,9,42,3.66890347481848e-06,"cue",0.467930513809832
"4426",4473,54,22,32,3.48005233998719e-06,"lobster",0.335082018828671
"4427",4474,78,34,44,3.65100749551839e-06,"limp",0.455341476850349
"4428",4475,33,3,30,3.58695496219349e-06,"nectarine",0.410283327427288
"4429",4476,50,6,44,3.64480633321548e-06,"teapot",0.450979231000937
"4430",4477,44,6,38,3.67564627050551e-06,"sneaker",0.47267377500224
"4431",4478,43,12,31,3.4533844894689e-06,"horseshoe",0.316322354986024
"4432",4479,26,2,24,3.46698562934457e-06,"antecedent",0.325890160676597
"4433",4480,78,35,43,3.81299545109643e-06,"creature",0.569292902786141
"4434",4481,56,19,37,3.45158462250019e-06,"radiation",0.315056227471495
"4435",4482,60,26,34,3.61934612892835e-06,"strings",0.433069093344201
"4436",4483,54,15,39,3.71672601039197e-06,"resistance",0.501571571263875
"4437",4484,43,16,27,3.58828067531442e-06,"cola",0.411215908494643
"4438",4485,37,9,28,3.45461329058825e-06,"bishop",0.317186762708447
"4439",4486,47,18,29,3.54720622038083e-06,"bronze",0.382321829965677
"4440",4487,40,7,33,3.62678891363165e-06,"timing",0.438304766125229
"4441",4488,31,4,27,3.51786901566507e-06,"bumper",0.361684392457428
"4442",4489,64,11,53,3.78628682637225e-06,"strengthen",0.550504556077004
"4443",4490,46,6,40,3.5860031126507e-06,"dramatic",0.409613742998677
"4444",4491,32,3,29,3.37881214480237e-06,"retainer",0.263863979424683
"4445",4492,53,17,36,3.57315134082504e-06,"stealth",0.400573084882402
"4446",4493,32,8,24,3.55520161548361e-06,"incident",0.387946239938822
"4447",4494,49,15,34,3.63506823023068e-06,"fungus",0.44412890242516
"4448",4495,48,15,33,3.77295845218152e-06,"hobo",0.541128629088984
"4449",4496,60,19,41,3.67524100392883e-06,"update",0.472388687730585
"4450",4497,67,35,32,3.54092602297353e-06,"submarine",0.37790398638486
"4451",4498,74,35,39,3.60231845215581e-06,"electronic",0.421090869150428
"4452",4499,32,6,26,3.51587770370995e-06,"tempo",0.36028359178704
"4453",4500,43,14,29,3.24714332565925e-06,"Tom",0.17124073691816
"4454",4501,51,10,41,3.69784193944414e-06,"leading",0.488287455143645
"4455",4502,32,3,29,3.51323435381081e-06,"illustrate",0.358424111005395
"4456",4503,49,17,32,3.52876828343067e-06,"locked",0.369351549556324
"4457",4504,43,13,30,3.5442894408529e-06,"babe",0.380270003426093
"4458",4505,74,34,40,3.75221849918764e-06,"zombie",0.526538981302761
"4459",4506,47,11,36,3.4300139944571e-06,"diagonal",0.299882236201157
"4460",4507,57,21,36,3.56994959231176e-06,"diary",0.398320795153362
"4461",4508,40,11,29,3.61400934582817e-06,"unmarried",0.429314900373462
"4462",4509,50,12,38,3.60401920221431e-06,"recycling",0.422287272263457
"4463",4510,37,5,32,3.63852028656986e-06,"landfill",0.446557272737361
"4464",4511,28,12,16,3.27054968128493e-06,"maple",0.187706082072923
"4465",4512,54,22,32,3.69944249401615e-06,"irrational",0.48941337512404
"4466",4513,33,5,28,3.50056709186888e-06,"horrendous",0.349513247504258
"4467",4514,52,26,26,3.55492356914326e-06,"surf",0.387750646526669
"4468",4515,117,87,30,3.68821320822914e-06,"fingers",0.481514064813565
"4469",4516,33,4,29,3.46100999193585e-06,"integer",0.32168656170426
"4470",4517,65,31,34,3.61943782891641e-06,"unfortunate",0.433133600266096
"4471",4518,77,39,38,3.70320994237805e-06,"dusty",0.49206360989888
"4472",4519,71,24,47,3.72511622362618e-06,"caught",0.507473718485451
"4473",4520,60,28,32,3.63562329125705e-06,"curse",0.444519363525868
"4474",4521,37,7,30,3.47159540638496e-06,"largest",0.329132936752907
"4475",4522,41,6,35,3.62913176651618e-06,"node",0.439952860429508
"4476",4523,77,31,46,3.70827724563999e-06,"unbelievable",0.495628235616185
"4477",4524,35,11,24,3.45417177596242e-06,"faulty",0.316876176523161
"4478",4525,46,10,36,3.61505453309763e-06,"jock",0.430050143801286
"4479",4526,39,10,29,3.51007743230816e-06,"armpit",0.356203355113326
"4480",4527,73,39,34,3.66148810199441e-06,"washing",0.462714124084233
"4481",4528,57,23,34,3.76995721098566e-06,"eccentric",0.539017387468419
"4482",4529,68,34,34,3.66050968936915e-06,"ham",0.462025853691507
"4483",4530,28,4,24,3.60604661897069e-06,"adieu",0.423713471078864
"4484",4531,30,4,26,3.32299880704343e-06,"selective",0.224601742913502
"4485",4532,48,13,35,3.69099029269553e-06,"misty",0.483467622000949
"4486",4533,66,35,31,3.69728138899467e-06,"charming",0.487893132474419
"4487",4534,48,7,41,3.52089120798256e-06,"accessory",0.363810372273654
"4488",4535,61,24,37,3.59973793907803e-06,"predator",0.419275591318142
"4489",4536,56,21,35,3.63442087320596e-06,"chin",0.443673515135448
"4490",4537,44,7,37,3.42352026895175e-06,"mentally",0.295314184963464
"4491",4538,43,8,35,3.62947423436241e-06,"orientation",0.440193771547103
"4492",4539,44,5,39,3.732220633955e-06,"contraption",0.512471359726821
"4493",4540,89,57,32,3.6666165562404e-06,"Olympics",0.466321766838234
"4494",4541,67,38,29,3.74594969189564e-06,"doll",0.522129150168762
"4495",4542,79,52,27,3.41997264021888e-06,"virus",0.292818583661754
"4496",4543,59,22,37,3.5969152854512e-06,"lingerie",0.417289978223926
"4497",4544,51,19,32,3.62739408009286e-06,"kitty",0.438730474202954
"4498",4545,70,25,45,3.67939245871722e-06,"awareness",0.475309054193365
"4499",4546,41,12,29,3.553837077893e-06,"interrogate",0.386986347558932
"4500",4547,49,6,43,3.73731182634954e-06,"photographer",0.516052790401724
"4501",4548,43,5,38,3.72515785356404e-06,"skim",0.507503003321874
"4502",4549,64,33,31,3.60794614058001e-06,"exhausted",0.425049701264657
"4503",4550,44,6,38,3.54215518890314e-06,"disapprove",0.37876865073531
"4504",4551,39,8,31,3.70396435304707e-06,"grapefruit",0.492594304734607
"4505",4552,44,6,38,3.61952953355123e-06,"contractor",0.433198110456776
"4506",4553,64,31,33,3.59634611234985e-06,"collar",0.416889589897084
"4507",4554,45,18,27,3.56515135850093e-06,"alley",0.394945448000134
"4508",4555,38,8,30,3.48517059910083e-06,"remedy",0.338682489753969
"4509",4556,44,12,32,3.44764577508248e-06,"lorry",0.31228542097425
"4510",4557,50,11,39,3.57993090733349e-06,"crevice",0.405342212735812
"4511",4558,41,9,32,3.48518274555726e-06,"jingle",0.338691034253628
"4512",4559,49,9,40,3.57400696216556e-06,"psychiatry",0.401174976988921
"4513",4560,84,47,37,3.769019414219e-06,"knowledgeable",0.538357688551813
"4514",4561,40,7,33,3.40221688452195e-06,"confine",0.280328187860338
"4515",4562,46,8,38,3.59566075659894e-06,"rustic",0.416407472169186
"4516",4563,150,120,30,3.81107727721395e-06,"colors",0.567943551543815
"4517",4564,68,28,40,3.7084010116518e-06,"genetics",0.495715299580151
"4518",4565,43,11,32,3.51145788708556e-06,"syringe",0.357174444536386
"4519",4566,48,16,32,3.37954295061136e-06,"chili",0.264378069276111
"4520",4567,32,5,27,3.55055637218352e-06,"crimson",0.384678514903492
"4521",4568,41,12,29,3.42590118330627e-06,"toad",0.296989053843437
"4522",4569,41,11,30,3.48007656168436e-06,"clergy",0.335099057730857
"4523",4570,53,17,36,3.38253798590158e-06,"shellfish",0.266484945314091
"4524",4571,33,4,29,3.60202001282319e-06,"carp",0.420880930162152
"4525",4572,41,8,33,3.68226474010575e-06,"contacts",0.477329578242482
"4526",4573,47,9,38,3.59367082693959e-06,"pioneer",0.415007643883281
"4527",4574,30,3,27,3.46467932660493e-06,"inhabit",0.324267777797056
"4528",4575,52,17,35,3.61214257849186e-06,"classical",0.428001711382936
"4529",4576,26,2,24,3.41775180286408e-06,"migraine",0.291256321934035
"4530",4578,39,7,32,3.64982152372749e-06,"nobility",0.454507197683048
"4531",4579,48,7,41,3.67082938719174e-06,"persuasive",0.469285308741204
"4532",4580,40,8,32,3.61685890271735e-06,"spectacle",0.431319438733418
"4533",4581,44,5,39,3.59797649801752e-06,"gradient",0.418036494745611
"4534",4582,52,13,39,3.61083829221792e-06,"treaty",0.427084203163185
"4535",4583,32,11,21,3.32505394900032e-06,"mourning",0.226047445192124
"4536",4584,46,16,30,3.50853802728941e-06,"cutlery",0.355120451163134
"4537",4585,39,4,35,3.43319348791859e-06,"validate",0.302118870476823
"4538",4586,58,18,40,3.6248957842462e-06,"crumble",0.436973032588728
"4539",4587,65,23,42,3.61055147563239e-06,"badge",0.426882440267993
"4540",4588,50,14,36,3.60811537309717e-06,"committed",0.425168748922095
"4541",4589,63,15,48,3.71457226700345e-06,"liver",0.500056507200347
"4542",4590,52,17,35,3.60051559383304e-06,"moose",0.419822637349447
"4543",4591,49,21,28,3.67092371453429e-06,"risky",0.469351663891805
"4544",4592,45,11,34,3.60281163419933e-06,"encyclopedia",0.421437801099194
"4545",4593,64,20,44,3.60917017959231e-06,"donut",0.425910759053518
"4546",4594,43,14,29,3.56998782634151e-06,"astronaut",0.39834769111729
"4547",4595,36,2,34,3.56968197703267e-06,"inanimate",0.398132539535555
"4548",4596,36,6,30,3.46836847946726e-06,"altar",0.326862935120067
"4549",4597,60,19,41,3.74317338753448e-06,"traditional",0.520176141751214
"4550",4598,52,14,38,3.72116561791816e-06,"sickly",0.504694640546399
"4551",4599,46,13,33,3.44384636312605e-06,"brew",0.309612701211793
"4552",4600,39,7,32,3.49070599528755e-06,"digger",0.342576398324799
"4553",4601,49,13,36,3.62328030058733e-06,"assessment",0.435836610650151
"4554",4603,48,6,42,3.52009799952831e-06,"assign",0.363252384896725
"4555",4604,37,5,32,3.47707564030348e-06,"likelihood",0.332988041086119
"4556",4605,69,37,32,3.68188512518409e-06,"cherry",0.477062535785681
"4557",4606,61,29,32,3.6992372172858e-06,"wreck",0.489268971942631
"4558",4607,80,55,25,3.56950358913586e-06,"itch",0.398007051469864
"4559",4608,43,13,30,3.61261235224415e-06,"faucet",0.428332176624938
"4560",4609,40,5,35,3.4423644913218e-06,"anytime",0.308570269356007
"4561",4610,45,5,40,3.63730272179363e-06,"endearment",0.44570076928977
"4562",4611,54,8,46,3.70393691454647e-06,"maneuver",0.492575002952218
"4563",4612,34,6,28,3.34425790916996e-06,"rhinoceros",0.239556589357411
"4564",4613,54,18,36,3.61147727477925e-06,"nausea",0.427533699384996
"4565",4614,42,5,37,3.71171826573676e-06,"worrying",0.498048842415628
"4566",4615,56,14,42,3.54128966687088e-06,"glide",0.378159793926157
"4567",4616,69,28,41,3.67670038200917e-06,"sleeping",0.473415296237622
"4568",4617,46,6,40,3.70466417219279e-06,"infidelity",0.493086596826743
"4569",4618,29,8,21,3.54236849842542e-06,"panda",0.378918704633717
"4570",4619,46,11,35,3.50988031308132e-06,"floppy",0.356064690378057
"4571",4620,60,30,30,3.60375944184974e-06,"dim",0.42210454223369
"4572",4621,30,5,25,3.57929022674804e-06,"billiards",0.404891522028461
"4573",4622,72,35,37,3.68341762220659e-06,"cuddle",0.478140580263324
"4574",4623,57,16,41,3.68100417793974e-06,"camouflage",0.47644282801599
"4575",4624,73,41,32,3.60962615101954e-06,"robber",0.426231514964866
"4576",4625,46,13,33,3.52744884317315e-06,"staircase",0.368423381173406
"4577",4626,48,14,34,3.49340096557603e-06,"wireless",0.344472191787535
"4578",4627,39,5,34,3.59440710254843e-06,"hacker",0.415525581499135
"4579",4628,52,10,42,3.65733680048862e-06,"telegraph",0.459793865449037
"4580",4629,46,11,35,3.63701168571855e-06,"tangible",0.445496038168645
"4581",4630,59,15,44,3.69317132621782e-06,"patch",0.485001883477318
"4582",4631,56,17,39,3.6006841299847e-06,"deodorant",0.419941195144284
"4583",4632,70,40,30,3.66550103733679e-06,"hearing",0.46553704818881
"4584",4633,31,5,26,3.31728871358861e-06,"scrumptious",0.220584942472498
"4585",4634,55,19,36,3.72364589616986e-06,"rider",0.506439407572382
"4586",4635,67,24,43,3.66101893478993e-06,"ceramic",0.462384085522031
"4587",4636,67,35,32,3.64335888542365e-06,"mosquito",0.449961014928892
"4588",4637,45,5,40,3.58390825194875e-06,"academy",0.408140100323996
"4589",4638,49,13,36,3.62339845788162e-06,"sane",0.435919729127202
"4590",4639,53,7,46,3.72347951713918e-06,"eyeball",0.506322367217595
"4591",4640,80,39,41,3.69051353495839e-06,"stew",0.483132243831756
"4592",4641,62,22,40,3.74499574942982e-06,"obsessive",0.52145809346055
"4593",4642,52,19,33,3.6487561390322e-06,"irritated",0.453757746251522
"4594",4643,50,5,45,3.66174284312361e-06,"organizer",0.462893323301936
"4595",4645,62,15,47,3.77004248837884e-06,"productive",0.539077376376355
"4596",4646,51,15,36,3.59038065215674e-06,"instruments",0.412693150149805
"4597",4647,59,25,34,3.69513646138952e-06,"thunder",0.48638426992804
"4598",4648,41,12,29,3.61004314001552e-06,"synthetic",0.426524848444645
"4599",4649,45,16,29,3.49048667855759e-06,"prank",0.34242211861912
"4600",4650,53,19,34,3.71740302224866e-06,"seaside",0.502047819427944
"4601",4651,56,19,37,3.68424542969354e-06,"discomfort",0.478722906543092
"4602",4652,54,25,29,3.63114798743623e-06,"jolly",0.441371183464831
"4603",4653,54,16,38,3.53641803290283e-06,"postman",0.374732812979856
"4604",4654,68,30,38,3.7597377206966e-06,"shady",0.531828424025928
"4605",4655,45,18,27,3.38282404917273e-06,"hum",0.266686178285635
"4606",4656,72,31,41,3.59409705499687e-06,"meditation",0.415307476637683
"4607",4657,40,7,33,3.5029337069796e-06,"cursive",0.351178057493028
"4608",4658,58,27,31,3.59210885526675e-06,"symphony",0.413908865281151
"4609",4659,55,16,39,3.59797649801752e-06,"twisted",0.418036494745611
"4610",4660,32,4,28,3.21922262212121e-06,"recently",0.151599745895482
"4611",4661,26,6,20,3.31278303590063e-06,"nephew",0.217415395727369
"4612",4662,38,10,28,3.51103870569069e-06,"hemisphere",0.356879568800097
"4613",4663,58,20,38,3.56787344039332e-06,"cheek",0.396860313287777
"4614",4664,55,14,41,3.63732918192829e-06,"radical",0.445719382834617
"4615",4665,28,4,24,3.44766954776919e-06,"pursuit",0.312302144017258
"4616",4666,44,9,35,3.54381214960557e-06,"nowhere",0.379934249955872
"4617",4667,39,9,30,3.68214271248725e-06,"boar",0.477243737161999
"4618",4668,55,15,40,3.54719363775349e-06,"colony",0.38231297863891
"4619",4669,63,19,44,3.67958199948486e-06,"poet",0.475442387814798
"4620",4670,31,8,23,3.41618726172094e-06,"freeway",0.290155735822187
"4621",4671,34,5,29,3.39231437255753e-06,"carrion",0.27336220477434
"4622",4672,93,53,40,3.7881657701341e-06,"ruin",0.551826310649143
"4623",4673,70,32,38,3.71351012117184e-06,"jewel",0.499309334167433
"4624",4674,54,17,37,3.59953062120699e-06,"instruction",0.419129752283736
"4625",4675,42,7,35,3.4630595438458e-06,"junction",0.323128331629899
"4626",4676,45,16,29,3.53508037005221e-06,"jaw",0.373791825801485
"4627",4677,34,7,27,3.4309554524744e-06,"photosynthesis",0.300544510647106
"4628",4678,86,52,34,3.7077272744126e-06,"pork",0.495241354965947
"4629",4679,54,25,29,3.5312729532742e-06,"disco",0.371113474997941
"4630",4680,60,23,37,3.69206685594663e-06,"reader",0.484224937056473
"4631",4681,63,17,46,3.77177729918115e-06,"marks",0.54029773972958
"4632",4682,43,12,31,3.57546373764677e-06,"reflective",0.402199754681557
"4633",4683,45,13,32,3.69475418800387e-06,"adorable",0.48611535735836
"4634",4684,45,12,33,3.51754728462937e-06,"reporter",0.361458068777037
"4635",4685,51,13,38,3.49699258637572e-06,"eyebrow",0.346998739579838
"4636",4686,68,32,36,3.60792010621717e-06,"fireplace",0.425031387231623
"4637",4687,76,44,32,3.76156210150951e-06,"wealthy",0.533111795955274
"4638",4688,47,13,34,3.57195160719963e-06,"diverse",0.399729124867774
"4639",4689,51,14,37,3.57584729701703e-06,"policeman",0.402469571885038
"4640",4690,52,7,45,3.61525057301722e-06,"raid",0.430188049291217
"4641",4691,74,29,45,3.64765145960773e-06,"foggy",0.452980652700514
"4642",4692,40,15,25,3.51649588218332e-06,"alpha",0.360718453244929
"4643",4693,42,13,29,3.52950311655125e-06,"merry",0.369868472444921
"4644",4694,34,4,30,3.42171626444392e-06,"dug",0.294045146871536
"4645",4695,49,18,31,3.56460489919297e-06,"tuna",0.394561037831274
"4646",4696,38,5,33,3.52154835438045e-06,"equilibrium",0.364272645958267
"4647",4697,172,137,35,3.74669354294835e-06,"British",0.522652416777305
"4648",4698,43,5,38,3.50932603393518e-06,"platypus",0.355674779295817
"4649",4699,57,19,38,3.72464448268413e-06,"anarchy",0.507141869411691
"4650",4700,64,19,45,3.65951840737759e-06,"technical",0.461328530263728
"4651",4701,41,13,28,3.57703685421071e-06,"orderly",0.403306373226029
"4652",4702,55,28,27,3.57894435457318e-06,"ketchup",0.404648216114906
"4653",4703,32,9,23,3.52839475680539e-06,"canary",0.369088789949146
"4654",4704,56,21,35,3.68735642355926e-06,"cannon",0.480911354355835
"4655",4705,84,47,37,3.68169534707342e-06,"villain",0.476929035203829
"4656",4706,42,11,31,3.48597244687378e-06,"consent",0.339246554512892
"4657",4707,42,5,37,3.66894385782109e-06,"roommate",0.467958921481959
"4658",4708,34,8,26,3.53766910058301e-06,"sorority",0.375612884251756
"4659",4709,48,10,38,3.59213466194421e-06,"spreadsheet",0.413927019147495
"4660",4710,56,22,34,3.64098437653604e-06,"sympathy",0.448290652014101
"4661",4711,38,10,28,3.54718105521542e-06,"boxers",0.382304127374938
"4662",4712,49,12,37,3.50211177339936e-06,"reed",0.350599863249153
"4663",4713,208,173,35,3.81376617036856e-06,"scared",0.56983507000927
"4664",4714,46,16,30,3.52468868187217e-06,"gaze",0.366481728691054
"4665",4715,39,10,29,3.43263959687081e-06,"expanse",0.301729232404763
"4666",4716,153,123,30,3.78608613345954e-06,"woods",0.550363377410376
"4667",4717,43,8,35,3.63142489850167e-06,"unavailable",0.441565978260854
"4668",4718,50,16,34,3.62805209882814e-06,"ditch",0.439193361538681
"4669",4719,95,54,41,3.73446462715105e-06,"bills",0.514049910573816
"4670",4720,86,55,31,3.52870602350118e-06,"damp",0.369307752425122
"4671",4721,28,5,23,3.34609310169446e-06,"ladle",0.240847566851929
"4672",4722,57,25,32,3.71098823616729e-06,"temper",0.497535298614676
"4673",4723,39,11,28,3.55875685505539e-06,"swine",0.390447195132076
"4674",4724,50,24,26,3.47955586948882e-06,"elastic",0.334732773596067
"4675",4725,41,6,35,3.4936694709187e-06,"artifact",0.344661073526052
"4676",4726,32,2,30,3.57043395054235e-06,"intimidate",0.398661519936527
"4677",4727,42,6,36,3.67845857871717e-06,"philanthropy",0.474652110550377
"4678",4728,40,5,35,3.72005818170996e-06,"jeep",0.503915607718888
"4679",4729,52,15,37,3.62943471554305e-06,"wallpaper",0.440165971790011
"4680",4730,82,45,37,3.73792649741336e-06,"carrot",0.516485184550739
"4681",4731,46,14,32,3.51013903660724e-06,"blouse",0.35624669103728
"4682",4732,63,22,41,3.6257106392853e-06,"reputation",0.437546247389204
"4683",4733,40,8,32,3.548099815144e-06,"anybody",0.382950434710448
"4684",4734,51,17,34,3.65503755551088e-06,"chaotic",0.458176447395615
"4685",4735,48,6,42,3.65501083710713e-06,"packet",0.45815765216979
"4686",4736,70,27,43,3.7931086801499e-06,"carefree",0.555303431170623
"4687",4737,41,15,26,3.55237262967936e-06,"lesbian",0.38595617243537
"4688",4738,53,6,47,3.68961484110674e-06,"attendance",0.482500052101759
"4689",4739,33,8,25,3.50708606739918e-06,"component",0.354099061027659
"4690",4740,48,14,34,3.59968610737144e-06,"pigeon",0.419239129984616
"4691",4741,65,27,38,3.53023825577988e-06,"windy",0.370385610667111
"4692",4742,31,2,29,3.43910885811269e-06,"autograph",0.306280074105511
"4693",4743,58,21,37,3.61715980612023e-06,"psychiatrist",0.431531111087117
"4694",4744,59,23,36,3.64932870598453e-06,"standing",0.454160522003762
"4695",4745,61,18,43,3.72061181740725e-06,"attentive",0.504305066163069
"4696",4746,42,4,38,3.59058691733751e-06,"radish",0.412838248662749
"4697",4747,39,9,30,3.56593957158802e-06,"priority",0.395499921355238
"4698",4748,44,8,36,3.65139410226825e-06,"peasant",0.455613437751797
"4699",4749,43,5,38,3.6784856410313e-06,"metallic",0.474671147702075
"4700",4750,40,7,33,3.52535967482082e-06,"pulse",0.366953742817158
"4701",4751,35,8,27,3.57463297455934e-06,"hefty",0.401615349266412
"4702",4752,77,37,40,3.712862096876e-06,"empire",0.498853477481742
"4703",4753,52,9,43,3.58712223119003e-06,"aristocracy",0.410400993834039
"4704",4754,43,6,37,3.52106476998644e-06,"implement",0.363932465535216
"4705",4755,42,9,33,3.63767319871517e-06,"buttocks",0.44596138356406
"4706",4756,78,34,44,3.62892104919365e-06,"spiral",0.439804630029998
"4707",4757,55,12,43,3.74609001854315e-06,"troubled",0.522227863814003
"4708",4758,60,21,39,3.67801210801586e-06,"organic",0.474338037983241
"4709",4759,49,12,37,3.71555218678824e-06,"forge",0.500745837813728
"4710",4760,46,23,23,3.32878399520655e-06,"citrus",0.228671369189988
"4711",4761,55,8,47,3.59365791251599e-06,"inconvenience",0.414998559152387
"4712",4762,60,18,42,3.60733443236789e-06,"understood",0.424619391351927
"4713",4763,47,13,34,3.59938810402232e-06,"database",0.419029497691618
"4714",4764,35,11,24,3.39775476365218e-06,"fetish",0.277189281427484
"4715",4765,43,11,32,3.52563311556673e-06,"flea",0.367146096395506
"4716",4766,48,15,33,3.59094793843679e-06,"agony",0.413092211180574
"4717",4767,39,6,33,3.6930485746679e-06,"goalie",0.484915533142817
"4718",4768,63,24,39,3.56522762195752e-06,"bondage",0.394999095998809
"4719",4769,63,18,45,3.77866114478318e-06,"suits",0.545140223354207
"4720",4770,74,37,37,3.62690729987632e-06,"hose",0.438388045658844
"4721",4771,36,5,31,3.54647657552222e-06,"facet",0.381808556791949
"4722",4772,37,3,34,3.64240340346174e-06,"influential",0.449288875252662
"4723",4773,35,11,24,3.30056967832648e-06,"enigma",0.208823834051861
"4724",4774,37,10,27,3.48228214842879e-06,"collision",0.336650591322702
"4725",4775,85,55,30,3.62342471610467e-06,"medication",0.435938200636082
"4726",4777,32,3,29,3.39927935277721e-06,"colander",0.278261763045908
"4727",4778,46,15,31,3.63077883836862e-06,"creek",0.441111503277579
"4728",4779,30,2,28,3.57996935546232e-06,"platinum",0.405369259309052
"4729",4780,33,3,30,3.45636853183834e-06,"testify",0.31842149798611
"4730",4781,33,5,28,3.41231709980345e-06,"jot",0.287433246563486
"4731",4782,30,6,24,3.29247373429078e-06,"sine",0.203128692312022
"4732",4783,61,31,30,3.80643515928028e-06,"whore",0.564678025066762
"4733",4784,35,12,23,3.43806835567505e-06,"forecast",0.305548126251515
"4734",4785,36,2,34,3.46217230539129e-06,"sodium",0.322504198269646
"4735",4786,30,3,27,3.61408771390882e-06,"ethanol",0.429370028882899
"4736",4787,37,2,35,3.58858972012589e-06,"portray",0.411433307972393
"4737",4788,49,12,37,3.68658158036379e-06,"pod",0.480366286133418
"4738",4789,36,13,23,3.61472784714039e-06,"bait",0.429820334550788
"4739",4790,48,10,38,3.73116229436632e-06,"burp",0.511726864218968
"4740",4791,63,30,33,3.5706379301726e-06,"peas",0.398805010664876
"4741",4793,42,12,30,3.60473373634257e-06,"cod",0.422789915700766
"4742",4794,51,13,38,3.68069255911192e-06,"hawk",0.476223617830567
"4743",4795,38,9,29,3.5650623885918e-06,"grimace",0.3948828615691
"4744",4796,54,17,37,3.61548584898839e-06,"archeology",0.43035355562351
"4745",4797,71,22,49,3.6814107165866e-06,"shipping",0.476728810133251
"4746",4798,28,3,25,3.45829298658182e-06,"accord",0.31977526753883
"4747",4799,43,12,31,3.59212175855913e-06,"greatest",0.413917942181718
"4748",4800,38,2,36,3.61950333175282e-06,"harmonica",0.43317967864016
"4749",4801,47,20,27,3.55641541777212e-06,"gin",0.388800096641227
"4750",4802,47,12,35,3.67092371453429e-06,"pat",0.469351663891805
"4751",4803,37,3,34,3.53154731213934e-06,"indulge",0.371306474432928
"4752",4804,41,4,37,3.74324344558073e-06,"mayor",0.520225424515721
"4753",4805,48,10,38,3.54862863246498e-06,"heap",0.38332243451482
"4754",4807,30,4,26,3.34388887588488e-06,"grasshopper",0.239296990618095
"4755",4808,52,9,43,3.6382422923837e-06,"format",0.446361716013399
"4756",4809,47,8,39,3.68042162910183e-06,"crib",0.476033030444803
"4757",4810,34,7,27,3.52436570228273e-06,"commute",0.366254526707834
"4758",4811,49,20,29,3.5707526789572e-06,"frustrating",0.398885731404773
"4759",4813,56,17,39,3.61487158168706e-06,"claw",0.429921445503704
"4760",4814,38,2,36,3.46949962876354e-06,"archive",0.327658649065574
"4761",4815,211,168,43,3.82035177799172e-06,"unknown",0.57446775628915
"4762",4816,149,112,37,3.80047505938242e-06,"depression",0.560485356052223
"4763",4817,49,18,31,3.64574978490076e-06,"agriculture",0.45164290790491
"4764",4818,58,25,33,3.61879602656196e-06,"plague",0.432682120443429
"4765",4819,41,5,36,3.65300806949483e-06,"productivity",0.456748792946732
"4766",4820,46,11,35,3.61420527240265e-06,"sucker",0.429452726130084
"4767",4821,52,5,47,3.75948329661571e-06,"limbo",0.531649447837813
"4768",4822,57,23,34,3.65156743532161e-06,"melancholy",0.455735369956709
"4769",4823,78,40,38,3.56046741816266e-06,"monk",0.391650501294749
"4770",4824,42,7,35,3.43236860892965e-06,"volt",0.301538604267036
"4771",4825,55,15,40,3.60505861825313e-06,"fade",0.423018455883509
"4772",4826,51,22,29,3.49718826063845e-06,"mend",0.347136387846201
"4773",4827,36,2,34,3.46688947209674e-06,"inverse",0.325822518267847
"4774",4828,47,11,36,3.70775476909957e-06,"applaud",0.495260696272988
"4775",4829,39,4,35,3.50310550302843e-06,"speculate",0.351298908482631
"4776",4830,54,19,35,3.59945288316176e-06,"stockings",0.419075066976594
"4777",4831,41,5,36,3.44036302710662e-06,"inertia",0.307162327015694
"4778",4832,82,32,50,3.74051312359029e-06,"goose",0.518304762680318
"4779",4833,52,6,46,3.64972827772972e-06,"sweating",0.454441603211098
"4780",4834,156,114,42,3.67128759398496e-06,"nervous",0.469607637134539
"4781",4835,42,10,32,3.57327901949224e-06,"optimist",0.400662901227924
"4782",4836,39,7,32,3.35953772760868e-06,"burrow",0.250305271831486
"4783",4837,41,8,33,3.51201283991894e-06,"cobra",0.357564829528069
"4784",4838,48,16,32,3.63187332025859e-06,"creator",0.441881423310079
"4785",4840,51,9,42,3.66052308874938e-06,"firefighter",0.462035279568135
"4786",4841,63,26,37,3.6949999261e-06,"hedge",0.486288223336949
"4787",4842,40,7,33,3.55563140902561e-06,"millennium",0.38824858085543
"4788",4843,44,5,39,3.59628144498588e-06,"hallmark",0.416844099241255
"4789",4844,38,3,35,3.5545950249888e-06,"communion",0.387519530115884
"4790",4845,46,15,31,3.65549182814802e-06,"outsider",0.458496008282599
"4791",4846,30,3,27,3.59589348963484e-06,"brevity",0.416571189657987
"4792",4847,54,21,33,3.67741698231162e-06,"geology",0.473919393137909
"4793",4848,38,4,34,3.74564101027429e-06,"heath",0.521912006179341
"4794",4849,48,17,31,3.65895602666647e-06,"riding",0.460932920085663
"4795",4850,37,4,33,3.33397790239446e-06,"generally",0.232325055219475
"4796",4851,67,28,39,3.67824209453818e-06,"photography",0.474499823420132
"4797",4852,69,27,42,3.5390838727487e-06,"tied",0.37660811445316
"4798",4853,39,4,35,3.61240354882525e-06,"coverage",0.428185292572725
"4799",4854,44,6,38,3.64703951567315e-06,"industrious",0.45255017696737
"4800",4855,79,36,43,3.76392652815417e-06,"slavery",0.534775066454107
"4801",4856,51,13,38,3.56712254492791e-06,"motorbike",0.396332091243692
"4802",4857,42,8,34,3.7686501072181e-06,"tavern",0.53809789726541
"4803",4858,49,12,37,3.70262034441774e-06,"jealousy",0.491648853579089
"4804",4859,39,12,27,3.52220574612645e-06,"spinach",0.364735092234522
"4805",4860,53,17,36,3.68119388480072e-06,"insufficient",0.476576278476803
"4806",4861,54,21,33,3.57891873707116e-06,"pyramid",0.40463019532519
"4807",4862,98,60,38,3.65862135829977e-06,"juicy",0.460697495560021
"4808",4863,33,6,27,3.48196689345878e-06,"rite",0.336428823270636
"4809",4864,40,9,31,3.34090605372177e-06,"hilarious",0.237198705979672
"4810",4865,39,6,33,3.69259855545544e-06,"operator",0.484598964353643
"4811",4866,40,6,34,3.47187262393717e-06,"plausible",0.329327947148936
"4812",4867,53,22,31,3.425384841987e-06,"molecule",0.296625830359379
"4813",4868,28,3,25,3.51614967545938e-06,"cyborg",0.360474911990763
"4814",4869,38,10,28,3.44804995534775e-06,"minority",0.312569744073446
"4815",4870,56,18,38,3.65929075626562e-06,"alcoholic",0.461168387685645
"4816",4871,46,13,33,3.56198929978414e-06,"gloss",0.392721078303114
"4817",4872,54,13,41,3.73493885905088e-06,"accuracy",0.514383511927179
"4818",4873,50,18,32,3.64253607931987e-06,"laser",0.449382206902948
"4819",4875,43,6,37,3.28628469084277e-06,"granted",0.198774971545786
"4820",4876,46,8,38,3.61564271664931e-06,"amoeba",0.430463905146607
"4821",4877,56,6,50,3.65394242117533e-06,"supporter",0.457406068396247
"4822",4878,61,24,37,3.70739736997231e-06,"nightmare",0.495009281653705
"4823",4879,61,31,30,3.72072256432199e-06,"flowing",0.504382971762946
"4824",4880,54,24,30,3.52410487736115e-06,"skiing",0.366071047808876
"4825",4881,53,14,39,3.6924758419768e-06,"designer",0.484512640800619
"4826",4882,49,16,33,3.65586601982211e-06,"chilly",0.458759235722462
"4827",4883,44,5,39,3.38550394919036e-06,"tongs",0.268571370473438
"4828",4885,61,24,37,3.55641541777212e-06,"lizard",0.388800096641227
"4829",4886,137,99,38,3.72156722639038e-06,"sword",0.504977154501923
"4830",4887,45,4,41,3.70950151718612e-06,"bohemian",0.496489456982404
"4831",4888,36,4,32,3.59425207208632e-06,"angelic",0.415416524364866
"4832",4889,49,26,23,3.58190564544149e-06,"bald",0.406731354431275
"4833",4890,78,42,36,3.64505875834718e-06,"foam",0.451156801015921
"4834",4891,49,14,35,3.57125000892813e-06,"distress",0.399235581238643
"4835",4893,68,26,42,3.64895585128316e-06,"hyper",0.453898235065592
"4836",4894,44,22,22,3.64197890565818e-06,"wicked",0.448990259655904
"4837",4895,54,17,37,3.62530316597725e-06,"evaluation",0.437259607778765
"4838",4896,38,6,32,3.58794593683062e-06,"devour",0.410980434644699
"4839",4897,43,8,35,3.45213272759911e-06,"perimeter",0.315441795382157
"4840",4898,61,24,37,3.56338550129707e-06,"rum",0.393703244864352
"4841",4899,28,4,24,3.39766240826312e-06,"flint",0.277124313459717
"4842",4900,52,14,38,3.55652925423138e-06,"twitch",0.388880175600247
"4843",4901,56,15,41,3.63162271797907e-06,"tribal",0.441705135591701
"4844",4902,113,77,36,3.80991568656586e-06,"crying",0.567126423441718
"4845",4903,51,9,42,3.61280812737316e-06,"onions",0.428469895846306
"4846",4904,42,21,21,3.52799641555564e-06,"fury",0.368808574341411
"4847",4905,52,11,41,3.57688331848927e-06,"diner",0.403198367576301
"4848",4906,55,24,31,3.54499305181362e-06,"notebook",0.380764962893863
"4849",4907,47,21,26,3.49027957139367e-06,"yawn",0.342276427807934
"4850",4908,55,16,39,3.77113722414131e-06,"entice",0.539847474997027
"4851",4909,46,6,40,3.44881102240003e-06,"emit",0.313105121383012
"4852",4910,68,33,35,3.58478188394627e-06,"chip",0.408754662138209
"4853",4911,40,4,36,3.60960009240576e-06,"tambourine",0.426213183872365
"4854",4912,51,17,34,3.56966923444874e-06,"tragic",0.398123575686338
"4855",4913,54,19,35,3.64695971203606e-06,"agile",0.452494038606904
"4856",4914,41,8,33,3.5686501224047e-06,"translucent",0.397406675036583
"4857",4915,43,8,35,3.6559462137193e-06,"contentment",0.458815648613807
"4858",4916,61,33,28,3.6125340481334e-06,"aroma",0.428277093115519
"4859",4917,40,6,34,3.51906983946003e-06,"hesitation",0.362529119358545
"4860",4918,55,22,33,3.73619476036047e-06,"clam",0.515266983445489
"4861",4919,71,27,44,3.77184843204261e-06,"engineering",0.540347778579477
"4862",4920,46,16,30,3.55104809184431e-06,"pollen",0.385024418130108
"4863",4921,54,9,45,3.61729064930367e-06,"withdraw",0.431623153531096
"4864",4922,54,21,33,3.60561755214624e-06,"inheritance",0.4234116413762
"4865",4923,40,13,27,3.70311394851931e-06,"April",0.491996082427187
"4866",4924,62,26,36,3.65124744869085e-06,"angst",0.45551027338872
"4867",4925,47,7,40,3.58590024025532e-06,"skeptic",0.409541376777981
"4868",4926,63,17,46,3.73302871818993e-06,"advanced",0.513039811563367
"4869",4927,45,17,28,3.58945275203343e-06,"Cinderella",0.412040413087962
"4870",4928,55,24,31,3.74519210962926e-06,"trendy",0.521596224253319
"4871",4929,29,2,27,3.54658977660031e-06,"fir",0.381888188788167
"4872",4931,43,11,32,3.63975191450951e-06,"slender",0.447423669003951
"4873",4932,40,12,28,3.66446676511867e-06,"stamps",0.464809483021141
"4874",4933,44,12,32,3.62225659341256e-06,"subjective",0.435116477527356
"4875",4934,41,3,38,3.63980490645701e-06,"slingshot",0.447460946516097
"4876",4935,45,6,39,3.55920017653633e-06,"frenzy",0.390759052360723
"4877",4936,25,5,20,3.2740940581741e-06,"nada",0.190199395845132
"4878",4937,44,17,27,3.53328174741982e-06,"litter",0.372526573623012
"4879",4938,32,3,29,3.60850597027313e-06,"gratuity",0.425443516913382
"4880",4939,70,23,47,3.72526887128079e-06,"salesman",0.507581099419091
"4881",4940,47,14,33,3.52507385029716e-06,"trailer",0.366752677794007
"4882",4941,54,12,42,3.65694893436508e-06,"frequency",0.45952101863341
"4883",4942,38,10,28,3.53540531654251e-06,"trigonometry",0.374020411413239
"4884",4943,44,8,36,3.58839656088074e-06,"concede",0.41129742891065
"4885",4944,69,17,52,3.63042294427301e-06,"swollen",0.440861147382092
"4886",4945,29,6,23,3.43656783097585e-06,"haggle",0.304492572901789
"4887",4946,71,26,45,3.65032779943639e-06,"garlic",0.45486334045144
"4888",4947,39,12,27,3.55289009845058e-06,"duel",0.386320189032453
"4889",4948,46,15,31,3.60599460543207e-06,"sub",0.423676881834481
"4890",4949,73,42,31,3.74509392695569e-06,"terror",0.52152715704634
"4891",4950,30,4,26,3.46265183728306e-06,"casket",0.322841527935014
"4892",4951,48,17,31,3.44947723172553e-06,"broccoli",0.313573770439925
"4893",4952,71,29,42,3.68965568133182e-06,"bent",0.482528781409855
"4894",4953,43,9,34,3.71660168808049e-06,"capability",0.501484115967473
"4895",4954,34,3,31,3.55764270594304e-06,"underage",0.389663440070755
"4896",4955,49,14,35,3.72153952647131e-06,"overflow",0.504957668823097
"4897",4956,37,5,32,3.53824488900526e-06,"sincerity",0.37601792616687
"4898",4957,50,9,41,3.690826819024e-06,"circumstance",0.483352625438967
"4899",4958,65,33,32,3.4616569567189e-06,"crops",0.322141673069154
"4900",4959,47,10,37,3.66621327829125e-06,"loft",0.466038078478876
"4901",4960,43,4,39,3.54607414131815e-06,"currant",0.381525461970265
"4902",4961,49,6,43,3.55731365901726e-06,"revise",0.389431969982381
"4903",4962,52,14,38,3.40382658184331e-06,"mammoth",0.281460539364119
"4904",4963,42,10,32,3.65646755981981e-06,"obesity",0.459182392742077
"4905",4964,56,21,35,3.61032987584076e-06,"gadget",0.426726554528504
"4906",4965,49,7,42,3.54351076872923e-06,"lawful",0.379722241720525
"4907",4966,50,11,39,3.67768747011879e-06,"python",0.474109669453297
"4908",4967,33,4,29,3.550985043251e-06,"affectionate",0.384980066208477
"4909",4968,55,26,29,3.75872023093577e-06,"condom",0.531112664581294
"4910",4969,43,23,20,3.38430090496206e-06,"Satan",0.267725081594806
"4911",4970,43,15,28,3.61774867499955e-06,"coma",0.431945354530387
"4912",4971,52,13,39,3.6822782992293e-06,"scum",0.477339116491525
"4913",4972,38,6,32,3.44484289793964e-06,"gecko",0.310313719769612
"4914",4973,43,17,26,3.56386807985916e-06,"phony",0.394042717728734
"4915",4974,38,5,33,3.70752107725732e-06,"bunk",0.495096304305952
"4916",4975,59,18,41,3.75925717078305e-06,"ginger",0.531490378226862
"4917",4976,46,7,39,3.59205724302422e-06,"conform",0.41387255833098
"4918",4977,47,16,31,3.54883012814826e-06,"hive",0.38346417789535
"4919",4978,67,21,46,3.72724053746809e-06,"strain",0.508968080153001
"4920",4979,56,26,30,3.51369109736087e-06,"trophy",0.358745410071309
"4921",4980,33,5,28,3.46676928303744e-06,"saloon",0.325737970533173
"4922",4981,44,5,39,3.46718998120783e-06,"eloquent",0.32603391325455
"4923",4982,57,28,29,3.36452245650514e-06,"atom",0.253811810102355
"4924",4983,38,5,33,3.39884031568429e-06,"calamari",0.277952919696421
"4925",4984,68,26,42,3.64318633076489e-06,"luxurious",0.449839630290462
"4926",4985,60,15,45,3.72295274828372e-06,"manipulation",0.505951808418926
"4927",4986,42,5,37,3.62194172295768e-06,"artwork",0.434894979964828
"4928",4987,40,5,35,3.43168543798601e-06,"intervene",0.301058023455286
"4929",4988,54,10,44,3.60482469737497e-06,"heartfelt",0.422853902799744
"4930",4989,32,6,26,3.64723904004668e-06,"librarian",0.452690533617911
"4931",4990,67,33,34,3.59967314967801e-06,"secretive",0.419230014815296
"4932",4991,44,9,35,3.71924186973727e-06,"issues",0.503341368029496
"4933",4992,51,16,35,3.61667576863402e-06,"organism",0.431190611933559
"4934",4993,44,11,33,3.34735876656524e-06,"parsley",0.241737906607546
"4935",4994,59,13,46,3.67089676337032e-06,"unrealistic",0.469332704929372
"4936",4995,52,23,29,3.51349357206351e-06,"pimple",0.358606459683227
"4937",4996,49,5,44,3.84923323274004e-06,"smoker",0.594784593673307
"4938",4997,45,10,35,3.66085810513984e-06,"headphones",0.462270948913234
"4939",4998,52,17,35,3.64531121844527e-06,"siren",0.451334395628228
"4940",4999,73,35,38,3.67432273046271e-06,"graceful",0.471742722600089
"4941",5000,51,11,40,3.66419821846683e-06,"intrigue",0.464620572223427
"4942",5001,46,14,32,3.5906900588155e-06,"lawsuit",0.412910804171266
"4943",5002,29,5,24,3.67128759398496e-06,"blubber",0.469607637134539
"4944",5003,41,3,38,3.37577811685594e-06,"venture",0.261729673762315
"4945",5004,43,13,30,3.54480455720074e-06,"northern",0.380632365196447
"4946",5005,44,10,34,3.60544855385459e-06,"concentration",0.423292758486132
"4947",5006,46,5,41,3.44684957948435e-06,"immunity",0.311725332272548
"4948",5007,41,11,30,3.56833176921457e-06,"alligator",0.397182727522483
"4949",5008,50,19,31,3.55451921573088e-06,"feeble",0.387466201626067
"4950",5009,49,10,39,3.64795750859094e-06,"tutor",0.453195944744409
"4951",5010,38,10,28,3.63494931063186e-06,"ozone",0.444045247700284
"4952",5011,67,26,41,3.69378520639025e-06,"sigh",0.485433721268911
"4953",5012,44,9,35,3.50554928451739e-06,"helium",0.353018001635875
"4954",5013,45,8,37,3.60231845215581e-06,"projector",0.421090869150428
"4955",5014,32,6,26,3.52762305231112e-06,"flora",0.368545929665434
"4956",5015,59,22,37,3.65945144822791e-06,"tattoo",0.461281427437113
"4957",5016,60,19,41,3.4454363472862e-06,"shrimp",0.310731185370806
"4958",5017,29,4,25,3.57784313304567e-06,"glucose",0.40387355504284
"4959",5018,76,36,40,3.55666839757862e-06,"harvest",0.38897805684562
"4960",5019,46,10,36,3.65485053488738e-06,"outlet",0.458044886585109
"4961",5020,46,13,33,3.55107331190852e-06,"fatigue",0.385042159339751
"4962",5021,43,8,35,3.70009953267743e-06,"jogging",0.48987557302067
"4963",5022,40,7,33,3.60260396214384e-06,"groove",0.421291712911551
"4964",5023,55,12,43,3.68675827032049e-06,"gently",0.480490579772673
"4965",5024,54,19,35,3.53214606130393e-06,"apt",0.371727668223781
"4966",5025,54,19,35,3.61060362071331e-06,"rip",0.42691912204662
"4967",5026,67,27,40,3.73265249751779e-06,"equipment",0.512775156812314
"4968",5027,37,7,30,3.53982300884956e-06,"sieve",0.377128064299756
"4969",5028,46,15,31,3.60231845215581e-06,"tyrant",0.421090869150428
"4970",5029,58,16,42,3.6214432900088e-06,"majestic",0.43454435423432
"4971",5030,44,14,30,3.44132201826654e-06,"transaction",0.307836935258896
"4972",5031,44,13,31,3.61239049941299e-06,"hangover",0.428176112883227
"4973",5032,32,10,22,3.41964517761637e-06,"January",0.292588228075358
"4974",5033,33,10,23,3.23276210426951e-06,"lasso",0.161124178077648
"4975",5034,56,22,34,3.65447655105121e-06,"laptop",0.457781805350113
"4976",5035,43,11,32,3.5793799082247e-06,"segregation",0.404954609016067
"4977",5036,35,6,29,3.57187505581055e-06,"warp",0.399675274321222
"4978",5037,44,4,40,3.62343784535892e-06,"toaster",0.435947436490917
"4979",5038,43,16,27,3.47127003356718e-06,"terminal",0.328904051238461
"4980",5039,39,9,30,3.55360975679095e-06,"confession",0.386826437128358
"4981",5040,47,12,35,3.65955858404359e-06,"tour",0.4613567927871
"4982",5041,90,52,38,3.71795586786385e-06,"poo",0.502436722084001
"4983",5042,34,3,31,3.48033090986291e-06,"precisely",0.335277980525004
"4984",5043,59,26,33,3.59915491842515e-06,"nude",0.418865461845807
"4985",5044,48,10,38,3.61129468525761e-06,"nylon",0.427405255660417
"4986",5045,72,25,47,3.75775977393317e-06,"suspicious",0.530437025182021
"4987",5046,36,5,31,3.50856264714035e-06,"starve",0.355137770149046
"4988",5047,125,86,39,3.7123658907822e-06,"shy",0.498504418246165
"4989",5048,50,6,44,3.73390686142725e-06,"expansion",0.513657546837026
"4990",5049,48,14,34,3.59339964353476e-06,"hack",0.414816878245421
"4991",5050,58,17,41,3.6487561390322e-06,"rogue",0.453757746251522
"4992",5051,83,46,37,3.68813159253522e-06,"bland",0.481456651750553
"4993",5052,28,4,24,3.43150880010432e-06,"woodpecker",0.300933766448513
"4994",5053,75,39,36,3.63303445569878e-06,"fries",0.442698231193368
"4995",5054,52,8,44,3.68076029784712e-06,"seating",0.476271269061424
"4996",5055,42,13,29,3.51329606897303e-06,"diminish",0.358467524916708
"4997",5056,50,14,36,3.59617798204069e-06,"crass",0.416771317594652
"4998",5057,52,21,31,3.43616633794009e-06,"pineapple",0.304210140150755
"4999",5058,44,10,34,3.59290903472906e-06,"assassin",0.414471756456667
"5000",5059,91,50,41,3.65779164487233e-06,"greasy",0.46011382853467
"5001",5060,49,17,32,3.41525388997418e-06,"unlikely",0.289499149713104
"5002",5061,40,6,34,3.2829617567785e-06,"slightly",0.196437433093849
"5003",5062,44,10,34,3.62213851057664e-06,"informal",0.435033411428499
"5004",5063,27,4,23,3.35525432827808e-06,"tepid",0.247292088167106
"5005",5064,42,6,36,3.55386233758849e-06,"giddy",0.387004116647439
"5006",5065,36,4,32,3.46380325597506e-06,"Wi-Fi",0.323651500511888
"5007",5066,46,5,41,3.51237056914453e-06,"symmetry",0.35781647635705
"5008",5067,57,15,42,3.57482465485068e-06,"receipt",0.401750187948982
"5009",5068,49,7,42,3.69852576762902e-06,"modest",0.4887684982958
"5010",5069,68,19,49,3.73007672767829e-06,"touching",0.510963215640232
"5011",5070,28,6,22,3.50905511672872e-06,"barrister",0.355484200916845
"5012",5071,37,5,32,3.64144842252454e-06,"arcade",0.448617088025353
"5013",5072,58,15,43,3.63820258239619e-06,"league",0.44633378177789
"5014",5073,56,18,38,3.63054156788568e-06,"mischief",0.44094459389369
"5015",5074,41,5,36,3.686500036865e-06,"fellowship",0.480308923856513
"5016",5075,23,2,21,3.45350375223183e-06,"dromedary",0.316406251111804
"5017",5076,60,23,37,3.66329887390193e-06,"bags",0.463987922745185
"5018",5077,36,8,28,3.3725675356649e-06,"compact",0.259471170631664
"5019",5078,28,5,23,3.39287834834682e-06,"crave",0.273758937019976
"5020",5079,37,8,29,3.45572354211663e-06,"malt",0.317967775990297
"5021",5081,49,6,43,3.72483871448366e-06,"invalid",0.507278502968428
"5022",5082,46,12,34,3.59639784791553e-06,"braces",0.416925983599685
"5023",5083,57,19,38,3.57298537219789e-06,"rocky",0.400456333228506
"5024",5084,91,42,49,3.66348676015885e-06,"skilled",0.464120092490853
"5025",5085,56,15,41,3.70731490303518e-06,"stronger",0.49495126977841
"5026",5086,50,7,43,3.64452737768966e-06,"blur",0.450782998016659
"5027",5087,37,11,26,3.58523171352565e-06,"woof",0.40907109752882
"5028",5088,46,9,37,3.58440925351093e-06,"lobby",0.408492532961365
"5029",5089,70,33,37,3.47945901371255e-06,"grill",0.334664639803176
"5030",5090,45,7,38,3.62209915134217e-06,"brutality",0.435005723932375
"5031",5091,50,12,38,3.60226654611081e-06,"fudge",0.421054355523099
"5032",5092,44,14,30,3.49852187450802e-06,"outer",0.348074526743894
"5033",5093,61,16,45,3.60936558181168e-06,"mutual",0.426048215949306
"5034",5094,113,77,36,3.61194687548535e-06,"chips",0.427864042896589
"5035",5095,31,5,26,3.5400986979517e-06,"margarine",0.37732199949816
"5036",5096,58,7,51,3.66907847425041e-06,"sublime",0.468053618239015
"5037",5097,36,7,29,3.62497462517762e-06,"billboard",0.437028493727956
"5038",5098,41,8,33,3.48122748080973e-06,"fuse",0.335908678884512
"5039",5099,69,27,42,3.85162018403041e-06,"stalk",0.596463709273024
"5040",5100,46,10,36,3.58041797799475e-06,"walnut",0.405684845595053
"5041",5101,75,39,36,3.6799205137169e-06,"bin",0.475680517738121
"5042",5102,75,36,39,3.71072659737503e-06,"clumsy",0.497351247193373
"5043",5103,55,15,40,3.57693449559858e-06,"rumor",0.403234368429333
"5044",5104,55,24,31,3.54285795265325e-06,"berry",0.379263014227553
"5045",5105,70,38,32,3.61182946386003e-06,"punk",0.427781448964966
"5046",5106,52,15,37,3.6191889397586e-06,"tray",0.432958517653741
"5047",5107,44,11,33,3.58701929457679e-06,"thrill",0.410328582438895
"5048",5108,33,2,31,3.58035388217771e-06,"sentient",0.405639756997436
"5049",5109,45,14,31,3.53298215490714e-06,"comedian",0.372315823423107
"5050",5110,46,10,36,3.67387726310839e-06,"laces",0.471429355843586
"5051",5111,35,5,30,3.49687030108053e-06,"yen",0.346912717235106
"5052",5112,53,11,42,3.64338543374504e-06,"drift",0.44997969050923
"5053",5113,51,22,29,3.60566955480798e-06,"subway",0.423448222969171
"5054",5114,65,36,29,3.62760462011724e-06,"peak",0.438878579880992
"5055",5115,52,16,36,3.56155796791749e-06,"karate",0.392417655242543
"5056",5116,78,32,46,3.68537238845299e-06,"gymnastics",0.479515672629629
"5057",5117,91,44,47,3.75526206096292e-06,"allergy",0.528679993595799
"5058",5118,39,5,34,3.45191823096095e-06,"jargon",0.315290906399762
"5059",5119,45,13,32,3.5426822355742e-06,"sled",0.379139404965078
"5060",5120,68,30,38,3.60663187469118e-06,"pilot",0.424125172823288
"5061",5121,31,6,25,3.25613047966058e-06,"paprika",0.177562805802243
"5062",5122,49,14,35,3.59210885526675e-06,"retarded",0.413908865281151
"5063",5123,45,7,38,3.5763204669244e-06,"ensure",0.402802426173263
"5064",5124,52,20,32,3.45375423084893e-06,"emperor",0.316582451839098
"5065",5125,59,17,42,3.65539829219792e-06,"adrenaline",0.458430209841893
"5066",5126,43,12,31,3.58667192711883e-06,"gloom",0.410084224659227
"5067",5127,31,7,24,3.40139525233251e-06,"latch",0.27975020563167
"5068",5128,45,10,35,3.59141221511123e-06,"pouch",0.413418809469269
"5069",5129,55,17,38,3.46284368723596e-06,"parallel",0.322976485967047
"5070",5130,36,7,29,3.60969129920009e-06,"composer",0.426277343854086
"5071",5131,69,26,43,3.80291759838148e-06,"impressive",0.562203575168286
"5072",5132,35,9,26,3.53260773570442e-06,"breadth",0.372052435926827
"5073",5133,63,26,37,3.62548717483912e-06,"noodles",0.437389049946978
"5074",5134,60,23,37,3.59695409926874e-06,"sarcasm",0.417317282043146
"5075",5135,108,68,40,3.67537608285768e-06,"steak",0.472483709835784
"5076",5136,43,12,31,3.64876945250214e-06,"bowling",0.453767111694023
"5077",5137,44,10,34,3.67065422070176e-06,"vigor",0.469162086793999
"5078",5139,43,8,35,3.49467062729338e-06,"transform",0.345365343149511
"5079",5140,37,6,31,3.6147670463377e-06,"overdose",0.429847909467781
"5080",5141,50,16,34,3.60011376359493e-06,"aircraft",0.419539967391345
"5081",5142,34,7,27,3.37874364796194e-06,"apparition",0.263815794900029
"5082",5143,73,36,37,3.69740442209569e-06,"scarf",0.487979680867774
"5083",5144,51,16,35,3.60065820031902e-06,"landing",0.419922954761117
"5084",5145,49,18,31,3.63200523008753e-06,"banker",0.441974216092413
"5085",5146,41,4,37,3.57154337103693e-06,"tame",0.399441948622527
"5086",5147,55,22,33,3.67385026855845e-06,"burst",0.471410366361022
"5087",5148,46,8,38,3.5583009824469e-06,"fencing",0.390126508735379
"5088",5149,47,9,38,3.52843210590942e-06,"preach",0.369115063406614
"5089",5150,69,31,38,3.63613885687067e-06,"cracker",0.444882041334999
"5090",5151,40,10,30,3.36111858026351e-06,"smashed",0.251417332376787
"5091",5152,48,8,40,3.61858650773835e-06,"betting",0.432534733135365
"5092",5153,54,9,45,3.74905336402558e-06,"survivor",0.524312447461344
"5093",5154,100,76,24,3.598455542881e-06,"wings",0.418373481807927
"5094",5155,52,16,36,3.63464544033729e-06,"macho",0.443831488268344
"5095",5156,62,22,40,3.54549580213297e-06,"ski",0.381118625705246
"5096",5158,29,8,21,3.23133098523282e-06,"igloo",0.160117448569069
"5097",5159,45,14,31,3.47554088104961e-06,"sweetheart",0.331908405227872
"5098",5160,55,20,35,3.66332571361585e-06,"enthusiasm",0.464006803307399
"5099",5161,64,19,45,3.72599064776347e-06,"strip",0.508088837535272
"5100",5162,80,30,50,3.69673467426222e-06,"onion",0.487508542625623
"5101",5163,40,2,38,3.55984635703123e-06,"pressing",0.391213612013279
"5102",5164,40,4,36,3.63653554531669e-06,"crest",0.445161094267763
"5103",5165,47,11,36,3.50687698576909e-06,"antelope",0.353951981266078
"5104",5166,55,10,45,3.61685890271735e-06,"smear",0.431319438733418
"5105",5167,53,12,41,3.65354192622037e-06,"prevention",0.457124337751311
"5106",5168,55,10,45,3.66202444035112e-06,"deserve",0.463091414607545
"5107",5169,47,20,27,3.48043992760685e-06,"voyage",0.335354669729025
"5108",5170,47,4,43,3.65308813805751e-06,"scooter",0.456805117670738
"5109",5171,39,9,30,3.44492596854094e-06,"snare",0.310372156296188
"5110",5172,39,8,31,3.482439797322e-06,"linger",0.336761490408467
"5111",5173,35,5,30,3.51978824953891e-06,"replicate",0.36303448935721
"5112",5174,40,11,29,3.47379025254455e-06,"textile",0.330676914814133
"5113",5175,34,4,30,3.47809150163122e-06,"intrinsic",0.33370265499946
"5114",5176,45,11,34,3.57094394332198e-06,"stitch",0.399020277501238
"5115",5177,34,4,30,3.56825537290053e-06,"cauliflower",0.397128986064417
"5116",5178,123,80,43,3.74941884007979e-06,"bomb",0.524569543844673
"5117",5179,52,14,38,3.62702569385002e-06,"deliberate",0.438471330629485
"5118",5180,42,10,32,3.38608859362196e-06,"stupendous",0.268982642202927
"5119",5181,39,4,35,3.58304788385192e-06,"collide",0.40753486908249
"5120",5182,50,14,36,3.37785344169487e-06,"restraint",0.263189573813729
"5121",5183,33,8,25,3.43300490919702e-06,"shin",0.301986213612628
"5122",5184,43,19,24,3.61640110227906e-06,"fragrance",0.430997396192965
"5123",5185,33,3,30,3.62538202463085e-06,"blazer",0.437315081384763
"5124",5186,44,16,28,3.42578381933786e-06,"rooster",0.296906493436366
"5125",5187,58,18,40,3.67959553885837e-06,"glance",0.475451912170558
"5126",5188,57,31,26,3.34553337838652e-06,"rodent",0.240453826040507
"5127",5189,71,36,35,3.58802317862973e-06,"magician",0.411034770864445
"5128",5190,51,17,34,3.62852602016009e-06,"muck",0.439526744421158
"5129",5191,80,50,30,3.80170316301703e-06,"burning",0.561349273124707
"5130",5192,35,6,29,3.61500225937641e-06,"reunion",0.430013371529849
"5131",5193,45,22,23,3.59504028242636e-06,"mortgage",0.41597099578754
"5132",5194,38,5,33,3.68799557440531e-06,"jive",0.481360968958575
"5133",5195,38,5,33,3.60806329986253e-06,"moonshine",0.425132117684181
"5134",5196,40,8,32,3.59292194377077e-06,"tweak",0.414480837401638
"5135",5197,57,22,35,3.67541660847257e-06,"backwards",0.472512217829403
"5136",5198,28,2,26,3.35206017618428e-06,"predicate",0.245045142186181
"5137",5199,36,11,25,3.72001666567466e-06,"riches",0.503886403007929
"5138",5200,43,17,26,3.49490268443475e-06,"facade",0.345528585176141
"5139",5201,44,7,37,3.65231428894919e-06,"brothel",0.456260748745055
"5140",5202,64,22,42,3.59325761141794e-06,"aloof",0.414716964877279
"5141",5203,40,10,30,3.56145649324748e-06,"gag",0.392346272260379
"5142",5204,52,12,40,3.58080260109501e-06,"morality",0.405955411085962
"5143",5205,42,7,35,3.5631442610217e-06,"propeller",0.393533542905498
"5144",5206,76,39,37,3.67618676499241e-06,"joyful",0.473053989180958
"5145",5207,66,19,47,3.77890389113734e-06,"events",0.545310984773463
"5146",5208,43,3,40,3.67801210801586e-06,"luscious",0.474338037983241
"5147",5209,38,9,29,3.64418206333588e-06,"funk",0.450540084505783
"5148",5210,32,5,27,3.49459735249305e-06,"orate",0.34531379753951
"5149",5211,66,24,42,3.73713025767513e-06,"wheelchair",0.515925064798418
"5150",5212,54,8,46,3.61666268833771e-06,"alliance",0.431181410518487
"5151",5213,35,9,26,3.33484512979217e-06,"crater",0.232935111678469
"5152",5214,63,18,45,3.67578137922669e-06,"demanding",0.472768818065039
"5153",5215,75,44,31,3.63251976998885e-06,"boom",0.442336172357907
"5154",5216,104,57,47,3.7556851684237e-06,"balls",0.528977631147354
"5155",5217,51,9,42,3.62565805693733e-06,"demeanor",0.43750925801238
"5156",5218,79,35,44,3.62781518458324e-06,"outline",0.439026702752632
"5157",5219,32,3,29,3.49335215085692e-06,"activate",0.344437852772457
"5158",5220,57,14,43,3.64277492022323e-06,"rack",0.449550221008768
"5159",5221,94,57,37,3.7314825180044e-06,"unclear",0.511952127511216
"5160",5222,43,8,35,3.67387726310839e-06,"recess",0.471429355843586
"5161",5223,59,15,44,3.64785105094589e-06,"viking",0.453121056457733
"5162",5224,45,18,27,3.48393210513114e-06,"gut",0.33781126353622
"5163",5225,184,141,43,3.73936617743293e-06,"religious",0.517497936335499
"5164",5227,32,4,28,3.64495246981979e-06,"panorama",0.451082031696106
"5165",5228,43,10,33,3.66013454654593e-06,"mellow",0.461761957159925
"5166",5229,46,6,40,3.62280774846121e-06,"rivalry",0.435504190943956
"5167",5230,55,19,36,3.67147630062048e-06,"biblical",0.469740383980586
"5168",5231,51,9,42,3.5903677613698e-06,"republic",0.412684082046263
"5169",5232,62,24,38,3.54685394055473e-06,"microphone",0.382074016550357
"5170",5233,36,5,31,3.44607750228303e-06,"perk",0.31118220980576
"5171",5234,36,8,28,3.59745875513537e-06,"spotless",0.417672285323511
"5172",5235,46,11,35,3.57786873515184e-06,"sparse",0.403891565002251
"5173",5236,54,18,36,3.51960242570999e-06,"plow",0.362903770439237
"5174",5237,43,17,26,3.49265668931072e-06,"freezer",0.343948626060572
"5175",5238,41,13,28,3.45365880613922e-06,"celery",0.316515324738802
"5176",5239,61,21,40,3.73119013771823e-06,"tiring",0.51174645079651
"5177",5240,72,47,25,3.54349821230515e-06,"untrue",0.379713408826605
"5178",5241,36,4,32,3.63399823387686e-06,"asparagus",0.443376206894007
"5179",5242,45,11,34,3.60398023577239e-06,"groan",0.422259861079675
"5180",5243,43,12,31,3.57678096866382e-06,"gospel",0.40312636896065
"5181",5244,55,23,32,3.54364889526746e-06,"lip",0.379819407685333
"5182",5245,42,15,27,3.60836274148968e-06,"moo",0.425342761742721
"5183",5246,43,9,34,3.56885389825911e-06,"taught",0.397550022417559
"5184",5247,44,14,30,3.42352026895175e-06,"gorilla",0.295314184963464
"5185",5248,54,13,41,3.71018966489567e-06,"gracious",0.496973538730813
"5186",5249,35,3,32,3.53603038157304e-06,"margin",0.374460117262212
"5187",5250,37,10,27,3.47348859827368e-06,"reef",0.33046471425772
"5188",5251,73,38,35,3.61629647845049e-06,"tan",0.430923797915799
"5189",5252,46,7,39,3.51893362235508e-06,"producer",0.362433296596347
"5190",5253,44,4,40,3.5029337069796e-06,"generic",0.351178057493028
"5191",5254,38,11,27,3.50809492904878e-06,"thermometer",0.354808750974258
"5192",5255,110,75,35,3.76855069077534e-06,"harsh",0.538027962155896
"5193",5256,44,6,38,3.5443899396036e-06,"variant",0.380340699891802
"5194",5257,37,3,34,3.50189102115142e-06,"detect",0.350444573719501
"5195",5258,65,21,44,3.76095377787807e-06,"immigrant",0.532683866946687
"5196",5259,53,26,27,3.57831683132888e-06,"gem",0.404206781020302
"5197",5260,44,14,30,3.53074929561552e-06,"beggar",0.370745104789823
"5198",5261,56,11,45,3.53890852983123e-06,"mathematical",0.376484768396953
"5199",5262,84,47,37,3.69149442768916e-06,"silk",0.483822258869989
"5200",5263,47,14,33,3.40234421516425e-06,"kidney",0.280417759385597
"5201",5264,58,19,39,3.52075484983981e-06,"spectacular",0.363714450297542
"5202",5265,37,10,27,3.41956332176381e-06,"koala",0.292530646071269
"5203",5266,85,39,46,3.81434805163101e-06,"unstable",0.570244397970384
"5204",5267,39,3,36,3.5226151895167e-06,"hyphen",0.365023117711427
"5205",5268,42,8,34,3.55868086817578e-06,"annihilate",0.39039374169319
"5206",5269,29,11,18,3.50138830046113e-06,"racket",0.350090931750865
"5207",5270,45,7,38,3.65731004845936e-06,"trigger",0.459775046569139
"5208",5271,411,367,44,4.10184049583048e-06,"brown",0.772482730106828
"5209",5272,62,22,40,3.72883883958535e-06,"artistic",0.510092415630222
"5210",5273,60,23,37,3.68242745617911e-06,"reproduction",0.477444041867359
"5211",5274,70,29,41,3.65922380544639e-06,"hurricane",0.461121290719134
"5212",5275,55,20,35,3.6805977290712e-06,"reserved",0.476156909053837
"5213",5276,39,4,35,3.54876715828921e-06,"comparative",0.383419881359823
"5214",5277,42,12,30,3.46699764937559e-06,"adapt",0.325898616241522
"5215",5278,68,27,41,3.74136679611796e-06,"reasonable",0.518905283882418
"5216",5280,38,3,35,3.57739515549148e-06,"sponsor",0.403558422470758
"5217",5281,75,38,37,3.67171895194454e-06,"gear",0.469911078550337
"5218",5282,48,4,44,3.58999396881013e-06,"distinguish",0.4124211353659
"5219",5283,57,17,40,3.54867900424067e-06,"coconut",0.383357868850948
"5220",5284,45,11,34,3.57953365835499e-06,"buckle",0.405062765493022
"5221",5285,36,11,25,3.54826347985296e-06,"meander",0.383065565658887
"5222",5287,41,7,34,3.41045509112736e-06,"refrain",0.286123405081826
"5223",5288,46,12,34,3.46610839214164e-06,"obliterate",0.325273062758417
"5224",5289,59,23,36,3.61167292689974e-06,"filthy",0.427671332075265
"5225",5290,39,11,28,3.61068184115888e-06,"neon",0.426974146701253
"5226",5291,55,13,42,3.6950272323507e-06,"fireman",0.486307432087336
"5227",5292,48,8,40,3.61931992978519e-06,"trace",0.433050663395443
"5228",5293,43,16,27,3.42141187982633e-06,"sloth",0.293831025635894
"5229",5294,57,30,27,3.56586327767021e-06,"skeleton",0.395446251928434
"5230",5295,60,25,35,3.65031447459199e-06,"pinch",0.454853967007503
"5231",5296,41,6,35,3.58557880205812e-06,"realm",0.409315259096639
"5232",5297,43,15,28,3.62506661059897e-06,"banks",0.437093201439651
"5233",5298,52,17,35,3.76938879360712e-06,"gaudy",0.538617530759443
"5234",5299,46,7,39,3.52506142419532e-06,"legitimate",0.366743936576061
"5235",5300,36,8,28,3.54608671600455e-06,"nook",0.381534307710935
"5236",5301,37,7,30,3.62923713435436e-06,"cluster",0.440026982084822
"5237",5302,38,6,32,3.68367542399104e-06,"intimacy",0.478321932517832
"5238",5303,62,24,38,3.60349971892702e-06,"gravy",0.421921838542628
"5239",5304,62,17,45,3.58275262884474e-06,"mushroom",0.407327170127573
"5240",5305,49,7,42,3.76290677022186e-06,"generation",0.534057711450265
"5241",5306,37,6,31,3.77448223539936e-06,"effortless",0.542200543787022
"5242",5307,65,38,27,3.47564959891004e-06,"yarn",0.331984883476984
"5243",5308,38,5,33,3.48534065719583e-06,"influenza",0.338802118169236
"5244",5309,53,16,37,3.51256796819018e-06,"uncover",0.357955337932596
"5245",5310,42,10,32,3.64852982490705e-06,"maniac",0.453598544185058
"5246",5311,87,50,37,3.71100200765209e-06,"stinky",0.49754498625055
"5247",5312,48,16,32,3.57330455632064e-06,"swan",0.400680865267287
"5248",5313,56,17,39,3.59098662357483e-06,"tomb",0.413119424479404
"5249",5314,40,2,38,3.59345129436116e-06,"teaspoon",0.414853212337657
"5250",5315,49,13,36,3.65970590603339e-06,"lever",0.461460427348999
"5251",5316,53,6,47,3.70220910817485e-06,"shopper",0.491359566908933
"5252",5317,145,108,37,3.87971336677646e-06,"movies",0.616226031857836
"5253",5318,40,5,35,3.50845186053202e-06,"crew",0.35505983662647
"5254",5319,43,7,36,3.63572903638638e-06,"maturity",0.444593750588962
"5255",5320,41,13,28,3.55804777034936e-06,"ruby",0.389948385124426
"5256",5321,86,45,41,3.712999955444e-06,"reject",0.498950454941241
"5257",5322,39,4,35,3.55184269599068e-06,"lukewarm",0.385583387315258
"5258",5323,28,6,22,3.49036484783754e-06,"frat",0.34233641604807
"5259",5324,45,16,29,3.68280718294713e-06,"tranquil",0.477711163003169
"5260",5325,53,9,44,3.5857845158653e-06,"layout",0.409459969742436
"5261",5326,48,11,37,3.57981556790194e-06,"weasel",0.405261076501673
"5262",5327,51,20,31,3.69879936972459e-06,"idol",0.488960965376561
"5263",5328,41,6,35,3.50707376778963e-06,"chisel",0.3540904087915
"5264",5329,38,9,29,3.629000065322e-06,"robust",0.439860214412584
"5265",5330,48,7,41,3.7337535050611e-06,"advisor",0.513549667355886
"5266",5331,53,9,44,3.70447203864505e-06,"leadership",0.492951439298168
"5267",5332,61,22,39,3.56328392246294e-06,"monthly",0.393631788607294
"5268",5333,52,11,41,3.61846866406137e-06,"mesh",0.432451835274341
"5269",5334,40,10,30,3.44581626218527e-06,"pluck",0.310998438848561
"5270",5335,41,3,38,3.48656799679236e-06,"doubtless",0.339665497774419
"5271",5336,81,45,36,3.70219540187331e-06,"Russia",0.491349925126624
"5272",5337,48,19,29,3.4809730015734e-06,"asphalt",0.335729663896961
"5273",5338,59,20,39,3.60464277990051e-06,"sewer",0.422725931830898
"5274",5339,94,53,41,3.81979724516223e-06,"worried",0.574077666751794
"5275",5340,48,10,38,3.66883617178959e-06,"lengthy",0.467883169079262
"5276",5341,84,43,41,3.74079297329448e-06,"creamy",0.518501624679877
"5277",5342,39,11,28,3.4914860113613e-06,"leprechaun",0.343125105440332
"5278",5343,47,8,39,3.52925398629238e-06,"anyway",0.369693220228538
"5279",5344,53,20,33,3.57880346285023e-06,"diving",0.404549104963865
"5280",5345,61,19,42,3.7466093185667e-06,"misery",0.522593168616827
"5281",5346,39,5,34,3.55768067681317e-06,"relativity",0.389690150913421
"5282",5347,43,14,29,3.56131697501736e-06,"vow",0.392248127301335
"5283",5348,43,10,33,3.56261110893396e-06,"flutter",0.393158493782732
"5284",5349,34,11,23,3.528133335215e-06,"marsupial",0.368904891319839
"5285",5350,48,26,22,3.55030426107517e-06,"regal",0.384501165790171
"5286",5351,47,9,38,3.71491725021825e-06,"brace",0.500299187769465
"5287",5352,33,10,23,3.53037534950716e-06,"proton",0.370482050094687
"5288",5353,42,8,34,3.59125744288105e-06,"amusement",0.413309933989849
"5289",5354,60,27,33,3.60264289883058e-06,"fearful",0.421319103163869
"5290",5355,44,10,34,3.66223901969186e-06,"tarp",0.463242361767578
"5291",5356,43,4,39,3.65975948060693e-06,"depending",0.461498114713022
"5292",5357,34,5,29,3.46763483031129e-06,"misplaced",0.326346845098677
"5293",5358,51,6,45,3.6800288514262e-06,"interact",0.475756728567577
"5294",5359,48,21,27,3.51509910821936e-06,"steer",0.35973588398948
"5295",5360,43,15,28,3.54802428267819e-06,"giraffe",0.38289730093175
"5296",5361,38,5,33,3.58609313083861e-06,"flux",0.409677066847883
"5297",5362,40,6,34,3.60072302518346e-06,"tiara",0.419968556211623
"5298",5363,39,5,34,3.551300308608e-06,"unemployment",0.38520184156733
"5299",5364,38,10,28,3.68811799027074e-06,"Barbie",0.481447083153754
"5300",5365,55,18,37,3.6715437005489e-06,"joyous",0.469787796875721
"5301",5366,40,16,24,3.54796134141322e-06,"snooze",0.382853024510905
"5302",5367,80,41,39,3.61458412402361e-06,"nonsense",0.4297192316383
"5303",5368,47,14,33,3.57262795367016e-06,"gullible",0.40020490496185
"5304",5369,43,16,27,3.6133433543389e-06,"unicorn",0.428846404554794
"5305",5370,55,24,31,3.58424223742737e-06,"bolt",0.408375044467808
"5306",5371,46,4,42,3.78869680196103e-06,"plasma",0.552199868261373
"5307",5372,57,26,31,3.69878568865841e-06,"geek",0.488951341346223
"5308",5373,98,61,37,3.85860526853963e-06,"ideas",0.601377410031007
"5309",5374,44,15,29,3.42692258924563e-06,"raspberry",0.297707568148
"5310",5375,67,27,40,3.77201916185734e-06,"addict",0.540467879520126
"5311",5376,51,8,43,3.74423855292668e-06,"perfectionist",0.520925438912633
"5312",5377,40,6,34,3.65218089982433e-06,"volleyball",0.456166915342885
"5313",5378,67,25,42,3.68390611933645e-06,"soothing",0.478484216580698
"5314",5379,53,14,39,3.66368808825092e-06,"redneck",0.464261717978319
"5315",5380,88,44,44,3.79760295301606e-06,"clay",0.558464955123531
"5316",5381,52,12,40,3.47509400129274e-06,"ghetto",0.331594044908079
"5317",5382,37,6,31,3.38964666323182e-06,"pronounce",0.271485588203916
"5318",5383,60,29,31,3.62539516807332e-06,"bricks",0.437324327220395
"5319",5384,38,8,30,3.52639151409146e-06,"spectrum",0.367679596512922
"5320",5385,54,20,34,3.65743043567311e-06,"gel",0.459859733696789
"5321",5386,34,4,30,3.54966153977218e-06,"an",0.384049039527488
"5322",5387,35,6,29,3.2845684405526e-06,"oat",0.197567664699238
"5323",5388,50,19,31,3.59234112871358e-06,"courtroom",0.414072259469189
"5324",5389,43,13,30,3.53873320428753e-06,"stripper",0.376361434562432
"5325",5390,44,10,34,3.6312271005741e-06,"completion",0.441426836089362
"5326",5391,55,14,41,3.74119882975301e-06,"impatient",0.518787126907554
"5327",5392,48,13,35,3.4654597625467e-06,"slant",0.324816780271339
"5328",5393,47,17,30,3.51845075576322e-06,"pitcher",0.362093621115644
"5329",5394,48,19,29,3.55367289862437e-06,"sage",0.386870854640323
"5330",5395,44,11,33,3.73164961302794e-06,"superfluous",0.512069671535587
"5331",5397,38,8,30,3.43900241417969e-06,"jockey",0.306205195464668
"5332",5398,52,13,39,3.54986315277546e-06,"riddle",0.384190865437499
"5333",5399,49,15,34,3.52516083546312e-06,"Cuba",0.366813868045223
"5334",5400,50,13,37,3.52421665474307e-06,"toothbrush",0.366149678297244
"5335",5401,81,33,48,3.76413904729641e-06,"hippie",0.5349245643548
"5336",5402,59,34,25,3.5681407845628e-06,"hockey",0.397048378191852
"5337",5403,40,14,26,3.50343687157101e-06,"tsunami",0.351532011726648
"5338",5404,48,13,35,3.69803338584541e-06,"crane",0.488422129294799
"5339",5405,24,4,20,3.36225997666592e-06,"kiwi",0.252220254712264
"5340",5406,58,26,32,3.53099863703453e-06,"popcorn",0.370920505548106
"5341",5407,45,7,38,3.7250052150073e-06,"patrol",0.507395628788183
"5342",5408,36,3,33,3.62238780559369e-06,"wok",0.435208779545034
"5343",5409,42,12,30,3.68821320822914e-06,"desirable",0.481514064813565
"5344",5410,37,5,32,3.64781113093088e-06,"packaging",0.45309297447709
"5345",5411,36,3,33,3.488489728142e-06,"encore",0.341017351538949
"5346",5412,54,8,46,3.77352794674797e-06,"blessing",0.541529243552435
"5347",5413,43,14,29,3.43510401494957e-06,"iceberg",0.303462842494324
"5348",5414,42,6,36,3.53615542110307e-06,"honestly",0.374548077090425
"5349",5415,44,6,38,3.6853588065334e-06,"ethic",0.479506118344569
"5350",5416,43,15,28,3.50055483794181e-06,"spam",0.349504627403721
"5351",5417,48,10,38,3.69758215103144e-06,"baker",0.48810470538325
"5352",5418,64,23,41,3.72468610207875e-06,"surrender",0.507171146831402
"5353",5419,41,8,33,3.55857955738387e-06,"fling",0.390322473992085
"5354",5420,81,45,36,3.66747717912325e-06,"comedy",0.466927177310539
"5355",5421,37,6,31,3.50488581082028e-06,"recipient",0.352551276973621
"5356",5422,64,16,48,3.71248992987107e-06,"persistent",0.498591674307876
"5357",5423,58,20,38,3.66812291146252e-06,"ban",0.46738142170525
"5358",5424,45,5,40,3.62827587958478e-06,"confirmation",0.43935078149145
"5359",5425,59,14,45,3.73060551458107e-06,"recovery",0.511335194046733
"5360",5426,45,5,40,3.61239049941299e-06,"compress",0.428176112883227
"5361",5427,83,34,49,3.67513294793439e-06,"farming",0.472312675075178
"5362",5428,54,19,35,3.48750427219273e-06,"potion",0.340324126476539
"5363",5429,50,9,41,3.62313589658121e-06,"sleazy",0.435735028761855
"5364",5430,54,10,44,3.68139716385163e-06,"compound",0.476719276378289
"5365",5431,64,24,40,3.70086637281788e-06,"prey",0.4904150114447
"5366",5432,79,40,39,3.76490431495684e-06,"crush",0.535462896608066
"5367",5433,40,5,35,3.66897078031671e-06,"patron",0.467977860277467
"5368",5434,37,7,30,3.56083508704461e-06,"surfer",0.391909140236279
"5369",5435,44,15,29,3.72537989561486e-06,"womb",0.507659200171309
"5370",5436,48,9,39,3.63516072863162e-06,"seagull",0.44419397099551
"5371",5437,53,22,31,3.66585040397671e-06,"pity",0.465782812305354
"5372",5438,47,13,34,3.70188018494593e-06,"socialist",0.491128183835887
"5373",5439,54,8,46,3.69088130863888e-06,"surrounded",0.483390956494458
"5374",5440,65,30,35,3.69929195551971e-06,"tragedy",0.489307477890717
"5375",5441,39,13,26,3.36509987616432e-06,"chalkboard",0.25421799952115
"5376",5442,92,53,39,3.68443547079716e-06,"toast",0.478856592128953
"5377",5443,42,6,36,3.65780502436098e-06,"counsel",0.460123240418444
"5378",5444,52,16,36,3.577983949164e-06,"compost",0.403972613009348
"5379",5445,39,6,33,3.56726251841599e-06,"maternal",0.39643055645676
"5380",5446,41,6,35,3.61599571866107e-06,"tentacle",0.43071222658788
"5381",5447,47,19,28,3.665366683283e-06,"hollow",0.465442536001432
"5382",5448,40,8,32,3.46213634585357e-06,"buffet",0.32247890231116
"5383",5449,71,28,43,3.67977155978157e-06,"traveler",0.475575735174075
"5384",5450,36,5,31,3.38816513916888e-06,"matrimony",0.270443400968897
"5385",5451,78,41,37,3.62017159613366e-06,"aliens",0.433649773338418
"5386",5452,52,16,36,3.66278899405163e-06,"sacred",0.46362924462131
"5387",5453,48,12,36,3.6378716995409e-06,"diplomacy",0.446101020193587
"5388",5454,51,7,44,3.54539524066143e-06,"hairstyle",0.381047885118173
"5389",5455,61,20,41,3.64964835638086e-06,"slowly",0.454385382045562
"5390",5456,46,9,37,3.58043079743355e-06,"journalism",0.4056938635083
"5391",5457,47,7,40,3.62688099115404e-06,"efficiency",0.438369538625971
"5392",5458,72,35,37,3.73240172586256e-06,"outgoing",0.512598749945547
"5393",5459,33,3,30,3.68238677581261e-06,"lonesome",0.477415425012766
"5394",5460,64,30,34,3.67003453502497e-06,"endangered",0.468726165084578
"5395",5461,69,29,40,3.50131474368625e-06,"psycho",0.350039187784132
"5396",5462,54,10,44,3.69063611804131e-06,"kit",0.483218475657104
"5397",5463,53,16,37,3.62535573803179e-06,"cruelty",0.437296589914615
"5398",5464,49,12,37,3.60930044538767e-06,"plush",0.426002395330299
"5399",5465,24,2,22,3.50633594905995e-06,"cob",0.353571385657779
"5400",5466,61,21,40,3.53234568947856e-06,"undecided",0.371868097893843
"5401",5467,41,8,33,3.53187160940326e-06,"overlook",0.371534603342379
"5402",5468,49,10,39,3.62803893611386e-06,"incapable",0.43918410214618
"5403",5469,162,129,33,3.82235235208452e-06,"colorful",0.575875072467389
"5404",5470,68,27,41,3.64519162772387e-06,"vulgar",0.451250268798031
"5405",5471,47,20,27,3.62087943919819e-06,"splash",0.434147709905706
"5406",5472,51,13,38,3.75915824928482e-06,"warehouse",0.531420791289123
"5407",5473,38,4,34,3.53600537472817e-06,"heartache",0.374442526043033
"5408",5474,64,22,42,3.62005364919508e-06,"following",0.433566802837386
"5409",5475,37,6,31,3.59889585875054e-06,"gallon",0.418683224720708
"5410",5476,47,11,36,3.59912901077939e-06,"genre",0.418847236952687
"5411",5477,42,4,38,3.64525806604479e-06,"motivate",0.451297005244443
"5412",5478,41,10,31,3.62628914579133e-06,"intellect",0.437953201357107
"5413",5479,160,113,47,3.7468760420999e-06,"sneaky",0.522780796930491
"5414",5480,52,14,38,3.49651572208294e-06,"shed",0.346663286453428
"5415",5481,55,17,38,3.63924856795569e-06,"vermin",0.447069586767757
"5416",5482,70,31,39,3.72007202059432e-06,"climbing",0.5039253427674
"5417",5483,63,28,35,3.6583938187778e-06,"mustard",0.460537431480616
"5418",5484,29,4,25,3.61018650223471e-06,"cortex",0.426625697481493
"5419",5485,48,20,28,3.64200543387211e-06,"climate",0.449008921091527
"5420",5486,48,13,35,3.62947423436241e-06,"vanity",0.440193771547103
"5421",5487,60,16,44,3.68843086774025e-06,"gaming",0.481667178738427
"5422",5488,71,35,36,3.66898424171268e-06,"festival",0.46798732977945
"5423",5489,46,11,35,3.54745789167483e-06,"sinus",0.382498869688882
"5424",5490,79,41,38,3.69829323767082e-06,"fighter",0.488604923663254
"5425",5491,52,8,44,3.715000055725e-06,"editor",0.500357437813648
"5426",5492,32,7,25,3.65419611339701e-06,"fortunate",0.457584529753494
"5427",5493,61,21,40,3.65775150699362e-06,"stylish",0.460085593296463
"5428",5494,44,10,34,3.56157065265782e-06,"clique",0.392426578401328
"5429",5495,53,14,39,3.52409245808973e-06,"anonymous",0.366062311395837
"5430",5496,240,204,36,3.85129384216628e-06,"trees",0.596234142076944
"5431",5497,60,14,46,3.77624965541722e-06,"industrial",0.543443846293952
"5432",5498,37,4,33,3.58996819288181e-06,"publication",0.412403003130225
"5433",5499,38,12,26,3.55706058741299e-06,"dining",0.389253945202282
"5434",5500,38,11,27,3.57655070297104e-06,"fin",0.402964387139576
"5435",5501,42,5,37,3.70351166976527e-06,"optional",0.492275861889435
"5436",5502,81,35,46,3.74118483323669e-06,"pit",0.518777280971866
"5437",5503,58,19,39,3.73890480000598e-06,"sensual",0.517173377540327
"5438",5504,162,132,30,3.77315775572577e-06,"parents",0.541268830395799
"5439",5505,38,11,27,3.55472138093816e-06,"starvation",0.387608415987389
"5440",5506,57,13,44,3.78538387577884e-06,"outfit",0.549869369915782
"5441",5507,57,9,48,3.71468265466081e-06,"scold",0.500134160078407
"5442",5508,62,11,51,3.73053592879153e-06,"trickery",0.511286243494115
"5443",5509,92,59,33,3.78700376049473e-06,"boys",0.551008887805052
"5444",5510,43,10,33,3.51406151716092e-06,"vibrate",0.359005984163131
"5445",5511,39,10,29,3.61372202527437e-06,"verbose",0.42911278295869
"5446",5512,39,9,30,3.71479304887925e-06,"hostel",0.500211817571896
"5447",5513,36,4,32,3.6399638915582e-06,"typist",0.447572785565596
"5448",5514,72,36,36,3.63890425315129e-06,"tribe",0.446827376396055
"5449",5515,54,16,38,3.77673455976494e-06,"forgotten",0.543784955246575
"5450",5516,55,15,40,3.59563489923233e-06,"indifferent",0.416389282645249
"5451",5517,78,44,34,3.71949087608888e-06,"stones",0.503516533082549
"5452",5518,68,30,38,3.48773537854136e-06,"herb",0.340486699662149
"5453",5519,42,9,33,3.6531281736551e-06,"kisses",0.456833280958667
"5454",5520,30,6,24,3.22106836395496e-06,"verdict",0.152898144366616
"5455",5521,66,21,45,3.68116678262342e-06,"crafty",0.47655721328311
"5456",5522,69,30,39,3.63215034196695e-06,"pretentious",0.442076295938545
"5457",5523,76,32,44,3.82039556375667e-06,"boredom",0.574498557655426
"5458",5524,81,40,41,3.76677627985641e-06,"classy",0.536779741856512
"5459",5525,39,9,30,3.46910243912593e-06,"imperative",0.327379243566494
"5460",5526,87,56,31,3.60106015210878e-06,"pointy",0.420205710225481
"5461",5528,54,18,36,3.70830474848423e-06,"troll",0.495647582661507
"5462",5529,47,13,34,3.57054868621661e-06,"surfing",0.398742231453882
"5463",5530,36,7,29,3.42511499823607e-06,"frisbee",0.296436007109318
"5464",5531,41,5,36,3.70651791174781e-06,"inviting",0.494390621344209
"5465",5532,53,17,36,3.4769305656966e-06,"saying",0.332885987459591
"5466",5533,33,3,30,3.46906633548647e-06,"terse",0.327353846238754
"5467",5534,54,13,41,3.61521136333236e-06,"circuit",0.430160466996692
"5468",5536,34,2,32,3.44833531612614e-06,"unveil",0.312770482872126
"5469",5537,46,15,31,3.47613287170289e-06,"neuron",0.33232484470228
"5470",5538,71,26,45,3.69221680697091e-06,"missile",0.484330421028883
"5471",5539,51,13,38,3.43374755774705e-06,"hooray",0.302508634313248
"5472",5540,38,8,30,3.56723706787382e-06,"capitol",0.396412653115977
"5473",5541,44,7,37,3.51654534585223e-06,"waltz",0.360753248767747
"5474",5542,38,13,25,3.60487667716887e-06,"starving",0.422890468306201
"5475",5543,43,8,35,3.57785593405296e-06,"dork",0.403882559990327
"5476",5544,45,13,32,3.56563441550338e-06,"dagger",0.395285257426344
"5477",5545,90,50,40,3.72883883958535e-06,"dragon",0.510092415630222
"5478",5546,36,5,31,3.65693556113848e-06,"transition",0.459511611154715
"5479",5547,53,19,34,3.55565669423486e-06,"voting",0.388266367891745
"5480",5548,65,38,27,3.54387494374099e-06,"cunning",0.379978422877526
"5481",5549,75,25,50,3.70344309104174e-06,"explorer",0.492227619763611
"5482",5550,44,2,42,3.5755276584942e-06,"increment",0.402244720195726
"5483",5551,46,6,40,3.59604866173049e-06,"discharge",0.416680346425242
"5484",5552,61,22,39,3.64872951238379e-06,"passport",0.453739015571552
"5485",5553,30,3,27,3.5657488429145e-06,"enforcement",0.395365752094092
"5486",5554,33,5,28,3.5107921751464e-06,"glitch",0.356706145368963
"5487",5555,51,15,36,3.67347238650807e-06,"incompetent",0.471144542903203
"5488",5556,61,16,45,3.60946980498035e-06,"dominate",0.426121532379792
"5489",5557,47,20,27,3.35353277910615e-06,"contagious",0.246081053789516
"5490",5558,50,16,34,3.6704925433944e-06,"guardian",0.469048353895469
"5491",5559,47,3,44,3.66402368424909e-06,"oblivion",0.464497795052037
"5492",5560,43,9,34,3.52231740306582e-06,"descend",0.364813637996838
"5493",5561,37,11,26,3.35656073360991e-06,"amphibian",0.248211087051195
"5494",5562,36,14,22,3.41527721805179e-06,"robin",0.289515559993106
"5495",5563,37,12,25,3.58780433550276e-06,"twig",0.410880824317703
"5496",5564,54,16,38,3.66882271148011e-06,"germ",0.467873700341587
"5497",5566,36,5,31,3.57426245094325e-06,"grenade",0.401354702144559
"5498",5567,37,10,27,3.53840764579124e-06,"altitude",0.376132418431294
"5499",5568,43,5,38,3.6991551129722e-06,"lifetime",0.489211215157093
"5500",5569,40,14,26,3.42762736206371e-06,"bumpy",0.298203344931488
"5501",5570,41,6,35,3.62965866689896e-06,"fortress",0.440323511751888
"5502",5571,49,14,35,3.63324565100496e-06,"haze",0.442846797833425
"5503",5572,54,17,37,3.61958193828613e-06,"cupcake",0.433234974890593
"5504",5573,32,5,27,3.47334382283168e-06,"brimstone",0.330362871080569
"5505",5574,29,3,26,3.5931414116734e-06,"martial",0.414635223450663
"5506",5575,39,4,35,3.52901734512025e-06,"judo",0.369526753537217
"5507",5576,39,2,37,3.62419950493435e-06,"profile",0.436483230614548
"5508",5577,83,40,43,3.71171826573676e-06,"advertising",0.498048842415628
"5509",5578,46,13,33,3.5983907996344e-06,"clueless",0.418327937771998
"5510",5579,48,10,38,3.64719913342549e-06,"patriotic",0.452662461059222
"5511",5580,54,15,39,3.44885860024625e-06,"safari",0.313138590312233
"5512",5581,46,17,29,3.53355641852856e-06,"untidy",0.372719792707678
"5513",5582,56,28,28,3.5199864832519e-06,"ridiculous",0.363173938084641
"5514",5583,41,2,39,3.63407747126353e-06,"flan",0.443431946922126
"5515",5584,47,13,34,3.68756038380128e-06,"rust",0.481054831445414
"5516",5585,39,7,32,3.45834082640512e-06,"boulder",0.319808920757443
"5517",5586,48,7,41,3.51796802167068e-06,"somersault",0.361754038842404
"5518",5587,58,23,35,3.63324565100496e-06,"mash",0.442846797833425
"5519",5588,54,7,47,3.77136478148712e-06,"sentimental",0.54000755161473
"5520",5589,42,10,32,3.47650750056493e-06,"conviction",0.332588379684707
"5521",5590,40,6,34,3.544201509121e-06,"clinical",0.380208147307231
"5522",5591,41,10,31,3.59065138006686e-06,"dresser",0.412883595367095
"5523",5592,50,11,39,3.5677716055329e-06,"stupidity",0.396788676927446
"5524",5593,64,25,39,3.70823599213854e-06,"details",0.495599215586278
"5525",5594,101,62,39,3.84985563041386e-06,"grandma",0.595222423153765
"5526",5595,88,51,37,3.76081233546446e-06,"toys",0.532584368408903
"5527",5596,40,8,32,3.62169248933412e-06,"plantation",0.434719655035918
"5528",5597,31,7,24,3.55819969328319e-06,"douche",0.390055256248761
"5529",5598,51,16,35,3.61378732138856e-06,"kinky",0.429158715912738
"5530",5599,130,92,38,3.84769292332317e-06,"thoughts",0.593701053518685
"5531",5600,40,4,36,3.58875714162671e-06,"pharmacist",0.411551081659228
"5532",5601,48,8,40,3.71045122797383e-06,"blessed",0.497157536890569
"5533",5602,40,5,35,3.56186242662563e-06,"inaccurate",0.392631828597644
"5534",5603,39,3,36,3.63936776903116e-06,"coaster",0.447153439499123
"5535",5604,24,3,21,3.30737047510377e-06,"niece",0.213607896468763
"5536",5605,59,13,46,3.6787698193724e-06,"accuse",0.474871054707957
"5537",5606,41,5,36,3.6125209977783e-06,"bumblebee",0.428267912762772
"5538",5607,59,21,38,3.71215917738553e-06,"privilege",0.49835900443298
"5539",5608,47,18,29,3.6405999708752e-06,"hardware",0.448020239482292
"5540",5609,29,3,26,3.55703528223296e-06,"spree",0.389236144117401
"5541",5610,46,11,35,3.52731197663509e-06,"wondering",0.368327101563481
"5542",5611,45,9,36,3.62947423436241e-06,"lawnmower",0.440193771547103
"5543",5612,47,6,41,3.65351522967823e-06,"appendix",0.45710555790417
"5544",5613,52,13,39,3.59065138006686e-06,"senate",0.412883595367095
"5545",5614,60,30,30,3.67657872290361e-06,"virgin",0.473329714389845
"5546",5615,56,22,34,3.56969471970757e-06,"drown",0.39814150344877
"5547",5616,59,28,31,3.45878340752424e-06,"peach",0.320120257174001
"5548",5617,49,17,32,3.55626364716175e-06,"matrix",0.388693332669761
"5549",5618,54,25,29,3.63803051579997e-06,"immoral",0.44621274047006
"5550",5619,27,5,22,3.35268952753899e-06,"procure",0.245487863276324
"5551",5620,41,9,32,3.54138999557326e-06,"expansive",0.37823037077033
"5552",5621,72,30,42,3.69340321252211e-06,"cellphone",0.485165005327548
"5553",5622,45,8,37,3.52681436965247e-06,"plaque",0.367977056864031
"5554",5625,39,7,32,3.49680916164e-06,"pullover",0.346869708318767
"5555",5626,48,16,32,3.70358025102867e-06,"suave",0.492324105801946
"5556",5627,101,63,38,3.75711033130199e-06,"bubbles",0.529980170759587
"5557",5628,43,11,32,3.64305360753384e-06,"everlasting",0.449746265315398
"5558",5629,32,7,25,3.47742628725628e-06,"unlock",0.333234705846648
"5559",5630,50,13,37,3.71661550125993e-06,"motive",0.501493832933706
"5560",5631,53,16,37,3.69897723279513e-06,"stressful",0.489086084249983
"5561",5632,55,9,46,3.70629811238237e-06,"jolt",0.494236002125626
"5562",5633,60,17,43,3.64725234244782e-06,"draft",0.452699891273991
"5563",5634,42,13,29,3.51448142069397e-06,"cornucopia",0.359301367891975
"5564",5635,56,15,41,3.58521885968529e-06,"amaze",0.409062055415584
"5565",5636,43,4,39,3.61820681670164e-06,"supportive",0.432267637134968
"5566",5637,49,12,37,3.5485278932035e-06,"coupon",0.38325156886032
"5567",5638,45,12,33,3.68946510134961e-06,"ethical",0.482394716746526
"5568",5639,53,9,44,3.65876860483836e-06,"enclosure",0.460801077045302
"5569",5640,71,38,33,3.6349360978234e-06,"warrior",0.44403595306872
"5570",5641,41,8,33,3.72165032862172e-06,"t-shirt",0.505035613278852
"5571",5642,63,18,45,3.70657286566268e-06,"forehead",0.494429279014392
"5572",5643,45,19,26,3.6170158895508e-06,"blackboard",0.431429872089168
"5573",5644,42,12,30,3.52601849044096e-06,"plum",0.367417190726454
"5574",5645,44,15,29,3.57711362701436e-06,"shaving",0.40336037952803
"5575",5646,38,7,31,3.46263984736684e-06,"syndrome",0.32283309355453
"5576",5647,46,7,39,3.6131214117188e-06,"lifeguard",0.428690277650503
"5577",5648,49,10,39,3.70908875107564e-06,"deviant",0.496199094117461
"5578",5649,59,10,49,3.75271133393877e-06,"passing",0.526885668946549
"5579",5650,28,9,19,3.54606156672092e-06,"picket",0.38151661629233
"5580",5651,43,13,30,3.54042456771416e-06,"silky",0.377551234591407
"5581",5652,86,47,39,3.72942290909905e-06,"rebel",0.51050328293016
"5582",5653,51,14,37,3.67239315172125e-06,"declare",0.470385348539407
"5583",5654,63,14,49,3.78739101782346e-06,"elegance",0.551281306360217
"5584",5655,46,14,32,3.479180583389e-06,"vicar",0.334468776275676
"5585",5656,27,7,20,3.38475910669438e-06,"oar",0.268047406428015
"5586",5657,38,10,28,3.48001600807364e-06,"lube",0.33505646092011
"5587",5658,36,4,32,3.47532346573157e-06,"hyena",0.331755463082127
"5588",5659,53,18,35,3.55651660537603e-06,"bling",0.388871277684976
"5589",5660,46,13,33,3.65426288036309e-06,"anchor",0.457631497387367
"5590",5661,40,9,31,3.72426994998305e-06,"tinker",0.506878402074292
"5591",5662,47,9,38,3.53040027678338e-06,"fluent",0.370499585340811
"5592",5663,65,30,35,3.65418276029657e-06,"cuddly",0.457575136432673
"5593",5664,43,7,36,3.58568165601122e-06,"paws",0.409387612343992
"5594",5665,51,10,41,3.72586570489653e-06,"innovation",0.508000945705305
"5595",5666,30,3,27,3.32334115426285e-06,"duet",0.224842569175424
"5596",5667,41,7,34,3.67693020451086e-06,"drape",0.473576966293189
"5597",5668,56,12,44,3.75060009601536e-06,"vice",0.525400505614476
"5598",5669,55,25,30,3.60498064125396e-06,"gravel",0.422963602482745
"5599",5670,71,33,38,3.66332571361585e-06,"Muslim",0.464006803307399
"5600",5671,39,8,31,3.54619989219552e-06,"pessimistic",0.381613922200154
"5601",5672,44,6,38,3.57095669500816e-06,"diplomat",0.399029247753491
"5602",5673,48,13,35,3.67522749658204e-06,"cashier",0.472379185904217
"5603",5674,28,6,22,3.30916539539563e-06,"vicinity",0.214870544212965
"5604",5675,83,38,45,3.69644771374709e-06,"dizzy",0.487306678482266
"5605",5676,51,10,41,3.64553713344124e-06,"gauge",0.451493316924807
"5606",5677,51,18,33,3.5933092581613e-06,"dolphin",0.41475329609728
"5607",5678,49,15,34,3.609065973726e-06,"burial",0.42583745479448
"5608",5679,43,9,34,3.51369109736087e-06,"pillar",0.358745410071309
"5609",5680,52,12,40,3.46279572275472e-06,"spatula",0.322942745057043
"5610",5681,41,3,38,3.62331968549585e-06,"intentions",0.435864316206838
"5611",5682,30,7,23,3.4051247126926e-06,"plea",0.28237371751246
"5612",5683,47,23,24,3.58871850450922e-06,"solitary",0.411523902140751
"5613",5684,80,46,34,3.65605314438851e-06,"hurtful",0.458890869652238
"5614",5685,47,18,29,3.61258625049673e-06,"plumbing",0.428313815189806
"5615",5686,50,19,31,3.70724618339005e-06,"chimney",0.494902928520421
"5616",5687,62,17,45,3.64924880213408e-06,"subtle",0.454104313147588
"5617",5688,65,24,41,3.64908900492992e-06,"mole",0.453991902819241
"5618",5689,55,17,38,3.61645341646354e-06,"actress",0.431034196928535
"5619",5690,60,25,35,3.55740224258637e-06,"mischievous",0.389494284640155
"5620",5691,64,30,34,3.77042628439571e-06,"filth",0.539347360050355
"5621",5692,70,26,44,3.68368899350566e-06,"plans",0.478331478076538
"5622",5693,29,2,27,3.51198817162384e-06,"goblet",0.357547476463808
"5623",5694,49,11,38,3.52291302632321e-06,"mixer",0.365232632848998
"5624",5695,42,3,39,3.61348697879967e-06,"stark",0.428947438067104
"5625",5696,52,11,41,3.65747056650562e-06,"icon",0.459887963978302
"5626",5697,39,4,35,3.5860416913207e-06,"timetable",0.40964088140191
"5627",5698,49,13,36,3.65440977627703e-06,"teamwork",0.457734832223581
"5628",5699,77,43,34,3.60546155316073e-06,"keys",0.423301902928173
"5629",5700,52,11,41,3.62086632847775e-06,"winding",0.43413848708859
"5630",5701,40,8,32,3.5307243634104e-06,"conceal",0.370727566076436
"5631",5702,56,18,38,3.61933302930936e-06,"apron",0.43305987833647
"5632",5703,45,14,31,3.65355527463775e-06,"postpone",0.457133727777801
"5633",5704,57,18,39,3.64604222116892e-06,"endurance",0.451848624000487
"5634",5705,35,5,30,3.63812316502163e-06,"printing",0.44627791513618
"5635",5706,38,3,35,3.55756676663429e-06,"destruct",0.389610020095882
"5636",5707,34,12,22,3.58705789511443e-06,"quill",0.410355736225055
"5637",5708,51,9,42,3.63995064226929e-06,"woodworking",0.44756346527164
"5638",5709,56,16,40,3.60102124962639e-06,"microwave",0.42017834403443
"5639",5710,59,19,40,3.56435078914726e-06,"gene",0.394382282553144
"5640",5711,44,8,36,3.63578191125783e-06,"valve",0.44463094574324
"5641",5712,106,57,49,3.67060032668343e-06,"tropical",0.469124174714575
"5642",5713,122,77,45,3.74335554390956e-06,"poison",0.520304280776175
"5643",5714,39,5,34,3.66625360209416e-06,"spades",0.466066444506613
"5644",5715,56,13,43,3.64807728086912e-06,"blueberry",0.453280199291837
"5645",5716,35,9,26,3.48648290577431e-06,"doodle",0.339605639973227
"5646",5717,89,54,35,3.53198388002557e-06,"tart",0.371613580803746
"5647",5718,43,19,24,3.53794445427207e-06,"introvert",0.37580658350176
"5648",5719,40,7,33,3.50454188628462e-06,"departure",0.352309341138869
"5649",5720,49,15,34,3.49567235762127e-06,"spoke",0.34607001652389
"5650",5721,45,8,37,3.62038129855836e-06,"barge",0.433797289801801
"5651",5722,45,11,34,3.65287462968983e-06,"pedestrian",0.456654923893313
"5652",5724,78,35,43,3.68996881976347e-06,"bias",0.482749060569963
"5653",5725,69,30,39,3.68666312747006e-06,"bars",0.480423650948027
"5654",5726,47,21,26,3.59136062288559e-06,"flock",0.413382516600099
"5655",5727,46,19,27,3.42644116115238e-06,"frost",0.29736890458801
"5656",5728,49,9,40,3.56620662601191e-06,"publish",0.395687782435997
"5657",5729,57,13,44,3.72636552664724e-06,"drone",0.50835254839702
"5658",5730,82,47,35,3.59652719334211e-06,"speaking",0.417016972437371
"5659",5731,38,7,31,3.64833015928609e-06,"info",0.453458088173144
"5660",5733,114,76,38,3.76418155400471e-06,"cave",0.534954465960793
"5661",5734,75,30,45,3.62977724057075e-06,"verbal",0.440406923132257
"5662",5735,34,3,31,3.4206511551539e-06,"dragonfly",0.293295889175538
"5663",5736,76,35,41,3.77137900473308e-06,"southern",0.540017557044777
"5664",5737,53,26,27,3.59426499078071e-06,"dressing",0.415425612100073
"5665",5738,51,15,36,3.66258776475931e-06,"mediocre",0.463487688635139
"5666",5739,51,14,37,3.59668242013567e-06,"exceptional",0.417126167682204
"5667",5740,68,22,46,3.79528246389738e-06,"vulnerable",0.556832592748202
"5668",5741,44,12,32,3.59329634633628e-06,"conscientious",0.414744213194368
"5669",5742,45,7,38,3.60880548538434e-06,"sling",0.425654212664741
"5670",5743,37,8,29,3.55393811882947e-06,"charitable",0.387057425428567
"5671",5744,41,8,33,3.50240615302713e-06,"raft",0.350806946413029
"5672",5745,47,12,35,3.6223221983149e-06,"bamboo",0.435162627700326
"5673",5746,33,9,24,3.4762778797486e-06,"acorn",0.332426851505944
"5674",5747,29,4,25,3.59985456587554e-06,"magpie",0.419357633157799
"5675",5748,41,7,34,3.64232380258605e-06,"banjo",0.449232879525953
"5676",5749,39,9,30,3.4341838662042e-06,"meteor",0.302815558187077
"5677",5750,45,9,36,3.64670702355773e-06,"shack",0.452316283339107
"5678",5751,55,19,36,3.67935184537892e-06,"jealous",0.475280484490176
"5679",5752,52,11,41,3.67789036208831e-06,"tantrum",0.474252395059994
"5680",5753,140,97,43,3.7308142875264e-06,"wooden",0.511482056662115
"5681",5754,69,37,32,3.67012882152164e-06,"blush",0.468792491501889
"5682",5755,48,8,40,3.63930154524744e-06,"fidelity",0.447106853970219
"5683",5756,50,4,46,3.77562231694839e-06,"recession",0.543002541180789
"5684",5757,41,5,36,3.7123658907822e-06,"torment",0.498504418246165
"5685",5758,66,31,35,3.60859712178294e-06,"temple",0.425507638004865
"5686",5759,53,17,36,3.53419332037462e-06,"porcelain",0.373167825237514
"5687",5760,31,9,22,3.55522689458041e-06,"mane",0.387964022675299
"5688",5761,39,10,29,3.62701253858235e-06,"mildew",0.438462076475346
"5689",5762,50,14,36,3.63730272179363e-06,"examination",0.44570076928977
"5690",5763,46,20,26,3.56620662601191e-06,"wasp",0.395687782435997
"5691",5764,73,34,39,3.73450646629795e-06,"wipe",0.514079342579619
"5692",5765,82,43,39,3.75489544493634e-06,"foul",0.528422095291869
"5693",5766,105,57,48,3.73901663862404e-06,"flexible",0.517252051105637
"5694",5767,62,17,45,3.64394303788243e-06,"skateboard",0.450371940577065
"5695",5768,37,11,26,3.45375423084893e-06,"sniff",0.316582451839098
"5696",5769,62,25,37,3.66199761970155e-06,"boil",0.463072547456269
"5697",5770,40,11,29,3.47716027274845e-06,"toll",0.333047576301257
"5698",5771,42,5,37,3.5734322459379e-06,"regional",0.4007706893157
"5699",5772,34,3,31,3.47813989078641e-06,"eggplant",0.333736694648971
"5700",5773,74,48,26,3.68909760983366e-06,"violin",0.48213620257421
"5701",5774,37,6,31,3.63809669333392e-06,"zucchini",0.446259293464272
"5702",5776,35,7,28,3.30856322333463e-06,"briefs",0.214446942564534
"5703",5777,36,4,32,3.3326112675587e-06,"cultivate",0.231363687519553
"5704",5778,52,13,39,3.6787562860748e-06,"persistence",0.474861534626336
"5705",5779,42,10,32,3.54216773581096e-06,"fitting",0.378777476934965
"5706",5780,50,13,37,3.48750427219273e-06,"dental",0.340324126476539
"5707",5781,32,5,27,3.49773871192274e-06,"elucidate",0.347523606195428
"5708",5782,66,36,30,3.5357053201758e-06,"spooky",0.374231450818461
"5709",5783,40,5,35,3.31189433732306e-06,"sonar",0.216790235234544
"5710",5784,58,18,40,3.42051075066529e-06,"colon",0.293197120772496
"5711",5785,58,15,43,3.63898370463097e-06,"bikini",0.446883267029219
"5712",5786,50,16,34,3.7141445767918e-06,"fad",0.499755645884434
"5713",5787,34,11,23,3.5718622975647e-06,"mast",0.399666299454534
"5714",5788,41,13,28,3.63072610891452e-06,"dorm",0.441074410418041
"5715",5789,42,13,29,3.58865411116215e-06,"pungent",0.411478604243794
"5716",5790,47,17,30,3.62038129855836e-06,"pi",0.433797289801801
"5717",5791,40,13,27,3.51613731219432e-06,"fracture",0.360466214975736
"5718",5792,50,29,21,3.42822664692008e-06,"drip",0.298624915558032
"5719",5793,38,9,29,3.48866011031143e-06,"illustration",0.341137207926371
"5720",5794,51,11,40,3.74586550095332e-06,"blackberry",0.52206992553139
"5721",5795,43,5,38,3.60336987150383e-06,"scrutinize",0.421830496572332
"5722",5796,192,147,45,3.89395968972929e-06,"legs",0.626247695561311
"5723",5797,34,9,25,3.49237614288009e-06,"evade",0.343751273944499
"5724",5798,39,4,35,3.52835740849205e-06,"replica",0.36906251704789
"5725",5799,50,19,31,3.44422592744394e-06,"beaver",0.309879708071059
"5726",5800,42,9,33,3.46696158953255e-06,"mute",0.325873249722639
"5727",5801,53,25,28,3.52622986081971e-06,"camel",0.367565880522386
"5728",5802,72,25,47,3.72895007681637e-06,"insecure",0.51017066614611
"5729",5803,87,38,49,3.83557650632678e-06,"mysterious",0.585177685290198
"5730",5804,42,11,31,3.6820342502826e-06,"touchy",0.477167438755513
"5731",5805,33,10,23,3.44517520438502e-06,"primate",0.310547482787137
"5732",5806,53,15,38,3.59575126031082e-06,"hedgehog",0.416471137563223
"5733",5807,40,5,35,3.51502497425244e-06,"custody",0.359683733993451
"5734",5808,34,2,32,3.52393101552644e-06,"latter",0.365948743629468
"5735",5809,40,8,32,3.49693144265907e-06,"slot",0.346955727655436
"5736",5810,61,18,43,3.68766917182326e-06,"thug",0.481131359050101
"5737",5811,53,8,45,3.75231705578195e-06,"fulfillment",0.52660831154658
"5738",5812,54,13,41,3.74054110667649e-06,"aura",0.518324447554807
"5739",5813,62,22,40,3.68795477092269e-06,"perspective",0.48133226549719
"5740",5814,42,6,36,3.61250794751748e-06,"anorexia",0.428258732476352
"5741",5815,83,47,36,3.80356850797418e-06,"uneducated",0.562661461533844
"5742",5816,61,32,29,3.64988813092879e-06,"handy",0.454554052929404
"5743",5817,51,8,43,3.56325852865929e-06,"epiphany",0.393613925179572
"5744",5818,47,17,30,3.491559155741e-06,"stereo",0.343176559305136
"5745",5819,40,13,27,3.55623835331939e-06,"bro",0.388675539560433
"5746",5820,35,5,30,3.44237634123588e-06,"embryo",0.308578605251118
"5747",5821,59,19,40,3.78542686366028e-06,"overwhelming",0.549899610005981
"5748",5822,56,20,36,3.54060006089832e-06,"loop",0.377674686353643
"5749",5823,42,5,37,3.61689814814815e-06,"flask",0.431347046173646
"5750",5824,53,21,32,3.48337385658253e-06,"cargo",0.337418560153349
"5751",5825,44,9,35,3.61962124283315e-06,"download",0.43326262391649
"5752",5826,36,12,24,3.52988933796925e-06,"remorse",0.3701401622823
"5753",5827,42,15,27,3.52213131209958e-06,"stuffed",0.364682731159462
"5754",5828,43,7,36,3.48240341554127e-06,"freight",0.336735897420531
"5755",5829,43,4,39,3.58055899687059e-06,"align",0.405784046192582
"5756",5830,50,11,39,3.57838085423108e-06,"baton",0.404251818325526
"5757",5831,66,19,47,3.71864715616459e-06,"questionable",0.502923013100643
"5758",5832,45,6,39,3.59116716524038e-06,"competitor",0.413246427626994
"5759",5833,33,3,30,3.53695588354926e-06,"nutcracker",0.3751111673327
"5760",5834,48,9,39,3.69371698740442e-06,"appeal",0.485385732202794
"5761",5835,79,46,33,3.67437673384652e-06,"obnoxious",0.471780711613339
"5762",5836,35,7,28,3.6459491681767e-06,"polo",0.451783165299476
"5763",5837,150,107,43,3.69852576762902e-06,"illegal",0.4887684982958
"5764",5838,53,17,36,3.70892367035086e-06,"caterpillar",0.496082967063971
"5765",5839,34,5,29,3.47379025254455e-06,"boulevard",0.330676914814133
"5766",5841,48,21,27,3.5931414116734e-06,"cigar",0.414635223450663
"5767",5842,53,9,44,3.70813973753787e-06,"feedback",0.49553150469407
"5768",5843,38,3,35,3.65071426224541e-06,"stapler",0.455135200096818
"5769",5844,60,17,43,3.63261213873672e-06,"wasteful",0.442401149723012
"5770",5845,41,5,36,3.60111202339282e-06,"bulldozer",0.420242199400005
"5771",5846,49,14,35,3.58248309067981e-06,"palace",0.40713756184387
"5772",5847,27,7,20,3.39973006143312e-06,"employer",0.278578816828329
"5773",5848,48,9,39,3.6871252958918e-06,"legacy",0.480748766173365
"5774",5849,63,33,30,3.62975089019641e-06,"crawl",0.440388386798989
"5775",5850,50,7,43,3.80569636632111e-06,"poorly",0.5641583166053
"5776",5851,34,3,31,3.62047305100884e-06,"photocopy",0.433861833628705
"5777",5852,33,4,29,3.54241869263496e-06,"dame",0.378954014059844
"5778",5853,40,6,34,3.59308976975481e-06,"squat",0.414598895624682
"5779",5854,49,15,34,3.64321287657159e-06,"mode",0.449858304101831
"5780",5855,49,15,34,3.67927062139202e-06,"marvelous",0.475223346975879
"5781",5856,96,58,38,3.72964545990258e-06,"breasts",0.510659837664835
"5782",5857,30,9,21,3.39263662147675e-06,"inception",0.273588892763083
"5783",5858,37,9,28,3.59575126031082e-06,"bumble",0.416471137563223
"5784",5859,48,21,27,3.57326625121491e-06,"razor",0.400653919304528
"5785",5860,44,9,35,3.6304097643501e-06,"rift",0.440851875884076
"5786",5861,62,25,37,3.78643019147977e-06,"tradition",0.550605407145679
"5787",5862,32,5,27,3.4178452536383e-06,"seaweed",0.291322060457243
"5788",5863,40,9,31,3.53283237770218e-06,"nicotine",0.372210461724968
"5789",5864,31,2,29,3.4875285977345e-06,"analog",0.340341238428852
"5790",5865,92,59,33,3.76909044309427e-06,"belly",0.538407654251983
"5791",5866,51,18,33,3.60771184483953e-06,"harass",0.424884884481684
"5792",5867,60,27,33,3.57744634724841e-06,"dive",0.403594433627742
"5793",5868,126,93,33,3.73780075279307e-06,"brave",0.51639672872244
"5794",5869,45,14,31,3.60172162293576e-06,"calcium",0.420671025956399
"5795",5870,54,21,33,3.5775871321346e-06,"lick",0.403693469623814
"5796",5871,43,6,37,3.61998812643895e-06,"dart",0.433520710450663
"5797",5872,48,26,22,3.49090096663048e-06,"sweep",0.342713552117896
"5798",5873,62,24,38,3.63635041327122e-06,"napkin",0.445030861989124
"5799",5874,48,10,38,3.54459095420388e-06,"guarantee",0.380482104851542
"5800",5875,41,8,33,3.55401390330239e-06,"hub",0.387110736483217
"5801",5876,68,22,46,3.7704831497108e-06,"mechanics",0.539387362306806
"5802",5877,49,17,32,3.57290877649312e-06,"maze",0.400402451507809
"5803",5878,37,6,31,3.47043880228216e-06,"kilogram",0.328319316466839
"5804",5879,35,5,30,3.46229217591214e-06,"intend",0.322588521926484
"5805",5881,38,12,26,3.53694337353659e-06,"snowman",0.375102367087166
"5806",5882,34,11,23,3.50103280467738e-06,"tusk",0.349840856050309
"5807",5883,38,14,24,3.5574402083237e-06,"barber",0.389520991872119
"5808",5884,45,10,35,3.5667662983386e-06,"digest",0.39608148738434
"5809",5885,41,5,36,3.57468408729379e-06,"toenail",0.401651304834547
"5810",5886,56,24,32,3.68892069558289e-06,"playing",0.482011751153905
"5811",5887,55,22,33,3.65979966256647e-06,"atheist",0.461526380960162
"5812",5888,42,2,40,3.606983119319e-06,"inference",0.424372258021996
"5813",5889,51,10,41,3.62693360898029e-06,"sandpaper",0.438406552960212
"5814",5890,25,6,19,3.25453030618621e-06,"parched",0.176437153907332
"5815",5891,55,14,41,3.68717967626562e-06,"sneakers",0.48078702038256
"5816",5892,30,7,23,3.37401267953965e-06,"lobe",0.260487765999031
"5817",5893,52,4,48,3.76612371716411e-06,"colonial",0.53632069260785
"5818",5894,42,6,36,3.64766476501744e-06,"shares",0.452990012472993
"5819",5895,45,10,35,3.61346086441211e-06,"crossword",0.428929067740188
"5820",5896,98,61,37,3.67657872290361e-06,"sweater",0.473329714389845
"5821",5897,29,2,27,3.59515660502171e-06,"ostrich",0.416052823634316
"5822",5898,39,5,34,3.58599025327849e-06,"pliers",0.409604696994024
"5823",5899,41,14,27,3.47479212056139e-06,"dove",0.331381685046651
"5824",5900,43,4,39,3.70053768812608e-06,"distraction",0.490183796172062
"5825",5901,45,6,39,3.62506661059897e-06,"inventory",0.437093201439651
"5826",5902,43,9,34,3.5193051483915e-06,"postal",0.362694648876962
"5827",5903,41,5,36,3.69169884597494e-06,"cove",0.48396605817327
"5828",5904,29,6,23,3.55286485257387e-06,"badminton",0.38630242966485
"5829",5905,24,3,21,3.54437737694808e-06,"brunette",0.380331862614335
"5830",5906,55,30,25,3.68054354267038e-06,"fridge",0.476118791296145
"5831",5907,27,4,23,3.5403242937053e-06,"udder",0.377480696221731
"5832",5908,38,7,31,3.45579519575352e-06,"sold",0.318018181182879
"5833",5909,33,4,29,3.17515756719427e-06,"arctic",0.120601911365466
"5834",5910,164,123,41,3.75102215353684e-06,"maths",0.525697404579757
"5835",5911,37,5,32,3.29713083674586e-06,"Zeppelin",0.206404759743033
"5836",5912,56,22,34,3.63916910490997e-06,"procrastinate",0.44701368799839
"5837",5913,47,13,34,3.60961312166562e-06,"assured",0.426222349385532
"5838",5914,34,7,27,3.49629567473262e-06,"minimize",0.346508492788348
"5839",5915,41,10,31,3.65670823125023e-06,"stump",0.459351694543438
"5840",5916,34,5,29,3.67210995766057e-06,"tit",0.470186133931656
"5841",5917,41,10,31,3.67958199948486e-06,"widow",0.475442387814798
"5842",5918,31,5,26,3.62686783693602e-06,"midday",0.438360285210218
"5843",5919,43,4,39,3.5841394660349e-06,"recite",0.408302749298232
"5844",5920,74,28,46,3.69791031088332e-06,"basement",0.488335551454015
"5845",5921,37,12,25,3.4998197592824e-06,"oriental",0.348987531789318
"5846",5922,62,27,35,3.65765785536889e-06,"tick",0.460019713483727
"5847",5923,30,9,21,3.40710859136502e-06,"scalp",0.283769289194314
"5848",5924,60,20,40,3.79021896094937e-06,"unsafe",0.553270640385164
"5849",5925,42,4,38,3.53898367466831e-06,"reptiles",0.376537629495831
"5850",5926,45,4,41,3.73043851304721e-06,"indoors",0.511217715788246
"5851",5927,31,7,24,3.46013577572784e-06,"reside",0.321071588923579
"5852",5928,88,45,43,3.73188635659667e-06,"training",0.512236210258432
"5853",5929,41,3,38,3.51217319228446e-06,"softball",0.357677630388092
"5854",5930,72,32,40,3.6583938187778e-06,"lounge",0.460537431480616
"5855",5931,59,13,46,3.67977155978157e-06,"forum",0.475575735174075
"5856",5932,47,8,39,3.56882842500464e-06,"timer",0.397532103099668
"5857",5933,43,8,35,3.64375715087341e-06,"nutmeg",0.450241177214656
"5858",5934,168,132,36,3.73630643690873e-06,"French",0.5153455430018
"5859",5935,66,30,36,3.55611188950449e-06,"toothpaste",0.388586577810247
"5860",5936,69,32,37,3.67273034446538e-06,"burglar",0.470622548853909
"5861",5937,41,8,33,3.49800788450977e-06,"llama",0.347712957311104
"5862",5938,34,8,26,3.44736052841142e-06,"wag",0.312084762445071
"5863",5939,40,9,31,3.51119896911198e-06,"cognition",0.356992307091758
"5864",5940,33,4,29,3.506016324012e-06,"lavatory",0.353346543447453
"5865",5941,64,39,25,3.47211371866851e-06,"grief",0.329497546723941
"5866",5942,48,17,31,3.56315695706396e-06,"extinct",0.393542474014693
"5867",5943,79,43,36,3.67937892083816e-06,"nuclear",0.47529953088889
"5868",5944,40,6,34,3.53646805862049e-06,"scholarship",0.374768003879331
"5869",5945,53,15,38,3.62255839564134e-06,"stamina",0.435328782165664
"5870",5946,35,4,31,3.66301708064865e-06,"cosmopolitan",0.463789693544034
"5871",5947,71,29,42,3.65748394364549e-06,"decoration",0.459897374209809
"5872",5948,45,9,36,3.52926644197004e-06,"fictional",0.369701982251771
"5873",5949,57,18,39,3.62550031904403e-06,"arrogance",0.437398296318949
"5874",5950,86,54,32,3.75653166944024e-06,"foolish",0.529573107505744
"5875",5951,83,40,43,3.67832327311918e-06,"hunter",0.474556928993369
"5876",5952,47,11,36,3.63657521892183e-06,"apocalypse",0.445189002909869
"5877",5953,66,25,41,3.50208724399742e-06,"jumper",0.350582607890148
"5878",5954,96,56,40,3.73943609303717e-06,"sparkle",0.517547118898304
"5879",5955,38,4,34,3.54627534700304e-06,"virtual",0.381667001349649
"5880",5956,44,14,30,3.52091600150695e-06,"silverware",0.363827813431225
"5881",5957,57,12,45,3.79052066591867e-06,"hostage",0.553482876605694
"5882",5958,32,2,30,3.47620537421351e-06,"parakeet",0.332375847040322
"5883",5959,44,9,35,3.56021389765097e-06,"artisan",0.391472160727962
"5884",5960,83,43,40,3.57068892872191e-06,"fried",0.398840885908766
"5885",5961,43,6,37,3.6053835587299e-06,"disprove",0.423247037265003
"5886",5962,60,25,35,3.62347723369254e-06,"flee",0.435975144457015
"5887",5963,90,55,35,3.69302129765382e-06,"itchy",0.484896344959112
"5888",5964,50,14,36,3.61696355909214e-06,"salon",0.431393059905429
"5889",5965,37,8,29,3.53560531330767e-06,"hover",0.374161100370576
"5890",5966,94,59,35,3.6447930486507e-06,"wheels",0.450969885891944
"5891",5967,55,16,39,3.50439451071644e-06,"airline",0.352205668886922
"5892",5968,52,6,46,3.73879296807819e-06,"sweatshirt",0.517094708681324
"5893",5969,61,19,42,3.63575547362987e-06,"resources",0.444612348030869
"5894",5970,50,11,39,3.6269467636754e-06,"burglary",0.438415806711584
"5895",5971,31,8,23,3.45189439964653e-06,"gluten",0.315274142114725
"5896",5972,31,4,27,3.43139105161842e-06,"beet",0.300850935550238
"5897",5973,45,20,25,3.4658921552997e-06,"peel",0.325120949618947
"5898",5974,70,26,44,3.6440492675461e-06,"terrorist",0.45044666848883
"5899",5975,47,16,31,3.55584634476775e-06,"beaker",0.38839977872822
"5900",5976,41,6,35,3.61212953096498e-06,"eyesight",0.427992533019722
"5901",5977,43,4,39,3.69851208858676e-06,"decisive",0.488758875689196
"5902",5978,47,16,31,3.64466020832878e-06,"bloom",0.450876438548587
"5903",5979,50,12,38,3.65807263469023e-06,"erotic",0.460311492554257
"5904",5980,44,7,37,3.51374048215547e-06,"suspense",0.358780150109507
"5905",5981,57,25,32,3.67275732255991e-06,"racing",0.470641526760816
"5906",5982,43,12,31,3.63026479151389e-06,"beetle",0.44074989384875
"5907",5983,45,12,33,3.44377520412978e-06,"soak",0.309562643977201
"5908",5984,38,5,33,3.51916891306949e-06,"algorithm",0.362598813299862
"5909",5985,68,25,43,3.72661548781397e-06,"assault",0.508528385120656
"5910",5986,51,21,30,3.73202563155204e-06,"solitude",0.512334184084355
"5911",5987,36,11,25,3.41193289410384e-06,"slug",0.287162974695635
"5912",5988,64,14,50,3.77896101245923e-06,"console",0.54535116711948
"5913",5989,47,9,38,3.62553975223061e-06,"pheasant",0.437426035837141
"5914",5990,59,25,34,3.66967090391334e-06,"lump",0.468470366537471
"5915",5991,50,21,29,3.62647325475975e-06,"pearl",0.438082713945891
"5916",5992,58,23,35,3.70558394444589e-06,"democrat",0.493733616288174
"5917",5993,38,3,35,3.5712627628003e-06,"distinction",0.399244553028645
"5918",5994,42,6,36,3.4959656556334e-06,"emphasis",0.346276338818578
"5919",5995,42,7,35,3.60200703832175e-06,"tricycle",0.420871803169133
"5920",5996,51,4,47,3.65737692926633e-06,"prestige",0.459822094285094
"5921",5997,62,30,32,3.57385368643008e-06,"squirrel",0.401067154227916
"5922",5998,77,42,35,3.76503188982011e-06,"victim",0.535552639932078
"5923",5999,38,4,34,3.65324828571324e-06,"legislation",0.456917774526404
"5924",6000,41,9,32,3.62886837368635e-06,"futile",0.439767575119664
"5925",6001,53,7,46,3.61289949636181e-06,"delegate",0.428534169924619
"5926",6002,45,11,34,3.59968610737144e-06,"rumble",0.419239129984616
"5927",6003,41,14,27,3.32356206087436e-06,"browser",0.224997967293084
"5928",6004,63,26,37,3.55323095290548e-06,"written",0.386559965199964
"5929",6005,44,11,33,3.62364792636747e-06,"lucid",0.436095219271442
"5930",6006,28,2,26,3.58737959857222e-06,"pickup",0.410582040505601
"5931",6007,83,35,48,3.71431012260938e-06,"rub",0.499872100110328
"5932",6008,34,5,29,3.35419643516003e-06,"currently",0.246547906731765
"5933",6009,46,9,37,3.62291274939226e-06,"shoelace",0.435578054496183
"5934",6010,36,6,30,3.55940287457376e-06,"venue",0.390901641544699
"5935",6011,71,21,50,3.75624946003914e-06,"brutal",0.529374585562844
"5936",6012,45,9,36,3.63184693944258e-06,"chatty",0.441862865562434
"5937",6013,63,24,39,3.73833173208124e-06,"doom",0.516770249375957
"5938",6014,75,35,40,3.75555822617474e-06,"immature",0.528888332839778
"5939",6015,42,13,29,3.28637109045079e-06,"cactus",0.198835749882666
"5940",6016,46,18,28,3.56077169044075e-06,"grapes",0.39186454350448
"5941",6017,50,15,35,3.50620071596619e-06,"smoothie",0.353476255104318
"5942",6018,58,30,28,3.41206095305687e-06,"spaghetti",0.287253058555569
"5943",6019,39,7,32,3.63087111859877e-06,"fondness",0.44117641837435
"5944",6020,109,71,38,3.78302104494607e-06,"aggressive",0.548207222000659
"5945",6021,33,4,29,3.65063429770923e-06,"abacus",0.455078948550895
"5946",6022,53,23,30,3.64980820257895e-06,"bothersome",0.454497826838992
"5947",6023,32,3,29,3.51260498298143e-06,"sociology",0.357981376215676
"5948",6024,48,12,36,3.54559636930932e-06,"shrug",0.3811893703054
"5949",6025,69,20,49,3.61748693182846e-06,"psychic",0.431761229683153
"5950",6026,43,4,39,3.74150677961028e-06,"progression",0.519003756133032
"5951",6027,51,16,35,3.52909207048303e-06,"savory",0.36957931955431
"5952",6028,41,4,37,3.57994372328467e-06,"defect",0.405351228195675
"5953",6029,70,43,27,3.68598367846427e-06,"trousers",0.479945688356398
"5954",6030,42,8,34,3.65094084745639e-06,"mercury",0.45529459286028
"5955",6031,66,23,43,3.65959876159178e-06,"pickle",0.461385055931049
"5956",6032,46,6,40,3.62342471610467e-06,"grainy",0.435938200636082
"5957",6033,42,6,36,3.67134150818709e-06,"sanctuary",0.469645563412383
"5958",6034,81,46,35,3.63879832324173e-06,"wizard",0.446752859348165
"5959",6035,47,14,33,3.59139931691585e-06,"posture",0.413409736154219
"5960",6036,41,5,36,3.76975824540372e-06,"mankind",0.538877423903273
"5961",6037,36,3,33,3.53700592448492e-06,"lantern",0.37514636893737
"5962",6038,54,29,25,3.60303231199377e-06,"icky",0.421593038254078
"5963",6039,61,22,39,3.57871381025659e-06,"swirl",0.404486038294203
"5964",6040,45,9,36,3.54930877211663e-06,"controversy",0.383800882945532
"5965",6041,51,16,35,3.54354843853538e-06,"vicious",0.379748740777882
"5966",6042,70,23,47,3.6685939013295e-06,"dip",0.467712742430623
"5967",6043,103,68,35,3.64733215889238e-06,"association",0.452756038643951
"5968",6044,62,29,33,3.58686490073351e-06,"communism",0.410219973138076
"5969",6045,36,5,31,3.45903465260915e-06,"sharpen",0.320296997077798
"5970",6046,41,8,33,3.48763806687197e-06,"dandy",0.340418245168435
"5971",6047,44,19,25,3.46038721732962e-06,"hydrogen",0.321248467068378
"5972",6048,41,4,37,3.44872776432774e-06,"spawn",0.313046552978812
"5973",6049,48,7,41,3.61900556964957e-06,"economic",0.432829524820148
"5974",6050,60,13,47,3.74259901045682e-06,"respected",0.519772092655151
"5975",6051,54,10,44,3.68836284638338e-06,"domestic",0.481619328695615
"5976",6053,44,14,30,3.68799557440531e-06,"calf",0.481360968958575
"5977",6054,44,4,40,3.57715201465201e-06,"liability",0.403387383548379
"5978",6055,36,2,34,3.52316126213729e-06,"novelty",0.36540725586268
"5979",6056,51,18,33,3.52412971616659e-06,"vertical",0.366088520819686
"5980",6057,63,29,34,3.54542038049452e-06,"crop",0.381065569888734
"5981",6058,51,13,38,3.52946574477021e-06,"correction",0.36984218303517
"5982",6059,49,8,41,3.57756153405839e-06,"straighten",0.403675462499298
"5983",6060,40,12,28,3.55912417072407e-06,"broth",0.390705585603546
"5984",6061,45,10,35,3.56913412806053e-06,"eventually",0.397747151798861
"5985",6062,48,12,36,3.52314884951574e-06,"remains",0.365398524127534
"5986",6063,38,7,31,3.65059431675477e-06,"pawn",0.455050823702015
"5987",6064,42,5,37,3.57620536001659e-06,"surge",0.402721453509383
"5988",6065,50,13,37,3.62280774846121e-06,"hem",0.435504190943956
"5989",6067,29,3,26,3.48410204238062e-06,"ruminate",0.337930806941957
"5990",6068,45,8,37,3.60836274148968e-06,"boost",0.425342761742721
"5991",6069,29,6,23,3.53051245388268e-06,"Belgium",0.370578497012836
"5992",6070,34,6,28,3.52947820194262e-06,"steering",0.369850946109895
"5993",6071,58,13,45,3.64412894385855e-06,"protective",0.450502717281994
"5994",6072,61,22,39,3.62768357892751e-06,"chewy",0.438934123942822
"5995",6073,46,2,44,3.7409609032176e-06,"escort",0.518619756019511
"5996",6074,57,11,46,3.74304728965946e-06,"goddess",0.520087437423689
"5997",6075,54,9,45,3.73305658940484e-06,"rally",0.513059417741309
"5998",6076,63,20,43,3.65182079784981e-06,"stalker",0.455913599389038
"5999",6077,44,4,40,3.59557025744283e-06,"composition",0.416343809979935
"6000",6078,54,14,40,3.73389291941886e-06,"paradise",0.513647739245277
"6001",6079,39,15,24,3.53205873107258e-06,"mini",0.371666235234188
"6002",6080,75,40,35,3.53665566766754e-06,"drain",0.374899978620003
"6003",6081,50,13,37,3.57987964444635e-06,"blurry",0.405306151541844
"6004",6082,40,4,36,3.69161707594395e-06,"accordion",0.483908536540891
"6005",6083,32,3,29,3.53548031267788e-06,"snooker",0.374073167906979
"6006",6084,46,15,31,3.53038781310127e-06,"ore",0.370490817686796
"6007",6085,32,2,30,3.69457673081683e-06,"beanie",0.485990524006192
"6008",6086,61,16,45,3.70745234996867e-06,"clerk",0.495047957671076
"6009",6087,54,21,33,3.61316057608232e-06,"penguin",0.428717828063455
"6010",6088,54,22,32,3.58828067531442e-06,"surprising",0.411215908494643
"6011",6089,42,12,30,3.59448462279478e-06,"unseen",0.415580113594308
"6012",6090,56,12,44,3.4997095241095e-06,"diarrhea",0.348909986177391
"6013",6091,42,3,39,3.48203963953926e-06,"tram",0.336479996949396
"6014",6092,42,9,33,3.60231845215581e-06,"rhino",0.421090869150428
"6015",6093,36,12,24,3.53656811430188e-06,"exhale",0.374838388665202
"6016",6094,60,18,42,3.63335125786621e-06,"wildlife",0.442921087630991
"6017",6095,47,10,37,3.72162262746558e-06,"willow",0.505016126729794
"6018",6096,48,7,41,3.63350967966979e-06,"blender",0.443032530425321
"6019",6097,57,18,39,3.61393098114612e-06,"mining",0.429259774254793
"6020",6098,43,13,30,3.45807772375492e-06,"microscopic",0.319623839576244
"6021",6099,38,9,29,3.52511112912835e-06,"reluctant",0.366778901817609
"6022",6100,61,19,42,3.68127519372711e-06,"balanced",0.476633475742305
"6023",6101,32,13,19,3.57416025104902e-06,"rattle",0.401282808998944
"6024",6102,42,9,33,3.67789036208831e-06,"snowboard",0.474252395059994
"6025",6103,29,6,23,3.43445514086418e-06,"arduous",0.30300638801893
"6026",6104,53,10,43,3.46942740570096e-06,"messenger",0.32760784330698
"6027",6105,44,2,42,3.63534573955656e-06,"formation",0.444324118071172
"6028",6106,45,7,38,3.60061930652072e-06,"expire",0.419895594678943
"6029",6107,47,5,42,3.59801533474136e-06,"entitled",0.418063814678409
"6030",6108,56,24,32,3.56565984318228e-06,"curry",0.395303144683817
"6031",6109,50,5,45,3.7016198288371e-06,"footprint",0.490945034726146
"6032",6110,54,17,37,3.5674025028896e-06,"grit",0.396529029397659
"6033",6111,45,13,32,3.50687698576909e-06,"socket",0.353951981266078
"6034",6112,62,17,45,3.73187242967286e-06,"renew",0.512226413278029
"6035",6113,46,8,38,3.54674072261295e-06,"nanny",0.381994372691278
"6036",6114,42,6,36,3.54672814328782e-06,"bison",0.381985523687464
"6037",6115,85,41,44,3.63989764607819e-06,"earthquake",0.447526184774314
"6038",6116,36,3,33,3.50510694081276e-06,"cranberries",0.352706832230001
"6039",6117,45,5,40,3.48079125346774e-06,"mammals",0.335601812071637
"6040",6118,29,4,25,3.51153187066326e-06,"pelican",0.357226488740194
"6041",6119,51,21,30,3.63353608464686e-06,"gorgeous",0.443051105169215
"6042",6120,49,12,37,3.52716267979712e-06,"promotion",0.368222077782464
"6043",6121,52,18,34,3.80416175295774e-06,"pleasing",0.563078783374619
"6044",6122,48,7,41,3.55196885633707e-06,"pinpoint",0.385672135588647
"6045",6124,46,12,34,3.60109905543172e-06,"frighten",0.420233077007824
"6046",6125,41,4,37,3.58566879894438e-06,"colloquial",0.409378567961068
"6047",6126,54,8,46,3.63422274878072e-06,"reflex",0.443534143287162
"6048",6127,67,22,45,3.76173190136739e-06,"secrets",0.533231242712038
"6049",6128,88,48,40,3.68393326186503e-06,"determined",0.478503310159745
"6050",6129,59,9,50,3.76882054760963e-06,"participation",0.538217794609521
"6051",6130,54,13,41,3.51525974254238e-06,"magnet",0.359848883194249
"6052",6131,47,6,41,3.54088840890179e-06,"fertilizer",0.377877526534224
"6053",6132,52,13,39,3.65432964976905e-06,"indigenous",0.457678466737593
"6054",6133,93,57,36,3.64920885152099e-06,"slide",0.454076209642532
"6055",6134,49,16,33,3.59498858591124e-06,"ram",0.415934629555289
"6056",6135,73,28,45,3.7146964535793e-06,"privacy",0.500143867012678
"6057",6136,79,36,43,3.70893742651668e-06,"dancer",0.496092643923613
"6058",6137,32,6,26,3.39525140139002e-06,"ladybug",0.275428275812039
"6059",6138,43,10,33,3.66898424171268e-06,"New Zealand",0.46798732977945
"6060",6139,51,20,31,3.58610599094867e-06,"orbit",0.409686113371581
"6061",6140,42,3,39,3.5672116176948e-06,"discus",0.396394750030654
"6062",6141,35,7,28,3.56662636378876e-06,"linguistics",0.395983049562617
"6063",6142,44,14,30,3.54024909192611e-06,"trombone",0.37742779506657
"6064",6143,27,3,24,3.26392062145049e-06,"pepperoni",0.183042829067146
"6065",6144,40,5,35,3.6411302068162e-06,"firefly",0.448393237223656
"6066",6145,36,6,30,3.59990640243354e-06,"resort",0.419394097904072
"6067",6146,97,61,36,3.66798836514091e-06,"educated",0.467286774265893
"6068",6147,58,27,31,3.64685331261921e-06,"handicap",0.452419191281211
"6069",6149,54,23,31,3.49231516048934e-06,"ritual",0.343708375505797
"6070",6150,39,10,29,3.59665654807291e-06,"violet",0.417107967820169
"6071",6151,43,15,28,3.49013339289828e-06,"moss",0.342173597644225
"6072",6152,47,8,39,3.58766274535129e-06,"lodge",0.410781221852808
"6073",6153,29,2,27,3.29756573697297e-06,"subsequent",0.206710692988757
"6074",6154,64,20,44,3.65629376126596e-06,"fatty",0.459060133077976
"6075",6155,65,31,34,3.69431740097382e-06,"shark",0.485808096829471
"6076",6156,42,4,38,3.73876501114152e-06,"grandchildren",0.517075042201884
"6077",6157,41,17,24,3.54957334128438e-06,"yacht",0.383986995757537
"6078",6158,54,16,38,3.5359428591634e-06,"studying",0.374398549083612
"6079",6159,37,10,27,3.52554610709199e-06,"foliage",0.367084889747582
"6080",6160,33,9,24,3.54433968951584e-06,"acceleration",0.380305351157803
"6081",6161,52,18,34,3.62380550311104e-06,"petty",0.436206067603092
"6082",6162,49,17,32,3.52685168530608e-06,"vitamin",0.368003306790598
"6083",6163,56,20,36,3.59852028845739e-06,"psychologist",0.418419027482767
"6084",6164,44,11,33,3.61874364458147e-06,"lure",0.432645272016343
"6085",6165,54,12,42,3.63662811840861e-06,"wrestling",0.445226215379949
"6086",6166,28,3,25,3.31511127170983e-06,"slumber",0.219053207559903
"6087",6167,42,9,33,3.54855307748266e-06,"referee",0.383269284896739
"6088",6168,47,8,39,3.6235691431346e-06,"voltage",0.436039798720616
"6089",6169,41,7,34,3.55233477202892e-06,"skating",0.385929541237787
"6090",6170,57,24,33,3.56577427222547e-06,"bleach",0.395383640499655
"6091",6171,41,5,36,3.60668390661574e-06,"monotony",0.424161775001373
"6092",6172,43,12,31,3.66121999172564e-06,"satellite",0.462525520262885
"6093",6173,36,2,34,3.75151467404965e-06,"provision",0.526043871170664
"6094",6174,41,2,39,3.53874572696453e-06,"wheelbarrow",0.376370243716769
"6095",6175,43,17,26,3.57072717858992e-06,"juvenile",0.398867793014213
"6096",6176,43,13,30,3.47065560684413e-06,"sunburn",0.328471828972463
"6097",6177,38,5,33,3.56034065339372e-06,"strenuous",0.39156132783659
"6098",6178,40,7,33,3.73640415936511e-06,"physician",0.515414286466157
"6099",6179,101,67,34,3.67426872866628e-06,"awkward",0.471704734703492
"6100",6180,58,16,42,3.5700515515444e-06,"opposition",0.398392519004102
"6101",6181,42,6,36,3.59813184994351e-06,"thrive",0.418145778015628
"6102",6182,43,12,31,3.65708267201088e-06,"shepherd",0.459615097204784
"6103",6183,41,10,31,3.61945092929403e-06,"slob",0.433142815807486
"6104",6184,26,6,20,3.44481916421797e-06,"ubiquitous",0.310297024136799
"6105",6185,49,19,30,3.66164898700481e-06,"dope",0.462827299636581
"6106",6186,54,18,36,3.65094084745639e-06,"permanent",0.45529459286028
"6107",6187,38,13,25,3.5837669691366e-06,"raven",0.408040714058842
"6108",6188,56,19,37,3.59861093617864e-06,"cuisine",0.418482794181083
"6109",6189,50,12,38,3.63955320844813e-06,"retro",0.447283888000141
"6110",6190,49,12,37,3.58794593683062e-06,"punctual",0.410980434644699
"6111",6191,34,10,24,3.41298093167553e-06,"hanger",0.287900223186135
"6112",6192,47,11,36,3.43628441438841e-06,"immortal",0.304293201756217
"6113",6193,36,3,33,3.42880262783433e-06,"myriad",0.299030092882833
"6114",6194,50,19,31,3.61810208836853e-06,"squint",0.432193965343432
"6115",6195,42,9,33,3.67320251834765e-06,"federal",0.470954702482134
"6116",6196,61,20,41,3.63586122644871e-06,"instinct",0.444686740503204
"6117",6197,62,23,39,3.60956100519055e-06,"wobble",0.426185687729868
"6118",6198,82,49,33,3.64850320156156e-06,"helmet",0.453579815828549
"6119",6199,35,7,28,3.54647657552222e-06,"carving",0.381808556791949
"6120",6200,36,6,30,3.54320943910995e-06,"fig",0.379510269542278
"6121",6201,35,10,25,3.55868086817578e-06,"vein",0.39039374169319
"6122",6202,45,9,36,3.59993232127236e-06,"abbey",0.419412330671021
"6123",6203,79,39,40,3.5784448794243e-06,"grumpy",0.404296857242385
"6124",6204,49,13,36,3.75275358294148e-06,"redhead",0.526915389267954
"6125",6205,46,12,34,3.6012157704441e-06,"guideline",0.420315180902782
"6126",6206,49,13,36,3.57267900908175e-06,"rapper",0.400240820205867
"6127",6207,35,6,29,3.56991135910095e-06,"cocoa",0.398293899765532
"6128",6208,39,15,24,3.56877747958659e-06,"floss",0.397496265231287
"6129",6209,32,5,27,3.45214464486062e-06,"mittens",0.31545017865323
"6130",6210,40,6,34,3.58381834341581e-06,"cramp",0.408076853612251
"6131",6211,55,13,42,3.63545146854062e-06,"veil",0.444398493776782
"6132",6212,60,17,43,3.65510435322928e-06,"cheater",0.458223436662403
"6133",6213,41,6,35,3.53157225596836e-06,"assets",0.371324021323217
"6134",6214,43,5,38,3.71748593860944e-06,"chances",0.502106147453078
"6135",6215,59,11,48,3.67010188202825e-06,"enclose",0.468773540749194
"6136",6216,45,12,33,3.65202084573499e-06,"vivid",0.456054324307074
"6137",6217,58,16,42,3.6291712787385e-06,"dummy",0.439980655545876
"6138",6218,40,10,30,3.58893745917584e-06,"majesty",0.411677927150738
"6139",6219,37,5,32,3.56562170179993e-06,"dissertation",0.395276313893275
"6140",6220,57,21,36,3.66540698846496e-06,"parrot",0.465470888930152
"6141",6221,68,30,38,3.74537446253876e-06,"skills",0.521724501531633
"6142",6222,82,43,39,3.72158107650454e-06,"explode",0.504986897450112
"6143",6223,43,18,25,3.51532152888364e-06,"icing",0.359892347176896
"6144",6224,35,7,28,3.56337280362609e-06,"pantry",0.393694312609423
"6145",6225,55,20,35,3.70146911309099e-06,"scrape",0.490839012805447
"6146",6226,36,5,31,3.42889668391402e-06,"termite",0.2990962572119
"6147",6227,62,27,35,3.47993123655877e-06,"carbon",0.334996827875394
"6148",6228,116,84,32,3.7303411023904e-06,"tears",0.511149191661222
"6149",6229,37,7,30,3.56620662601191e-06,"interval",0.395687782435997
"6150",6230,96,59,37,3.64746519406339e-06,"pasta",0.452849623055099
"6151",6231,85,36,49,3.80109623615451e-06,"video game",0.560922326681827
"6152",6232,74,30,44,3.73385109401837e-06,"runner",0.51361831690947
"6153",6233,53,24,29,3.53483045185738e-06,"shore",0.373616019306691
"6154",6234,50,8,42,3.56961826502274e-06,"dynamic",0.398087720929415
"6155",6235,37,6,31,3.64664053240952e-06,"altruism",0.45226950973101
"6156",6236,35,6,29,3.40825820964196e-06,"tulip",0.284577995258117
"6157",6237,49,12,37,3.44731299188847e-06,"membrane",0.31205132258496
"6158",6238,42,7,35,3.53716856730524e-06,"array",0.375260781031945
"6159",6239,43,8,35,3.58574594272847e-06,"panther",0.409432835231541
"6160",6240,41,7,34,3.52517326226584e-06,"ferocious",0.366822609756203
"6161",6241,52,23,29,3.53088642903801e-06,"champagne",0.370841572141244
"6162",6242,62,15,47,3.66229266845631e-06,"quote",0.46328010132165
"6163",6243,36,5,31,3.36281400275751e-06,"intoxicated",0.252609987781721
"6164",6244,72,31,41,3.73868114284005e-06,"prisoner",0.517016044528205
"6165",6245,29,5,24,3.47441786128734e-06,"pram",0.331118410053179
"6166",6246,39,6,33,3.50391562571173e-06,"salvation",0.351868794278247
"6167",6247,85,50,35,3.63930154524744e-06,"spider",0.447106853970219
"6168",6248,82,53,29,3.63147764825507e-06,"blade",0.441603085400062
"6169",6249,55,20,35,3.50115538127582e-06,"seasoning",0.349927083314114
"6170",6250,30,6,24,3.48211238865946e-06,"spherical",0.336531172766467
"6171",6251,31,5,26,3.65280791344306e-06,"petroleum",0.456607991938246
"6172",6252,91,59,32,3.72921429184085e-06,"frustration",0.51035652983385
"6173",6253,57,7,50,3.77371306950047e-06,"inspiring",0.541659469293882
"6174",6254,47,10,37,3.61933302930936e-06,"contempt",0.43305987833647
"6175",6255,41,12,29,3.39690066783067e-06,"binary",0.276588462456719
"6176",6256,121,76,45,3.76041635329864e-06,"tools",0.532305812313299
"6177",6257,45,13,32,3.519255607054e-06,"duh",0.362659798717693
"6178",6258,46,2,44,3.58353580310621e-06,"distribution",0.407878098889727
"6179",6259,46,10,36,3.564338084596e-06,"instructor",0.394373345458239
"6180",6260,59,30,29,3.58905338716913e-06,"repetitive",0.411759477412268
"6181",6261,40,10,30,3.61993570994179e-06,"excrement",0.433483837742615
"6182",6262,60,25,35,3.64171364477268e-06,"canvas",0.448803660250786
"6183",6263,40,8,32,3.39103748791943e-06,"sincerely",0.272463972404233
"6184",6264,65,28,37,3.65760434230788e-06,"wrench",0.45998206939107
"6185",6265,50,7,43,3.66956317519962e-06,"vent",0.46839458410971
"6186",6266,51,11,40,3.62275525027805e-06,"losing",0.435467260773379
"6187",6267,51,16,35,3.66044269393941e-06,"insanity",0.461978725343458
"6188",6268,76,42,34,3.59020018956257e-06,"throat",0.412566202625462
"6189",6269,47,10,37,3.39769704094565e-06,"merchant",0.277148676033739
"6190",6271,30,3,27,3.4713664339694e-06,"procession",0.32897186469567
"6191",6272,69,31,38,3.63146446067306e-06,"arts",0.441593808514195
"6192",6273,87,46,41,3.60186432497461e-06,"beans",0.420771410585319
"6193",6274,51,7,44,3.70493868326479e-06,"moderate",0.493279703332583
"6194",6275,29,7,22,3.47455065373671e-06,"eclipse",0.331211823720292
"6195",6276,35,2,33,3.60943072058675e-06,"conformity",0.426094038222177
"6196",6277,35,8,27,3.40579734824618e-06,"mango",0.28284688713913
"6197",6278,48,7,41,3.4903161179308e-06,"exterminate",0.342302136694773
"6198",6279,88,54,34,3.7392123723059e-06,"killer",0.517389741170751
"6199",6280,31,9,22,3.31010741298555e-06,"phobia",0.21553321229372
"6200",6281,39,7,32,3.5329447094153e-06,"mince",0.372289482161039
"6201",6282,35,5,30,3.52859396116429e-06,"scramble",0.369228921483424
"6202",6283,68,26,42,3.5915670006824e-06,"cheeky",0.413527694333494
"6203",6284,46,4,42,3.66083130157196e-06,"piggy",0.462252093778174
"6204",6285,41,9,32,3.61947713033375e-06,"seatbelt",0.433161247090399
"6205",6286,59,16,43,3.66907847425041e-06,"fidget",0.468053618239015
"6206",6287,34,17,17,3.29251709639502e-06,"queer",0.203159195651557
"6207",6288,39,8,31,3.51339481774264e-06,"testimony",0.358536990347436
"6208",6289,34,8,26,3.55372341370671e-06,"denim",0.386906389786397
"6209",6290,73,42,31,3.5737387382558e-06,"necklace",0.400986293226117
"6210",6291,52,16,36,3.74943289827414e-06,"grime",0.52457943316815
"6211",6292,40,7,33,3.54846493406952e-06,"antenna",0.383207279869404
"6212",6293,51,5,46,3.67977155978157e-06,"obedience",0.475575735174075
"6213",6294,51,19,32,3.57591123157959e-06,"courageous",0.402514547047199
"6214",6295,46,10,36,3.5358803458091e-06,"elevated",0.374354573679164
"6215",6296,46,12,34,3.69467228256854e-06,"nudity",0.486057740474962
"6216",6297,60,26,34,3.67166502665629e-06,"wrinkles",0.469873144473889
"6217",6298,36,8,28,3.58375412579694e-06,"sprout",0.408031679332383
"6218",6299,35,11,24,3.54847752571759e-06,"archery",0.38321613754186
"6219",6300,132,90,42,3.68584781871526e-06,"fluffy",0.479850116978441
"6220",6302,68,36,32,3.64662723447084e-06,"coke",0.45226015521407
"6221",6303,67,24,43,3.65684195129087e-06,"mixture",0.459445760730349
"6222",6304,71,26,45,3.75100808342242e-06,"helpless",0.525687506871033
"6223",6305,120,80,40,3.71203516039704e-06,"unhealthy",0.498271763917919
"6224",6306,40,5,35,3.43687491837422e-06,"increasing",0.304708595425233
"6225",6307,49,7,42,3.63105569313222e-06,"consumerism",0.441306258467724
"6226",6309,68,28,40,3.68602443834203e-06,"brat",0.479974361143672
"6227",6310,47,18,29,3.6372498026792e-06,"isolation",0.445663543012503
"6228",6311,33,5,28,3.53998591085607e-06,"sunflower",0.37724265872046
"6229",6312,42,6,36,3.56153259870788e-06,"bankrupt",0.392399809115653
"6230",6313,39,3,36,3.62422577476887e-06,"consumption",0.436501710291581
"6231",6314,51,6,45,3.69807441265333e-06,"caravan",0.488450989855745
"6232",6315,31,7,24,3.41196781831954e-06,"retribution",0.287187542350461
"6233",6316,31,2,29,3.49342537344717e-06,"heron",0.344489361654956
"6234",6317,70,28,42,3.73365592120493e-06,"ants",0.513481021390697
"6235",6318,42,11,31,3.64069275101666e-06,"stoop",0.448085506244753
"6236",6319,54,20,34,3.47410402857103e-06,"saxophone",0.330897642494251
"6237",6320,54,25,29,3.61487158168706e-06,"tummy",0.429921445503704
"6238",6321,52,23,29,3.6106688041826e-06,"ape",0.426964975759918
"6239",6322,79,43,36,3.60707419390909e-06,"unreal",0.424436325003832
"6240",6323,47,18,29,3.52099038417526e-06,"paddle",0.363880138377784
"6241",6324,76,29,47,3.70140060999082e-06,"covering",0.490790823877344
"6242",6325,130,89,41,3.75290850409067e-06,"confused",0.52702436950537
"6243",6326,71,40,31,3.72800477184611e-06,"Obama",0.50950568553739
"6244",6327,40,15,25,3.55352136199367e-06,"belongings",0.386764255263296
"6245",6328,128,80,48,3.78169056695105e-06,"arrogant",0.547271289053249
"6246",6329,57,22,35,3.51534624402831e-06,"weave",0.359909733197769
"6247",6330,69,33,36,3.58245742249353e-06,"bandage",0.407119505399999
"6248",6331,35,4,31,3.49568457738921e-06,"envision",0.346078612594982
"6249",6332,41,3,38,3.69465863201569e-06,"canon",0.486048137909416
"6250",6333,39,9,30,3.63551755227874e-06,"speck",0.444444980789741
"6251",6334,58,12,46,3.62673630000363e-06,"insert",0.438267754744257
"6252",6335,41,21,20,3.45394509608875e-06,"inhale",0.316716717168649
"6253",6336,45,11,34,3.58563022829708e-06,"dock",0.409351435201452
"6254",6337,40,6,34,3.60569555670137e-06,"reservation",0.423466514161364
"6255",6338,54,14,40,3.70268889267386e-06,"trolley",0.491697074272423
"6256",6339,34,3,31,3.52604335622911e-06,"surmount",0.36743468271841
"6257",6340,45,14,31,3.56131697501736e-06,"thorn",0.392248127301335
"6258",6341,67,22,45,3.75279583289551e-06,"graduation",0.526945110258564
"6259",6342,42,9,33,3.47351272868739e-06,"tack",0.330481688946003
"6260",6343,35,4,31,3.62254527275955e-06,"remaining",0.435319550793571
"6261",6344,44,19,25,3.5843321672306e-06,"clarinet",0.408438306142265
"6262",6345,30,4,26,3.60792010621717e-06,"taut",0.425031387231623
"6263",6346,52,15,37,3.68240033583491e-06,"screwdriver",0.477424963894045
"6264",6347,52,6,46,3.82222086321036e-06,"trusting",0.57578257580829
"6265",6348,42,12,30,3.62910542551261e-06,"flush",0.439934330688168
"6266",6349,56,11,45,3.49633234736761e-06,"stomp",0.346534290379503
"6267",6350,53,20,33,3.67115281540709e-06,"casino",0.469512826313086
"6268",6351,36,5,31,3.68624183958213e-06,"simplicity",0.480127293386204
"6269",6352,61,27,34,3.82559861054258e-06,"grandfather",0.57815867299147
"6270",6353,65,41,24,3.60372048102461e-06,"spoiled",0.422077135001078
"6271",6354,72,33,39,3.70977674563545e-06,"snobby",0.496683068131745
"6272",6355,76,39,37,3.68792756910254e-06,"ballet",0.48131313020912
"6273",6356,95,64,31,3.57493967289302e-06,"sly",0.401831098099901
"6274",6357,63,27,36,3.77993233921113e-06,"bliss",0.546034452910901
"6275",6358,69,33,36,3.56950358913586e-06,"sponge",0.398007051469864
"6276",6359,52,8,44,3.61666268833771e-06,"terrorism",0.431181410518487
"6277",6360,57,12,45,3.6431066956658e-06,"peppermint",0.449783610489091
"6278",6361,85,56,29,3.75775977393317e-06,"insane",0.530437025182021
"6279",6362,59,14,45,3.73781472399976e-06,"dates",0.516406556853912
"6280",6363,45,12,33,3.59157990008225e-06,"moisture",0.413536768495837
"6281",6364,50,22,28,3.4709206269871e-06,"eerie",0.328658259025767
"6282",6365,56,15,41,3.66749062956144e-06,"outdoor",0.466936639104199
"6283",6366,33,4,29,3.59212175855913e-06,"reaper",0.413917942181718
"6284",6367,36,7,29,3.54606156672092e-06,"eel",0.38151661629233
"6285",6368,49,22,27,3.58054617651377e-06,"skull",0.405775027633541
"6286",6369,36,4,32,3.5563901217708e-06,"empathize",0.388782302013159
"6287",6370,37,2,35,3.54357355218444e-06,"especially",0.379766407129125
"6288",6371,54,13,41,3.60775089201641e-06,"waffle",0.424912352458967
"6289",6372,50,18,32,3.54521927181196e-06,"funds",0.380924098746245
"6290",6373,41,10,31,3.5788675031673e-06,"dwell",0.404594154519686
"6291",6374,34,5,29,3.58516744524553e-06,"caboose",0.409025887610988
"6292",6375,48,4,44,3.7703409896391e-06,"intensity",0.539287358928013
"6293",6376,55,10,45,3.7370324972346e-06,"butler",0.515856294613873
"6294",6377,43,14,29,3.5599604132402e-06,"vanish",0.391293845556588
"6295",6378,51,15,36,3.56735159817352e-06,"beige",0.396493220161327
"6296",6379,89,44,45,3.67891869221798e-06,"focused",0.474975780228918
"6297",6380,44,8,36,3.57716481071432e-06,"opulent",0.403396385017293
"6298",6381,57,23,34,3.74536043476144e-06,"whine",0.521714633605199
"6299",6382,50,10,40,3.60375944184974e-06,"staple",0.42210454223369
"6300",6383,46,19,27,3.53545531361256e-06,"his",0.374055582160375
"6301",6384,38,4,34,3.68599726499003e-06,"confrontation",0.479955245881698
"6302",6385,51,15,36,3.6410506615789e-06,"pedal",0.448337280636123
"6303",6386,42,6,36,3.65586601982211e-06,"veranda",0.458759235722462
"6304",6387,63,33,30,3.44427337886663e-06,"slope",0.309913088066867
"6305",6388,66,25,41,3.69625643148619e-06,"cloak",0.487172119796666
"6306",6389,37,7,30,3.35311672199309e-06,"livestock",0.245788375848527
"6307",6390,39,11,28,3.55039249589042e-06,"terrific",0.384563235114885
"6308",6391,90,51,39,3.78181928198379e-06,"pill",0.547361834436502
"6309",6392,42,8,34,3.56164676299734e-06,"segment",0.392480118688849
"6310",6393,45,5,40,3.54935916320308e-06,"cycling",0.383836330865937
"6311",6394,123,87,36,3.61553813669627e-06,"poop",0.430390337733948
"6312",6395,62,27,35,3.54896866970458e-06,"vanilla",0.383561635807197
"6313",6396,52,21,31,3.7246028642196e-06,"crow",0.507112592646262
"6314",6397,45,10,35,3.74557086245515e-06,"trampoline",0.521862660263532
"6315",6398,55,20,35,3.61960814122263e-06,"pushy",0.433253407507805
"6316",6399,35,7,28,3.31997596337403e-06,"sweetie",0.22247530489976
"6317",6400,78,42,36,3.67774157245519e-06,"sailor",0.474147728075353
"6318",6401,62,20,42,3.57427522634098e-06,"piercing",0.401363689076848
"6319",6402,43,8,35,3.57712642280203e-06,"gourmet",0.403369380803748
"6320",6403,52,20,32,3.55249882767539e-06,"spade",0.386044947193628
"6321",6404,49,11,38,3.72357656976679e-06,"moth",0.506390639486779
"6322",6405,55,11,44,3.73308446103593e-06,"pathway",0.513079024212017
"6323",6406,36,4,32,3.60411012718905e-06,"salamander",0.422351233997448
"6324",6407,95,53,42,3.82678442957951e-06,"unnecessary",0.578992844703049
"6325",6408,32,4,28,3.40035431691982e-06,"pondering",0.279017953198709
"6326",6409,45,13,32,3.5909737284362e-06,"bleed",0.413110353314646
"6327",6410,54,20,34,3.61782720533702e-06,"blink",0.432000597180386
"6328",6411,36,4,32,3.6483168490217e-06,"affordable",0.453448724985606
"6329",6412,52,17,35,3.68742440779964e-06,"curl",0.480959178288825
"6330",6413,47,3,44,3.63167547347969e-06,"documentary",0.441742246773823
"6331",6414,50,12,38,3.70584485851084e-06,"philosopher",0.493917157895589
"6332",6415,52,23,29,3.61863888516973e-06,"dreary",0.432571578362357
"6333",6416,61,26,35,3.8081021180664e-06,"smiling",0.565850657500924
"6334",6417,65,31,34,3.78117579442503e-06,"hopeless",0.546909169146477
"6335",6418,32,10,22,3.51734932554827e-06,"tartan",0.361318813241102
"6336",6419,41,6,35,3.62661792492176e-06,"transit",0.438184483063185
"6337",6420,55,12,43,3.81263201238343e-06,"criticism",0.569037239583043
"6338",6421,41,14,27,3.65196749748927e-06,"upbeat",0.456016796154757
"6339",6422,40,2,38,3.53868311446578e-06,"fanfare",0.376326198568543
"6340",6423,35,2,33,3.63907640240907e-06,"elope",0.446948475852663
"6341",6424,87,54,33,3.68678545489402e-06,"thread",0.480509702928506
"6342",6425,88,46,42,3.73210920151524e-06,"shorts",0.512392971890139
"6343",6426,54,15,39,3.68058418232142e-06,"flamboyant",0.476147379509192
"6344",6427,40,7,33,3.46341936467035e-06,"vulture",0.323381449807069
"6345",6428,67,26,41,3.68472056921563e-06,"bloody",0.479057146368932
"6346",6429,49,20,29,3.43565870166458e-06,"oats",0.303853040283393
"6347",6430,33,5,28,3.54791099000908e-06,"bassoon",0.382817604505267
"6348",6431,45,8,37,3.52983949819802e-06,"scanner",0.370105102187983
"6349",6432,40,13,27,3.46339537428914e-06,"verse",0.323364573625515
"6350",6433,56,17,39,3.56786071071785e-06,"selfless",0.396851358519096
"6351",6434,56,21,35,3.56121551407927e-06,"mineral",0.39217675397897
"6352",6435,42,4,38,3.64657404368596e-06,"louse",0.452222737828547
"6353",6436,58,16,42,3.68990074167005e-06,"arrival",0.482701170615472
"6354",6437,43,2,41,3.4572288927533e-06,"becoming",0.319026724175488
"6355",6438,36,10,26,3.52863131448574e-06,"congregation",0.369255197907659
"6356",6439,35,6,29,3.45641631843272e-06,"falcon",0.318455113760513
"6357",6440,74,40,34,3.82583278815216e-06,"workout",0.578323406674528
"6358",6441,47,17,30,3.66045609282917e-06,"mattress",0.461988150875058
"6359",6442,35,3,32,3.61427058598169e-06,"prospect",0.429498671369887
"6360",6443,43,2,41,3.47087243849614e-06,"fortify",0.328624360534739
"6361",6444,39,11,28,3.38941688471915e-06,"neutron",0.271323949092694
"6362",6445,43,6,37,3.62730197651685e-06,"intake",0.438665683374629
"6363",6446,65,31,34,3.53170945332669e-06,"ash",0.371420533650701
"6364",6447,30,4,26,3.50524208954491e-06,"discourse",0.352801903438764
"6365",6448,50,12,38,3.54209245569728e-06,"ornate",0.378724520674926
"6366",6449,43,14,29,3.48213663904172e-06,"cosmos",0.336548231847361
"6367",6450,59,27,32,3.65302141401153e-06,"madness",0.45675818022927
"6368",6451,46,10,36,3.62605246172702e-06,"seeker",0.437786704493014
"6369",6452,30,6,24,3.48185778003712e-06,"sob",0.336352066761532
"6370",6453,29,4,25,3.28242295332723e-06,"lass",0.196058408484569
"6371",6454,38,15,23,3.58656901634758e-06,"envy",0.410011831442795
"6372",6455,52,10,42,3.70690262337499e-06,"arena",0.494661249109925
"6373",6456,41,4,37,3.67501139253532e-06,"continental",0.472227166180364
"6374",6457,32,9,23,3.40763104897107e-06,"weep",0.284136815218005
"6375",6458,100,52,48,3.70497986343444e-06,"India",0.493308671776781
"6376",6459,54,18,36,3.63842761712099e-06,"introduction",0.446492083842285
"6377",6460,36,8,28,3.54151541444584e-06,"sapphire",0.378318597449398
"6378",6461,101,58,43,3.72140103306093e-06,"crack",0.504860244779812
"6379",6462,73,28,45,3.7312875927225e-06,"results",0.51181500612003
"6380",6463,71,29,42,3.71936636874542e-06,"successful",0.503428947624259
"6381",6464,61,22,39,3.63584800700992e-06,"rational",0.444677441207492
"6382",6465,29,4,25,3.53035042258295e-06,"feral",0.370464515096185
"6383",6466,53,4,49,3.60355166051661e-06,"compatible",0.421958377174018
"6384",6467,34,7,27,3.56129160924084e-06,"tampon",0.392230283589472
"6385",6468,57,25,32,3.67413373111955e-06,"incredible",0.471609769847043
"6386",6469,50,11,39,3.64371732041028e-06,"tails",0.450213158229833
"6387",6470,48,5,43,3.53989819252798e-06,"meager",0.377180952721819
"6388",6471,53,8,45,3.68905678196199e-06,"mayhem",0.482107481956197
"6389",6472,35,6,29,3.44504464777864e-06,"proclaim",0.310455641937553
"6390",6473,155,120,35,3.74275309432112e-06,"fur",0.519880483899351
"6391",6474,67,26,41,3.83141762452107e-06,"passionate",0.582252094246296
"6392",6475,34,6,28,3.56504967896728e-06,"placid",0.394873920905379
"6393",6476,43,4,39,3.68592933336282e-06,"primal",0.479907458959769
"6394",6477,49,19,30,3.61021256931608e-06,"granite",0.426644034530579
"6395",6478,60,24,36,3.68745160219772e-06,"incomplete",0.480978308355797
"6396",6479,41,10,31,3.59624264568379e-06,"purity",0.416816805633015
"6397",6480,36,7,29,3.522590372056e-06,"splinter",0.365005659715707
"6398",6481,46,10,36,3.53260773570442e-06,"jagged",0.372052435926827
"6399",6482,55,16,39,3.69476783926282e-06,"softly",0.48612496042062
"6400",6483,41,8,33,3.61025167064396e-06,"oasis",0.426671540600719
"6401",6484,37,12,25,3.63555720367482e-06,"cello",0.444472873808746
"6402",6485,108,62,46,3.83409120536159e-06,"hunting",0.584132841170009
"6403",6486,62,21,41,3.69940143684752e-06,"asleep",0.489384493205666
"6404",6487,56,19,37,3.71781764104471e-06,"puppet",0.502339485575968
"6405",6488,46,15,31,3.42957874484277e-06,"convict",0.299576057176837
"6406",6489,46,13,33,3.54170355941208e-06,"straightforward",0.378450949185727
"6407",6490,26,5,21,3.59606159334297e-06,"entirely",0.416689443247759
"6408",6491,56,6,50,3.67856683036289e-06,"looming",0.474728260837879
"6409",6492,38,5,33,3.72310521867658e-06,"appetite",0.5060590646567
"6410",6493,51,16,35,3.47313874494658e-06,"mermaid",0.330218607778084
"6411",6494,33,7,26,3.60875339222819e-06,"iris",0.425617567412917
"6412",6495,35,6,29,3.64815713342405e-06,"Cheddar",0.45333637206386
"6413",6497,77,38,39,3.63273090545818e-06,"poem",0.442484696905365
"6414",6498,163,130,33,3.81328625195908e-06,"ice cream",0.569497468445631
"6415",6499,38,8,30,3.6284338590934e-06,"bigotry",0.439461913150662
"6416",6500,36,2,34,3.68322768608587e-06,"conglomerate",0.478006968528333
"6417",6501,59,31,28,3.60290249825259e-06,"knitting",0.421501719977598
"6418",6502,109,73,36,3.85184272155799e-06,"feelings",0.596620254668647
"6419",6503,74,35,39,3.665366683283e-06,"audience",0.465442536001432
"6420",6504,41,16,25,3.70440342435053e-06,"torch",0.492903172149707
"6421",6505,34,8,26,3.65142076782076e-06,"pragmatic",0.455632195799094
"6422",6506,60,28,32,3.62727566206849e-06,"massive",0.438647172313715
"6423",6507,50,3,47,3.6036815210419e-06,"clamp",0.422049728361067
"6424",6508,37,9,28,3.43641430785461e-06,"anywhere",0.304384576115753
"6425",6509,44,7,37,3.49868099726403e-06,"observation",0.348186462627532
"6426",6510,60,18,42,3.56943988349348e-06,"mushy",0.397962237343017
"6427",6511,40,3,37,3.4035485397075e-06,"recommendation",0.281264948909677
"6428",6512,51,8,43,3.65100749551839e-06,"submission",0.455341476850349
"6429",6513,56,18,38,3.71402042711235e-06,"generosity",0.499668312027099
"6430",6514,35,4,31,3.43661507161906e-06,"playboy",0.304525804623473
"6431",6515,71,31,40,3.59506613124148e-06,"microscope",0.415989179295882
"6432",6516,32,7,25,3.40081687621367e-06,"amble",0.279343343385438
"6433",6517,42,14,28,3.26424024808226e-06,"eraser",0.183267672391623
"6434",6518,26,2,24,3.33430028041465e-06,"madly",0.232551834025097
"6435",6519,61,24,37,3.60702215072303e-06,"acne",0.42439971490377
"6436",6520,44,12,32,3.66294999340669e-06,"donor",0.463742500610117
"6437",6521,52,8,44,3.53007624964699e-06,"negate",0.370271646454233
"6438",6522,35,5,30,3.42330931311299e-06,"ottoman",0.295165786778234
"6439",6523,106,55,51,3.6952593517776e-06,"crunchy",0.486470717929104
"6440",6524,41,8,33,3.57440298534137e-06,"mortar",0.401453561933253
"6441",6525,39,8,31,3.5443899396036e-06,"supervisor",0.380340699891802
"6442",6526,54,10,44,3.62686783693602e-06,"register",0.438360285210218
"6443",6527,44,12,32,3.58597739399851e-06,"flex",0.409595651054248
"6444",6528,62,30,32,3.70734239160658e-06,"typing",0.494970606783415
"6445",6529,39,6,33,3.59235403367473e-06,"gulp",0.41408133754366
"6446",6530,48,14,34,3.67555170031022e-06,"gala",0.472607249015376
"6447",6531,48,13,35,3.65662800391991e-06,"dignity",0.459295258133356
"6448",6532,58,20,38,3.64095786319465e-06,"indecisive",0.448272001040657
"6449",6533,59,15,44,3.69118103028245e-06,"panties",0.483601797532281
"6450",6534,47,7,40,3.55985902958243e-06,"railing",0.39122252659754
"6451",6535,65,17,48,3.79662252460211e-06,"survival",0.557775266711834
"6452",6536,37,5,32,3.50344914568393e-06,"courier",0.351540646027042
"6453",6537,34,7,27,3.56889210882266e-06,"peril",0.397576901874036
"6454",6538,98,58,40,3.81221051026438e-06,"untrustworthy",0.568740731319021
"6455",6539,66,23,43,3.69352598764885e-06,"squish",0.485251372247305
"6456",6540,61,24,37,3.6725010466628e-06,"sterile",0.470461247901163
"6457",6541,33,5,28,3.47839395594266e-06,"numeral",0.333915418349338
"6458",6542,47,4,43,3.52486261847944e-06,"mediate",0.366604085469681
"6459",6543,41,6,35,3.67240663824224e-06,"tango",0.470394835715735
"6460",6544,46,12,34,3.5992844622489e-06,"speeding",0.418956590247206
"6461",6545,53,27,26,3.53328174741982e-06,"lime",0.372526573623012
"6462",6546,82,45,37,3.66668377785763e-06,"athlete",0.466369054299267
"6463",6547,56,20,36,3.75932783218361e-06,"ideal",0.531540085424677
"6464",6548,41,7,34,3.56803893444085e-06,"bonnet",0.39697673109571
"6465",6549,128,80,48,3.77677735142158e-06,"muscles",0.543815057301232
"6466",6550,41,12,29,3.51366640548413e-06,"chord",0.358728040418404
"6467",6551,35,11,24,3.48379859463565e-06,"quench",0.337717344755136
"6468",6552,55,8,47,3.7238954925969e-06,"curves",0.506614987717634
"6469",6553,72,22,50,3.793900167311e-06,"neutral",0.555860207693264
"6470",6555,44,9,35,3.50851340778399e-06,"plead",0.355103132420277
"6471",6556,76,31,45,3.76437993133771e-06,"childish",0.535094015718598
"6472",6557,64,34,30,3.78743405130458e-06,"killing",0.551311578527793
"6473",6558,38,12,26,3.43301669476019e-06,"minimum",0.301994504239691
"6474",6559,47,3,44,3.68001530886369e-06,"rapture",0.475747201968495
"6475",6560,39,5,34,3.52249110570996e-06,"tranquility",0.364935830192654
"6476",6561,43,12,31,3.49291287976695e-06,"shuttle",0.344128844816308
"6477",6562,29,5,24,3.43430180644275e-06,"Fahrenheit",0.302898523974937
"6478",6563,52,15,37,3.65099416571132e-06,"thankful",0.455332099915397
"6479",6564,80,29,51,3.72375682378438e-06,"confusing",0.506517440286637
"6480",6565,107,67,40,3.67494386523246e-06,"Japan",0.472179663682892
"6481",6566,58,12,46,3.66045609282917e-06,"ramp",0.461988150875058
"6482",6567,77,33,44,3.74721301032357e-06,"casual",0.523017839304694
"6483",6568,26,4,22,3.46744244912395e-06,"iguana",0.326211513366498
"6484",6569,31,5,26,3.68648644663258e-06,"convenience",0.480299363723739
"6485",6570,45,12,33,3.52707559581125e-06,"bracelet",0.368160818015767
"6486",6571,25,4,21,3.32015232858884e-06,"indigo",0.222599370097332
"6487",6572,60,17,43,3.6257106392853e-06,"bleak",0.437546247389204
"6488",6573,33,9,24,3.50666792906712e-06,"beneficial",0.353804919040334
"6489",6574,60,25,35,3.53665566766754e-06,"oh",0.374899978620003
"6490",6575,35,5,30,3.55273862857183e-06,"synopsis",0.386213636612501
"6491",6576,70,37,33,3.70034598234935e-06,"despair",0.490048939561636
"6492",6577,52,16,36,3.59955653463493e-06,"manic",0.419147981244364
"6493",6578,51,8,43,3.69827956034853e-06,"shooter",0.488595302266575
"6494",6579,50,10,40,3.58865411116215e-06,"manuscript",0.411478604243794
"6495",6580,76,36,40,3.70155132015828e-06,"sneak",0.490896841873704
"6496",6581,32,5,27,3.32289942912588e-06,"pennies",0.22453183490478
"6497",6582,53,18,35,3.56737705034996e-06,"cucumber",0.396511124651748
"6498",6583,38,7,31,3.51744830230358e-06,"prism",0.361388439049773
"6499",6584,66,30,36,3.6400963897524e-06,"mob",0.447665992237103
"6500",6585,32,2,30,3.63563650906182e-06,"bagpipe",0.444528661672116
"6501",6586,48,7,41,3.60678797496889e-06,"fusion",0.424234982525932
"6502",6587,59,21,38,3.63801728058208e-06,"rebellion",0.44620343007445
"6503",6588,42,10,32,3.48568082317838e-06,"rotation",0.339041410026634
"6504",6589,47,9,38,3.70768603314671e-06,"nursing",0.495212343543223
"6505",6590,53,13,40,3.5716326647237e-06,"cockroach",0.399504762816943
"6506",6591,50,12,38,3.57025548748268e-06,"stereotype",0.39853597899706
"6507",6592,61,29,32,3.55350873452447e-06,"bun",0.386755372392246
"6508",6593,43,12,31,3.52795907567472e-06,"carpentry",0.368782307371995
"6509",6594,44,18,26,3.53413086886607e-06,"howl",0.373123893338838
"6510",6595,45,8,37,3.79894465317535e-06,"bore",0.559408782371576
"6511",6596,50,18,32,3.54239359535238e-06,"squeak",0.378936359221701
"6512",6597,44,8,36,3.71622877104315e-06,"menace",0.501221785178685
"6513",6598,82,51,31,3.63476434005401e-06,"celebrity",0.443915129007033
"6514",6599,59,22,37,3.52177159198163e-06,"plumber",0.364429683824977
"6515",6600,46,14,32,3.44776464179449e-06,"flimsy",0.312369038495573
"6516",6601,62,23,39,3.74925014997001e-06,"refreshing",0.524450877747047
"6517",6602,37,9,28,3.517534911534e-06,"malicious",0.361449364846819
"6518",6603,33,2,31,3.65741705892465e-06,"processor",0.459850323740618
"6519",6604,51,22,29,3.5598843749555e-06,"prescription",0.391240355956472
"6520",6605,52,16,36,3.63143808579636e-06,"friction",0.441575254944592
"6521",6606,46,3,43,3.67720062071146e-06,"maintenance",0.473767192236502
"6522",6607,38,6,32,3.4723427896802e-06,"metro",0.329658688139231
"6523",6608,74,33,41,3.62446222041805e-06,"haughty",0.436668039441081
"6524",6609,70,17,53,3.65744381251943e-06,"immigration",0.459869143721792
"6525",6610,41,16,25,3.37281778689188e-06,"zebra",0.259647211399971
"6526",6611,40,13,27,3.47458687162096e-06,"dam",0.331237301414241
"6527",6612,49,11,38,3.48251256316407e-06,"slanted",0.336812677988638
"6528",6613,59,12,47,3.5155686959701e-06,"eureka",0.360066218387545
"6529",6614,81,38,43,3.76720198606889e-06,"spit",0.53707920751597
"6530",6615,63,23,40,3.72680992524019e-06,"thinker",0.508665163326755
"6531",6616,59,14,45,3.72426994998305e-06,"sketchy",0.506878402074292
"6532",6617,36,6,30,3.32857347326656e-06,"vehicles",0.228523276233528
"6533",6618,50,7,43,3.74098889300398e-06,"lovers",0.518639445607282
"6534",6619,64,39,25,3.61738224516446e-06,"cock",0.431687587204019
"6535",6620,49,13,36,3.60327898387533e-06,"abdomen",0.421766561109779
"6536",6621,41,5,36,3.57081643146889e-06,"mutter",0.39893057850213
"6537",6622,78,34,44,3.69368970051564e-06,"motorcycle",0.485366537072666
"6538",6623,34,4,30,3.59129613468797e-06,"poodle",0.413337151979944
"6539",6624,59,29,30,3.54692942319834e-06,"ignorance",0.382127115281321
"6540",6625,56,10,46,3.69795133496043e-06,"drawn",0.488364410093955
"6541",6626,38,10,28,3.54602384346432e-06,"crackle",0.381490079634929
"6542",6627,40,5,35,3.60252609129522e-06,"presence",0.421236934183049
"6543",6629,27,3,24,3.21879777902953e-06,"posterior",0.15130088740367
"6544",6630,61,19,42,3.6937715623915e-06,"spa",0.485424123313879
"6545",6631,42,6,36,3.67360733545913e-06,"tactful",0.471239473574725
"6546",6632,69,31,38,3.63170185180477e-06,"pudding",0.441760802769215
"6547",6633,33,10,23,3.3945368324219e-06,"lethargic",0.274925607866415
"6548",6634,40,21,19,3.5665754812202e-06,"siblings",0.395947255906095
"6549",6635,60,19,41,3.63080520367002e-06,"Buddhism",0.441130050111379
"6550",6636,58,13,45,3.66595791480314e-06,"mercy",0.465858441458958
"6551",6637,46,10,36,3.57972586459329e-06,"probe",0.405197974156221
"6552",6638,44,5,39,3.49934212368075e-06,"deviation",0.348651536080925
"6553",6639,55,25,30,3.62349036332738e-06,"freeze",0.43598438057958
"6554",6641,27,6,21,3.19045416114984e-06,"centimeter",0.131362394680277
"6555",6642,48,5,43,3.69056801532324e-06,"scaffolding",0.483170568380257
"6556",6643,31,6,25,3.51338247384287e-06,"tow",0.358528306955044
"6557",6644,59,28,31,3.6661191928672e-06,"stem",0.46597189350733
"6558",6645,47,8,39,3.55074547901332e-06,"progressive",0.384811543268674
"6559",6646,73,43,30,3.61472784714039e-06,"comfy",0.429820334550788
"6560",6647,60,21,39,3.58770135973882e-06,"tractor",0.410808385381756
"6561",6648,58,23,35,3.56356327819313e-06,"files",0.393828303117801
"6562",6649,44,7,37,3.60979554118055e-06,"senator",0.426350673517843
"6563",6650,47,4,43,3.58181583735691e-06,"version",0.406668178380549
"6564",6651,42,8,34,3.67557871986944e-06,"monotonous",0.472626256090878
"6565",6652,109,79,30,3.76116596144805e-06,"explosion",0.532833128787007
"6566",6653,52,7,45,3.70403295107713e-06,"execution",0.492642560441734
"6567",6654,35,13,22,3.60648879463932e-06,"summit",0.424024522278777
"6568",6655,56,17,39,3.69528666186279e-06,"compassionate",0.486489929376885
"6569",6656,28,2,26,3.44385822324467e-06,"consonant",0.309621044285347
"6570",6657,58,16,42,3.62274212596999e-06,"refresh",0.435458028397971
"6571",6658,36,5,31,3.46464331497072e-06,"serial",0.324242445190981
"6572",6659,36,7,29,3.43301669476019e-06,"infrequent",0.301994504239691
"6573",6660,35,3,32,3.66362097642826e-06,"educator",0.464214507752956
"6574",6661,58,29,29,3.7320117035887e-06,"obese",0.512324386372687
"6575",6662,36,3,33,3.66590415860168e-06,"bless",0.465820626327658
"6576",6663,66,20,46,3.71356528262089e-06,"vaccine",0.499348137828814
"6577",6664,28,10,18,3.30766584636554e-06,"adhesive",0.213815677203688
"6578",6665,51,8,43,3.5297024460838e-06,"hassle",0.370008692033368
"6579",6666,39,14,25,3.65239432710113e-06,"haunted",0.456317052076436
"6580",6667,39,7,32,3.49963603785206e-06,"curb",0.348858291816588
"6581",6668,38,8,30,3.39843603973451e-06,"inspect",0.27766852928737
"6582",6669,57,19,38,3.64014939173104e-06,"grid",0.447703276805708
"6583",6670,70,24,46,3.71884076295737e-06,"peanut",0.503059206992527
"6584",6671,55,21,34,3.61185555467266e-06,"nag",0.427799802707944
"6585",6672,96,57,39,3.74180077904292e-06,"nails",0.519210571846298
"6586",6673,37,7,30,3.40042369279212e-06,"anvil",0.27906675608375
"6587",6674,65,29,36,3.57225784557129e-06,"squash",0.399944550138149
"6588",6675,94,46,48,3.70233246945576e-06,"therapy",0.491446346162456
"6589",6676,38,5,33,3.54298347552507e-06,"fluorescent",0.379351314065531
"6590",6677,57,32,25,3.53994831675458e-06,"scales",0.377216212918009
"6591",6678,30,7,23,3.36917007233608e-06,"perspire",0.257081204109139
"6592",6679,47,5,42,3.5047261231771e-06,"crowbar",0.352438943716623
"6593",6680,43,10,33,3.46175282392487e-06,"envelop",0.322209111446168
"6594",6681,59,12,47,3.61008223767337e-06,"scope",0.42655235193308
"6595",6682,43,7,36,3.61579959792308e-06,"rim",0.430574264245747
"6596",6683,45,14,31,3.4101527066382e-06,"totally",0.285910690848862
"6597",6684,36,4,32,3.42634723973466e-06,"fallacy",0.297302834987733
"6598",6685,37,7,30,3.52932872167714e-06,"mommy",0.369745793295658
"6599",6686,53,8,45,3.63572903638638e-06,"transmission",0.444593750588962
"6600",6687,44,14,30,3.44618438464932e-06,"polar",0.311257396865209
"6601",6688,43,9,34,3.53200883002208e-06,"impediment",0.371631132032592
"6602",6689,49,18,31,3.49979526197717e-06,"ranch",0.348970299008944
"6603",6690,39,12,27,3.59403246848932e-06,"lyrics",0.415262042860797
"6604",6691,60,25,35,3.63583478766725e-06,"cape",0.444668141979402
"6605",6692,29,4,25,3.43957019130889e-06,"proxy",0.3066046017863
"6606",6693,54,14,40,3.59173470010811e-06,"dainty",0.413645663528305
"6607",6694,48,13,35,3.72027961621595e-06,"humanity",0.504071377187175
"6608",6695,45,7,38,3.60643676834414e-06,"vector",0.423987924060717
"6609",6696,79,37,42,3.69680300476148e-06,"Mexico",0.487556610136554
"6610",6697,37,4,33,3.49456071624516e-06,"serpent",0.345288025545092
"6611",6698,59,19,40,3.57492689274504e-06,"growl",0.401822107826023
"6612",6699,36,4,32,3.69018668654447e-06,"establish",0.48290232030011
"6613",6700,32,6,26,3.32357310697585e-06,"tonic",0.225005737741268
"6614",6701,35,8,27,3.6451650530736e-06,"pulp",0.45123157469648
"6615",6702,51,17,34,3.61768323565589e-06,"unwilling",0.431899320820684
"6616",6703,48,8,40,3.64216461127177e-06,"sticker",0.449120895414579
"6617",6704,42,8,34,3.55798447295576e-06,"grown",0.389903858182694
"6618",6705,63,24,39,3.7597377206966e-06,"keen",0.531828424025928
"6619",6706,40,2,38,3.6066578904658e-06,"pickax",0.424143473780319
"6620",6707,48,14,34,3.49120565296019e-06,"decent",0.342927885594791
"6621",6708,35,8,27,3.41016433581934e-06,"opposed",0.285918871468024
"6622",6709,64,31,33,3.60054152144483e-06,"pompous",0.419840876287792
"6623",6710,41,7,34,3.57130102496339e-06,"nursery",0.399271468783144
"6624",6711,52,8,44,3.613500036135e-06,"flare",0.428956623330133
"6625",6712,44,11,33,3.45549665853473e-06,"salute",0.317808173335972
"6626",6713,51,17,34,3.48682329476907e-06,"munch",0.339845088709935
"6627",6714,59,27,32,3.63698523020298e-06,"astronomy",0.445477427873134
"6628",6716,69,39,30,3.56838270190801e-06,"straw",0.39721855643966
"6629",6717,52,11,41,3.70149651504103e-06,"tourist",0.490858288876127
"6630",6719,39,10,29,3.41849955217656e-06,"cider",0.291782330797446
"6631",6720,56,18,38,3.68011010889446e-06,"civilization",0.475813889634543
"6632",6721,28,2,26,3.53781928819076e-06,"pike",0.375718534650269
"6633",6722,36,3,33,3.49723718262573e-06,"hippopotamus",0.347170802319735
"6634",6723,39,5,34,3.45383773179568e-06,"monologue",0.316641191094837
"6635",6724,78,32,46,3.61272981477534e-06,"spear",0.428414806366607
"6636",6725,36,5,31,3.44709909375765e-06,"rehearse",0.311900854626244
"6637",6726,67,29,38,3.76058604972999e-06,"weights",0.532425186314038
"6638",6727,54,22,32,3.60225356983329e-06,"superb",0.421045227280681
"6639",6728,39,5,34,3.75055789548695e-06,"postcard",0.525370819392619
"6640",6729,44,12,32,3.53214606130393e-06,"driveway",0.371727668223781
"6641",6730,34,7,27,3.34324046925723e-06,"loo",0.238840864978737
"6642",6731,58,11,47,3.73481331535643e-06,"glorious",0.514295197441399
"6643",6732,44,12,32,3.58087953563154e-06,"fossil",0.406009531159953
"6644",6733,58,18,40,3.568752007423e-06,"meditate",0.397478346680786
"6645",6734,49,9,40,3.55421601103229e-06,"observant",0.387252910411718
"6646",6735,41,12,29,3.49685807302139e-06,"fangs",0.346904115331521
"6647",6736,66,36,30,3.70973545876444e-06,"spelling",0.496654024627816
"6648",6737,52,13,39,3.62801261097184e-06,"resolution",0.439165583562739
"6649",6738,53,20,33,3.51307390453573e-06,"zip",0.358311241973744
"6650",6739,128,94,34,3.71193870846805e-06,"needle",0.498203914213885
"6651",6740,56,20,36,3.65739030572126e-06,"airy",0.459831504034771
"6652",6741,49,9,40,3.72569912744126e-06,"relevant",0.50788376576752
"6653",6742,41,11,30,3.51391333986921e-06,"micro",0.358901747933832
"6654",6743,28,5,23,3.45015560201765e-06,"onset",0.314050974203771
"6655",6744,32,6,26,3.5713647970572e-06,"throb",0.399316329655655
"6656",6745,65,29,36,3.53455558265382e-06,"trim",0.373422660870998
"6657",6746,45,12,33,3.75657400450789e-06,"neglect",0.529602888370059
"6658",6747,51,21,30,3.56132965804113e-06,"vine",0.392257049252588
"6659",6748,37,10,27,3.56428726729659e-06,"spent",0.394337597715706
"6660",6749,38,3,35,3.65567891440959e-06,"stature",0.458627615266606
"6661",6750,48,12,36,3.53664315977846e-06,"prose",0.374891179868327
"6662",6751,56,26,30,3.60154001851192e-06,"unreliable",0.420543275204932
"6663",6752,54,13,41,3.67407973487841e-06,"inspire",0.471571785858351
"6664",6753,40,9,31,3.5414401620563e-06,"metaphor",0.378265660692078
"6665",6754,37,6,31,3.32718912408419e-06,"cymbals",0.227549447267286
"6666",6755,59,20,39,3.67761984443668e-06,"wasted",0.474062097750336
"6667",6756,50,14,36,3.62626284603613e-06,"denial",0.437934700632188
"6668",6757,35,2,33,3.67724118657219e-06,"parenthood",0.473795728541298
"6669",6758,32,2,30,3.46350333362196e-06,"spar",0.323440518283709
"6670",6759,55,14,41,3.63514751428613e-06,"obsolete",0.444184675282716
"6671",6760,54,13,41,3.50461557871717e-06,"pierce",0.352361180534824
"6672",6761,42,12,30,3.5778175313059e-06,"conduct",0.403855545341174
"6673",6762,43,15,28,3.37615422272489e-06,"pharmacy",0.261994247754362
"6674",6763,62,17,45,3.61487158168706e-06,"crispy",0.429921445503704
"6675",6764,42,14,28,3.60525357551023e-06,"wellness",0.423155599767842
"6676",6765,34,6,28,3.39844758914128e-06,"mega",0.277676653788756
"6677",6766,52,9,43,3.66448019348455e-06,"supreme",0.4648189292879
"6678",6767,24,5,19,3.61467558286644e-06,"cuckoo",0.429783568925091
"6679",6768,37,8,29,3.40378023833269e-06,"climax",0.281427938735889
"6680",6769,41,7,34,3.67952784298719e-06,"stub",0.475404291092661
"6681",6770,42,6,36,3.76718779431155e-06,"household",0.537069224236783
"6682",6771,37,8,29,3.64793089359715e-06,"landlord",0.45317722226296
"6683",6772,71,44,27,3.66480250379307e-06,"everything",0.465045660461327
"6684",6773,43,13,30,3.69274854967301e-06,"prom",0.484704478710636
"6685",6774,42,7,35,3.503289588924e-06,"mason",0.351428404840675
"6686",6775,39,7,32,3.58802317862973e-06,"savor",0.411034770864445
"6687",6776,32,5,27,3.67820150659134e-06,"tee",0.47447127157872
"6688",6777,35,5,30,3.44969142510202e-06,"footwear",0.313724446091027
"6689",6778,41,7,34,3.76606698326736e-06,"newborn",0.536280782798446
"6690",6779,48,8,40,3.62228283508833e-06,"patent",0.435134937395941
"6691",6780,35,5,30,3.50883348830681e-06,"disposal",0.355328295037213
"6692",6781,25,2,23,3.54653946411789e-06,"conditioner",0.381852796162252
"6693",6782,42,12,30,3.53789438677677e-06,"scribble",0.375771363213545
"6694",6783,71,33,38,3.66936120090853e-06,"journal",0.46825250404956
"6695",6784,67,29,38,3.58271412090944e-06,"deceit",0.407300081483098
"6696",6785,46,11,35,3.5737387382558e-06,"astounding",0.400986293226117
"6697",6786,57,9,48,3.75416242759159e-06,"corset",0.52790644972198
"6698",6787,43,10,33,3.68923370926625e-06,"acute",0.482231942559058
"6699",6788,47,8,39,3.67998822403768e-06,"usage",0.475728148980678
"6700",6789,37,6,31,3.63926181213403e-06,"senile",0.447078903466654
"6701",6790,57,10,47,3.73694870664205e-06,"comforting",0.515797351605017
"6702",6791,38,8,30,3.62228283508833e-06,"derivative",0.435134937395941
"6703",6792,51,9,42,3.56046741816266e-06,"ravine",0.391650501294749
"6704",6793,67,30,37,3.65000803001767e-06,"eagle",0.454638396682601
"6705",6794,36,6,30,3.55108592207497e-06,"consensus",0.385051030039074
"6706",6795,33,4,29,3.62634174644619e-06,"geometric",0.437990203612026
"6707",6796,56,11,45,3.66628048512223e-06,"impression",0.466085355538431
"6708",6797,44,4,40,3.61194687548535e-06,"proven",0.427864042896589
"6709",6798,50,12,38,3.6856983845584e-06,"subordinate",0.479744996599601
"6710",6799,31,4,27,3.56931247903029e-06,"dune",0.397872613887991
"6711",6800,64,24,40,3.60570855778869e-06,"telescope",0.423475659856388
"6712",6801,33,7,26,3.34702265599636e-06,"refute",0.241501467555891
"6713",6802,57,21,36,3.62091877192919e-06,"rainy",0.434175378757795
"6714",6803,39,6,33,3.50981871786322e-06,"positively",0.356021360842176
"6715",6804,58,16,42,3.62149575017474e-06,"divine",0.434581257661443
"6716",6805,40,9,31,3.49618566144337e-06,"stormy",0.346431103261838
"6717",6806,47,19,28,3.47394713347252e-06,"grin",0.330787273670016
"6718",6807,44,7,37,3.69972991971586e-06,"phase",0.489615566504354
"6719",6808,38,5,33,3.41770507939329e-06,"peacock",0.29122345402048
"6720",6809,55,6,49,3.63162271797907e-06,"priceless",0.441705135591701
"6721",6810,100,54,46,3.78947208864333e-06,"seed",0.552745248457339
"6722",6811,49,11,38,3.61738224516446e-06,"combination",0.431687587204019
"6723",6812,52,12,40,3.7282549529867e-06,"restore",0.509681677002999
"6724",6813,45,17,28,3.6746062659386e-06,"injure",0.471942177378479
"6725",6814,46,10,36,3.75479675285177e-06,"twirl",0.528352669736587
"6726",6815,34,8,26,3.55277649483071e-06,"cellar",0.386240273865736
"6727",6816,34,7,27,3.41008293321694e-06,"sermon",0.285861608305549
"6728",6817,55,16,39,3.69822485207101e-06,"superficial",0.488556817391501
"6729",6818,104,65,39,3.68094997957073e-06,"rights",0.476404701839198
"6730",6819,45,11,34,3.59007129881599e-06,"characteristic",0.412475533635229
"6731",6820,38,8,30,3.63154358760191e-06,"apparel",0.441649470840081
"6732",6821,36,7,29,3.40185809489143e-06,"abbreviation",0.280075795082965
"6733",6822,46,10,36,3.62538202463085e-06,"downtown",0.437315081384763
"6734",6823,49,12,37,3.67986634725427e-06,"cooperate",0.475642414006068
"6735",6824,54,22,32,3.47823667313619e-06,"salsa",0.333804776789544
"6736",6825,140,84,56,3.83647412681849e-06,"violent",0.585809121958523
"6737",6826,60,31,29,3.59762700522735e-06,"witty",0.417790641887901
"6738",6827,68,29,39,3.70937767770701e-06,"invention",0.496402341337408
"6739",6828,60,12,48,3.66457419480143e-06,"administration",0.464885055093736
"6740",6829,38,8,30,3.51926799225761e-06,"extract",0.362668511165524
"6741",6830,55,22,33,3.63170185180477e-06,"layer",0.441760802769215
"6742",6831,50,10,40,3.59176050140977e-06,"banner",0.413663813613008
"6743",6832,53,29,24,3.52488746796759e-06,"cocaine",0.3666215659953
"6744",6833,42,11,31,3.48500055760009e-06,"shimmer",0.338562873012045
"6745",6834,79,52,27,3.44761011666713e-06,"odor",0.312260336842148
"6746",6835,57,25,32,3.43459669248339e-06,"seafood",0.303105963378065
"6747",6836,47,10,37,3.64803735590252e-06,"prohibit",0.453252113827967
"6748",6837,22,7,15,3.33836313378824e-06,"boa",0.235409873276449
"6749",6838,38,7,31,3.4913884902887e-06,"trough",0.343056503640643
"6750",6839,48,14,34,3.53122307442406e-06,"nucleus",0.371078387413329
"6751",6840,35,5,30,3.49169326173034e-06,"triad",0.343270896990047
"6752",6841,47,11,36,3.62439653797643e-06,"disturb",0.436621834722621
"6753",6842,52,18,34,3.61718597399967e-06,"welcoming",0.431549519043217
"6754",6843,39,3,36,3.46275975026577e-06,"interface",0.322917439987932
"6755",6844,38,4,34,3.59611332072296e-06,"sovereign",0.41672583119209
"6756",6845,43,8,35,3.55254930938441e-06,"sparrow",0.386080458863041
"6757",6846,36,4,32,3.55089677898153e-06,"nourishment",0.384917976164011
"6758",6847,49,14,35,3.61973916159602e-06,"satin",0.433345574597145
"6759",6848,40,6,34,3.68598367846427e-06,"paternal",0.479945688356398
"6760",6849,42,7,35,3.73979969632826e-06,"cordial",0.517802897874879
"6761",6850,56,13,43,3.7352039234582e-06,"seduce",0.514569973118516
"6762",6851,42,11,31,3.72066719004052e-06,"outback",0.504344018383286
"6763",6852,39,7,32,3.47539593448184e-06,"fond",0.331806441671237
"6764",6853,57,24,33,3.66269508429693e-06,"collapse",0.463563183225451
"6765",6854,64,21,43,3.78951516942922e-06,"Lego",0.552775553901749
"6766",6855,49,9,40,3.56834450225163e-06,"prominent",0.39719168465589
"6767",6856,51,6,45,3.66044269393941e-06,"exquisite",0.461978725343458
"6768",6857,46,9,37,3.75886151602403e-06,"miner",0.531212052447587
"6769",6858,52,12,40,3.70510340943616e-06,"guidance",0.493395580973294
"6770",6859,40,4,36,3.53207120655552e-06,"reform",0.371675011189571
"6771",6860,86,50,36,3.74429463105593e-06,"panic",0.520964887418347
"6772",6861,46,8,38,3.65130077590141e-06,"advocate",0.455547786743734
"6773",6862,31,4,27,3.52680193127674e-06,"equivalent",0.367968307011946
"6774",6863,43,12,31,3.64407582592979e-06,"yearning",0.450465351147556
"6775",6864,35,9,26,3.61884841005895e-06,"December",0.432718969937307
"6776",6865,40,6,34,3.58642752367939e-06,"compensation",0.409912297553114
"6777",6866,43,8,35,3.62624969630159e-06,"tread",0.43792545037036
"6778",6867,56,11,45,3.67206950493159e-06,"superstition",0.47015767721008
"6779",6868,68,21,47,3.61522443313281e-06,"smug",0.43016966102839
"6780",6869,67,26,41,3.66441305263929e-06,"questioning",0.464771698646407
"6781",6870,59,19,40,3.73847148854719e-06,"fashionable",0.516868561923467
"6782",6871,55,19,36,3.623109642544e-06,"zoom",0.435716560197538
"6783",6872,45,2,43,3.66439962476548e-06,"emerge",0.464762252725795
"6784",6873,44,13,31,3.43223902112543e-06,"percussion",0.301447444927306
"6785",6874,88,45,43,3.656160081313e-06,"hamburger",0.458966095090992
"6786",6875,49,10,39,3.57424967563684e-06,"uprising",0.401345715276514
"6787",6876,68,19,49,3.71038239200932e-06,"magical",0.497109113806989
"6788",6877,67,23,44,3.609065973726e-06,"bigot",0.42583745479448
"6789",6878,33,7,26,3.59810595702422e-06,"perpetual",0.418127563481937
"6790",6879,42,10,32,3.5599604132402e-06,"heel",0.391293845556588
"6791",6880,52,15,37,3.7579009868248e-06,"zipper",0.530536362261151
"6792",6881,51,21,30,3.55193100729211e-06,"courteous",0.385645510444652
"6793",6882,141,92,49,3.66706026446839e-06,"jungle",0.466633896126478
"6794",6883,51,18,33,3.51606313442964e-06,"opponent",0.360414034169903
"6795",6884,53,14,39,3.48547428591346e-06,"regularly",0.338896120114409
"6796",6885,76,34,42,3.68222406333425e-06,"racist",0.477300963916816
"6797",6886,45,6,39,3.7104374605766e-06,"sniper",0.497147852130117
"6798",6887,48,15,33,3.45612961868522e-06,"crocodile",0.318253433055754
"6799",6888,43,3,40,3.55424127611479e-06,"undefined",0.387270683289752
"6800",6889,48,10,38,3.60212381219967e-06,"dimension",0.420953948473415
"6801",6890,54,13,41,3.6147670463377e-06,"clearly",0.429847909467781
"6802",6891,46,8,38,3.70635305977977e-06,"copyright",0.494274655211052
"6803",6892,60,20,40,3.7198782855825e-06,"towards",0.503789058679042
"6804",6893,81,29,52,3.70478769714102e-06,"chemicals",0.493173491213049
"6805",6894,52,14,38,3.61549892077357e-06,"bribe",0.43036275105138
"6806",6895,54,19,35,3.57569386339419e-06,"sunglasses",0.402361638057203
"6807",6896,63,23,40,3.61098171759956e-06,"uneasy",0.427185096632056
"6808",6897,58,21,37,3.5403242937053e-06,"herbs",0.377480696221731
"6809",6898,42,10,32,3.53167203480816e-06,"lint",0.371394211363169
"6810",6899,39,8,31,3.58503891559743e-06,"trivial",0.408935472637703
"6811",6900,35,3,32,3.52481292055424e-06,"chivalrous",0.366569125157831
"6812",6901,51,11,40,3.65386231516024e-06,"aside",0.457349717326116
"6813",6902,38,12,26,3.62164002346823e-06,"morose",0.434682747599129
"6814",6903,37,4,33,3.45449395118109e-06,"weld",0.317102812666805
"6815",6904,55,10,45,3.694604030813e-06,"amber",0.486009728356786
"6816",6905,38,5,33,3.46328742168641e-06,"perpendicular",0.323288633701647
"6817",6906,56,21,35,3.55104809184431e-06,"seen",0.385024418130108
"6818",6907,46,4,42,3.63810992912962e-06,"physically",0.446268604266351
"6819",6908,64,21,43,3.71848122352906e-06,"sensible",0.502806286765281
"6820",6909,34,9,25,3.59182500628569e-06,"everybody",0.413709189965624
"6821",6910,38,6,32,3.66367466568969e-06,"daylight",0.464252275794876
"6822",6911,74,31,43,3.70796099225036e-06,"plug",0.495405765219686
"6823",6913,59,12,47,3.76987193745028e-06,"beating",0.538957401274289
"6824",6914,56,13,43,3.73348864646103e-06,"cancel",0.513363350940926
"6825",6915,50,23,27,3.51428380653165e-06,"nipple",0.359162354991286
"6826",6916,55,20,35,3.63254616058034e-06,"wages",0.442354736982175
"6827",6917,49,4,45,3.67424172836331e-06,"congratulate",0.471685741173924
"6828",6918,44,7,37,3.58384403110777e-06,"bibliography",0.408094923777512
"6829",6919,76,35,41,3.70697133028373e-06,"raw",0.49470958140843
"6830",6920,54,22,32,3.59262505927831e-06,"shiver",0.414271992175256
"6831",6921,49,3,46,3.58538596679933e-06,"tracksuit",0.409179607945095
"6832",6923,40,3,37,3.69024115725963e-06,"bead",0.482940638060473
"6833",6924,58,25,33,3.58470478163771e-06,"penny",0.408700424043948
"6834",6925,51,14,37,3.63592732508463e-06,"harp",0.444733237996109
"6835",6926,52,9,43,3.58659474348674e-06,"reminder",0.410029929357435
"6836",6927,47,12,35,3.55152733433013e-06,"clone",0.385361544211077
"6837",6928,47,8,39,3.66601167258117e-06,"timeless",0.465896257699305
"6838",6929,41,11,30,3.68822681119598e-06,"aptitude",0.481523633904445
"6839",6930,69,39,30,3.62059102527897e-06,"cops",0.433944823356282
"6840",6931,42,9,33,3.39232588039337e-06,"tortilla",0.273370300032402
"6841",6932,42,13,29,3.50098377644118e-06,"antlers",0.349806366835317
"6842",6933,68,26,42,3.60173459538114e-06,"weapons",0.420680151503065
"6843",6934,31,2,29,3.39565491996441e-06,"harpsichord",0.275712133440713
"6844",6935,50,21,29,3.60213678754237e-06,"mansion",0.420963076058223
"6845",6936,46,9,37,3.59568661433744e-06,"dilemma",0.416425661954738
"6846",6937,62,26,36,3.55021603064546e-06,"wary",0.384439099550491
"6847",6938,43,11,32,3.54675330202732e-06,"butcher",0.382003221757862
"6848",6939,40,5,35,3.58375412579694e-06,"pastoral",0.408031679332383
"6849",6940,45,12,33,3.52182120418111e-06,"tipsy",0.364464583832535
"6850",6941,41,8,33,3.6446867756185e-06,"boisterous",0.45089512747232
"6851",6942,49,5,44,3.71617353043918e-06,"getting",0.50118292583529
"6852",6943,53,31,22,3.48702999194496e-06,"noun",0.339990491112514
"6853",6944,49,6,43,3.75175394496927e-06,"fingernail",0.526212187774075
"6854",6945,27,3,24,3.53525533381648e-06,"vocation",0.373914905140036
"6855",6946,41,15,26,3.39514765497151e-06,"crust",0.275355294754393
"6856",6947,47,19,28,3.59203143745914e-06,"olive",0.413854405247142
"6857",6948,55,12,43,3.6822918584527e-06,"athletics",0.477348654810814
"6858",6949,68,26,42,3.70882738004725e-06,"laughing",0.496015231056307
"6859",6950,74,40,34,3.78319278772127e-06,"emotions",0.548328035514589
"6860",6951,46,9,37,3.63395861647928e-06,"horrific",0.443348337791453
"6861",6952,78,33,45,3.65332836480676e-06,"swamp",0.45697410665839
"6862",6953,42,4,38,3.56747886268774e-06,"comeback",0.396582745168386
"6863",6954,52,15,37,3.69952461108748e-06,"trait",0.489471140884078
"6864",6955,49,6,43,3.72402030335869e-06,"mushrooms",0.506702786617424
"6865",6956,72,29,43,3.61201210746458e-06,"trapped",0.427909930734504
"6866",6957,51,19,32,3.53230825747701e-06,"thorough",0.371841766121607
"6867",6958,46,8,38,3.66368808825092e-06,"factor",0.464261717978319
"6868",6959,46,5,41,3.67793094316861e-06,"contribution",0.474280942071098
"6869",6960,62,17,45,3.68044872030798e-06,"restriction",0.476052087920775
"6870",6961,48,10,38,3.50109409190372e-06,"navigation",0.349883968927487
"6871",6962,101,58,43,3.69849840964568e-06,"salty",0.48874925315377
"6872",6963,42,10,32,3.58761126079423e-06,"comprehension",0.410745004723764
"6873",6964,70,30,40,3.72289730760067e-06,"wilderness",0.505912808328666
"6874",6965,54,12,42,3.57702405906382e-06,"mechanism",0.403297372401075
"6875",6966,57,25,32,3.53644304558475e-06,"marine",0.374750408305143
"6876",6967,120,80,40,3.8611380318235e-06,"painful",0.603159097976413
"6877",6968,34,9,25,3.52579471412856e-06,"cab",0.367259773900014
"6878",6970,100,62,38,3.56886663502272e-06,"slime",0.397558982172432
"6879",6971,68,34,34,3.64894253645294e-06,"suffering",0.453888868666194
"6880",6972,50,10,40,3.61718597399967e-06,"removal",0.431549519043217
"6881",6973,44,15,29,3.46606033717835e-06,"nod",0.325239258198253
"6882",6974,22,3,19,3.39863239032613e-06,"confide",0.277806653321459
"6883",6975,37,7,30,3.54767184035477e-06,"inhibit",0.382649373206686
"6884",6976,53,18,35,3.62094499422459e-06,"torn",0.434193824993145
"6885",6977,66,23,43,3.67196163534483e-06,"investigation",0.470081795684309
"6886",6978,53,19,34,3.58294518093873e-06,"severe",0.40746262208509
"6887",6979,67,31,36,3.62205979296306e-06,"owner",0.434978037037965
"6888",6980,57,8,49,3.69169884597494e-06,"balcony",0.48396605817327
"6889",6981,39,4,35,3.61650573216159e-06,"simply",0.431070998728827
"6890",6982,50,16,34,3.69571001980901e-06,"blossom",0.486787743133963
"6891",6984,51,22,29,3.51311092999073e-06,"famine",0.358337287758307
"6892",6985,51,5,46,3.69864888356283e-06,"cleanser",0.488855104958395
"6893",6986,177,134,43,3.74578131379534e-06,"yuck",0.522010703556129
"6894",6987,46,9,37,3.57597516842843e-06,"inherit",0.40255952381766
"6895",6988,39,4,35,3.64702621482443e-06,"blackbird",0.452540820403344
"6896",6989,54,18,36,3.50220989444339e-06,"helicopter",0.350668887102452
"6897",6990,74,43,31,3.64176669385852e-06,"humid",0.448840977957245
"6898",6991,38,8,30,3.41167680503291e-06,"tattle",0.286982827260011
"6899",6992,38,7,31,3.59500150990063e-06,"espionage",0.415943721015299
"6900",6993,31,5,26,3.63807022203143e-06,"rump",0.446240672063351
"6901",6994,69,21,48,3.70829099701112e-06,"attraction",0.495637909102974
"6902",6995,82,46,36,3.68138361121644e-06,"cloudy",0.476709742693522
"6903",6996,35,3,32,3.57215576027977e-06,"backbone",0.399872737610516
"6904",6997,72,36,36,3.69734973970658e-06,"deadly",0.487941214204062
"6905",6998,128,89,39,3.78481079730824e-06,"makeup",0.549466234332862
"6906",6999,82,38,44,3.76408237317865e-06,"hardworking",0.534884696597296
"6907",7000,48,14,34,3.58563022829708e-06,"ashamed",0.409351435201452
"6908",7001,50,14,36,3.65969251263509e-06,"disgrace",0.461451005680399
"6909",7002,32,8,24,3.51842599694601e-06,"bashful",0.362076204373046
"6910",7003,46,10,36,3.53700592448492e-06,"humiliate",0.37514636893737
"6911",7004,53,18,35,3.60413610659593e-06,"embarrass",0.422369509371371
"6912",7005,49,6,43,3.5974069890423e-06,"degrade",0.417635870146223
"6913",7006,46,12,34,3.61363061467857e-06,"ornament",0.429048479611565
"6914",7007,29,2,27,3.58763700288805e-06,"Crayola",0.410763113158353
"6915",7008,50,15,35,3.63948697791559e-06,"compliment",0.447237297723745
"6916",7010,34,2,32,3.47510607761302e-06,"symptom",0.331602540070028
"6917",7012,47,12,35,3.58176452047337e-06,"hesitate",0.406632079202476
"6918",7014,27,2,25,3.60573456024461e-06,"Methodist",0.423493951444301
"6919",7015,29,3,26,3.44272002423675e-06,"porpoise",0.308820371176732
"6920",7016,56,13,43,3.67439023494051e-06,"catastrophe",0.471790209041135
"6921",7017,31,4,27,3.29589200021094e-06,"galoshes",0.205533292545657
"6922",7018,95,59,36,3.74813998553218e-06,"times",0.523669925729583
"6923",7019,32,3,29,3.28517270152892e-06,"maggot",0.197992735808035
"6924",7020,43,5,38,3.53749389782303e-06,"gully",0.375489636790199
"6925",7021,72,31,41,3.48050049597132e-06,"Hawaii",0.33539727691839
"6926",7022,57,20,37,3.61310835711963e-06,"lipstick",0.428681094312242
"6927",7023,34,4,30,3.61076006499368e-06,"cookbook",0.427029173740056
"6928",7024,42,4,38,3.58057181731923e-06,"indirect",0.405793064816206
"6929",7025,30,5,25,3.51313561406097e-06,"quail",0.358354651919689
"6930",7026,39,3,36,3.54496791804034e-06,"bulletin",0.380747282386113
"6931",7027,66,28,38,3.70736988058562e-06,"frightened",0.494989944075177
"6932",7028,50,19,31,3.6300407653578e-06,"hymn",0.440592301268221
"6933",7030,54,9,45,3.72504684246404e-06,"adventurous",0.507424911879244
"6934",7031,28,3,25,3.50091023666153e-06,"sill",0.349754634823983
"6935",7032,42,7,35,3.51324669666979e-06,"hitch",0.358432793665639
"6936",7033,63,13,50,3.67131455088809e-06,"walker",0.469626600134221
"6937",7034,164,130,34,3.81410073040029e-06,"leaves",0.570070418326003
"6938",7035,54,12,42,3.61996191800062e-06,"intuition",0.433502273963162
"6939",7036,113,75,38,3.80047505938242e-06,"arms",0.560485356052223
"6940",7037,43,7,36,3.66383574291597e-06,"boiled",0.464365586562678
"6941",7038,44,9,35,3.67337792814138e-06,"scoop",0.471078095582861
"6942",7039,36,3,33,3.49438975724474e-06,"clockwise",0.345167763382359
"6943",7041,42,14,28,3.56086044631825e-06,"brittle",0.391926979373646
"6944",7043,115,83,32,3.71038239200932e-06,"instrument",0.497109113806989
"6945",7044,51,14,37,3.38074261392257e-06,"outlaw",0.265221979827781
"6946",7045,32,4,28,3.54459095420388e-06,"inlet",0.380482104851542
"6947",7046,55,9,46,3.732220633955e-06,"stimulus",0.512471359726821
"6948",7047,54,16,38,3.61610032508742e-06,"murderer",0.430785812623349
"6949",7048,52,13,39,3.65990681877239e-06,"poise",0.461601760653789
"6950",7050,31,6,25,3.56207811637309e-06,"blaze",0.392783556880126
"6951",7051,59,26,33,3.53393103886971e-06,"carrots",0.37298332169603
"6952",7052,46,7,39,3.64353145642883e-06,"grounds",0.45008241106631
"6953",7054,60,13,47,3.693908006915e-06,"amateur",0.485520106055056
"6954",7055,39,5,34,3.67786330853228e-06,"ceramics",0.474233364069231
"6955",7056,59,27,32,3.65722979471969e-06,"goo",0.459718591581241
"6956",7057,47,9,38,3.59674710192102e-06,"smudge",0.417171668482848
"6957",7058,43,4,39,3.59012285400406e-06,"unload",0.412511800450092
"6958",7060,44,12,32,3.40694608167131e-06,"Pluto",0.283654970748471
"6959",7061,30,3,27,3.62727566206849e-06,"precipice",0.438647172313715
"6960",7062,35,5,30,3.38497679598406e-06,"ghoul",0.268200541300804
"6961",7063,63,26,37,3.6740932337899e-06,"directions",0.471581281750856
"6962",7064,38,11,27,3.50604090848532e-06,"twinkle",0.35336383754676
"6963",7065,40,7,33,3.51850027444302e-06,"competence",0.36212845533621
"6964",7066,34,7,27,3.49467062729338e-06,"stethoscope",0.345365343149511
"6965",7067,54,20,34,3.58703216133036e-06,"ambition",0.410337633636014
"6966",7068,39,14,25,3.40500876789758e-06,"pissed",0.282292155431651
"6967",7069,85,50,35,3.64256261565136e-06,"brass",0.449400874048925
"6968",7070,53,19,34,3.62576322315848e-06,"cemetery",0.437583237838945
"6969",7071,47,5,42,3.51096474289205e-06,"swimmer",0.356827539213446
"6970",7072,39,3,36,3.44510399046395e-06,"shrine",0.31049738691536
"6971",7073,72,38,34,3.67525451137491e-06,"slick",0.472398189626798
"6972",7074,37,11,26,3.22632682690757e-06,"bran",0.156597242546738
"6973",7075,42,8,34,3.57703685421071e-06,"vary",0.403306373226029
"6974",7076,40,13,27,3.65599967827203e-06,"roar",0.458853258583006
"6975",7077,40,9,31,3.5478480527636e-06,"Dracula",0.382773330911949
"6976",7078,32,6,26,3.54788581484293e-06,"sty",0.382799894879447
"6977",7079,46,3,43,3.60488967235158e-06,"detach",0.422899609847583
"6978",7080,46,12,34,3.37869798494452e-06,"George",0.263783672968932
"6979",7081,53,15,38,3.76296340894381e-06,"overwhelm",0.534097554308374
"6980",7082,50,16,34,3.50135152168737e-06,"dissolve",0.350065059495738
"6981",7083,46,22,24,3.47520269119696e-06,"skyscraper",0.331670503491235
"6982",7084,50,4,46,3.64970163689118e-06,"blockade",0.454422862549
"6983",7085,33,4,29,3.62230907714432e-06,"hoot",0.435153397531996
"6984",7086,75,38,37,3.61156857646413e-06,"wax",0.427597926118061
"6985",7087,43,4,39,3.58263710752211e-06,"scarcity",0.407245905941027
"6986",7088,35,5,30,3.63008029737618e-06,"catcher",0.440620110310249
"6987",7089,50,12,38,3.50995423019684e-06,"doorway",0.356116687828632
"6988",7090,54,19,35,3.56438890334447e-06,"tighten",0.394409094220123
"6989",7091,57,31,26,3.52585687136616e-06,"prick",0.367303498791975
"6990",7092,43,5,38,3.69673467426222e-06,"holiness",0.487508542625623
"6991",7093,36,7,29,3.56108869603615e-06,"antler",0.392087543044764
"6992",7094,43,3,40,3.51064427343706e-06,"magnitude",0.35660210299978
"6993",7095,30,3,27,3.42493903608516e-06,"gander",0.296312225449533
"6994",7096,57,12,45,3.6814107165866e-06,"tact",0.476728810133251
"6995",7097,48,21,27,3.55529009389521e-06,"lava",0.388008480622891
"6996",7098,47,16,31,3.68153269569187e-06,"charcoal",0.476814617086804
"6997",7099,37,2,35,3.74864580170413e-06,"grown-ups",0.524025745233878
"6998",7100,52,18,34,3.56143112548346e-06,"oath",0.392328427150403
"6999",7101,63,24,39,3.58797168372747e-06,"pancakes",0.410998546458005
"7000",7102,45,8,37,3.44847801422842e-06,"inability",0.312870864731846
"7001",7103,50,28,22,3.39138249707493e-06,"sting",0.272706671221502
"7002",7104,61,24,37,3.64798412397309e-06,"follower",0.453214667499057
"7003",7105,39,4,35,3.50784881171621e-06,"proverb",0.35463561821946
"7004",7106,41,13,28,3.53890852983123e-06,"rake",0.376484768396953
"7005",7107,37,7,30,3.57762552993578e-06,"puck",0.403720480793758
"7006",7108,39,8,31,3.37321599039308e-06,"alto",0.259927330107639
"7007",7109,57,19,38,3.57414747647317e-06,"traitor",0.401273822644819
"7008",7110,43,5,38,3.53943461071528e-06,"bristle",0.376854843237898
"7009",7111,51,21,30,3.59628144498588e-06,"rob",0.416844099241255
"7010",7112,40,3,37,3.66540698846496e-06,"implode",0.465470888930152
"7011",7113,40,8,32,3.43377113915358e-06,"tweezers",0.302525222799037
"7012",7115,46,14,32,3.58980065836944e-06,"stoned",0.412285149944722
"7013",7116,87,53,34,3.62170560603811e-06,"zoo",0.434728882062199
"7014",7117,44,9,35,3.60661886694462e-06,"waffles",0.42411602244378
"7015",7118,39,2,37,3.53111085216298e-06,"criterion",0.370999443971975
"7016",7119,33,2,31,3.63743502631684e-06,"uncooked",0.445793839722226
"7017",7120,51,13,38,3.57011527902236e-06,"chemist",0.398437348491321
"7018",7122,40,3,37,3.71458606510184e-06,"clove",0.500066213557712
"7019",7123,44,9,35,3.69401716979181e-06,"mailbox",0.485596897353689
"7020",7124,39,6,33,3.53997337940019e-06,"dunk",0.377233843390565
"7021",7125,40,8,32,3.4100945619222e-06,"clippers",0.285869788589955
"7022",7126,52,7,45,3.6930485746679e-06,"heading",0.484915533142817
"7023",7127,55,11,44,3.67375579075756e-06,"unused",0.471343905369572
"7024",7128,30,3,27,3.37638220646577e-06,"legion",0.262154624322301
"7025",7129,45,14,31,3.64797081623347e-06,"id",0.453205306087583
"7026",7130,24,2,22,3.57464575260592e-06,"excise",0.401624338062049
"7027",7131,39,4,35,3.61572115558448e-06,"truce",0.430519083499094
"7028",7132,224,180,44,3.84834444222096e-06,"flowers",0.594159368503657
"7029",7135,42,8,34,3.63983140300941e-06,"tombstone",0.447479585679221
"7030",7136,33,5,28,3.46686543361819e-06,"treble",0.325805608251927
"7031",7137,40,10,30,3.44500904314874e-06,"hinge",0.310430595641165
"7032",7138,67,22,45,3.70220910817485e-06,"cocky",0.491359566908933
"7033",7139,35,9,26,3.62632859613941e-06,"hoop",0.437980952947659
"7034",7140,81,42,39,3.67525451137491e-06,"give up",0.472398189626798
"7035",7141,40,12,28,3.45914234024816e-06,"cavity",0.320372750611306
"7036",7142,41,11,30,3.49849739536869e-06,"reel",0.348057306742429
"7037",7143,42,14,28,3.42610072050898e-06,"tangy",0.297129419518744
"7038",7144,41,7,34,3.58028978865549e-06,"brandy",0.405594670014121
"7039",7145,47,4,43,3.72975674526507e-06,"controls",0.510738122039106
"7040",7146,107,62,45,3.60902689807747e-06,"disgust",0.425809966788638
"7041",7147,41,9,32,3.54250653592456e-06,"sympathetic",0.379015807963429
"7042",7148,37,5,32,3.62141706049577e-06,"editorial",0.434525902921688
"7043",7149,51,13,38,3.64786435781172e-06,"withdrawn",0.453130417254533
"7044",7150,61,24,37,3.65232762839758e-06,"stolen",0.456270132462253
"7045",7151,34,5,29,3.59016152136685e-06,"Tupperware",0.412539001244808
"7046",7152,43,10,33,3.72835225472103e-06,"valor",0.50975012450783
"7047",7154,44,5,39,3.58362569746315e-06,"misunderstand",0.407941335629277
"7048",7155,45,7,38,3.63114798743623e-06,"porcupine",0.441371183464831
"7049",7156,36,4,32,3.52879318801763e-06,"maroon",0.369369068841548
"7050",7157,37,4,33,3.69438564213964e-06,"radiator",0.485856101498243
"7051",7158,29,4,25,3.51166751531965e-06,"accelerate",0.357321908809922
"7052",7159,27,4,23,3.33139002248688e-06,"wigwam",0.230504595145348
"7053",7160,39,3,36,3.6214432900088e-06,"recliner",0.43454435423432
"7054",7161,59,24,35,3.69210775047259e-06,"cabin",0.484253704562857
"7055",7162,43,8,35,3.55864287595283e-06,"marines",0.390367015829745
"7056",7163,47,15,32,3.47058333564706e-06,"mayonnaise",0.328420989353359
"7057",7164,33,2,31,3.41511392820064e-06,"unsolved",0.289400692740708
"7058",7165,64,18,46,3.65355527463775e-06,"fattening",0.457133727777801
"7059",7166,62,26,36,3.61623109163168e-06,"vinegar",0.430877801155027
"7060",7167,33,3,30,3.46717795984314e-06,"adjustment",0.326025456751455
"7061",7168,49,13,36,3.70415643393452e-06,"shun",0.492729425218979
"7062",7169,39,9,30,3.5054264000673e-06,"sandals",0.352931557811933
"7063",7170,28,6,22,3.46670919163275e-06,"lather",0.325695698864103
"7064",7171,39,2,37,3.54369912576943e-06,"righteousness",0.379854742641592
"7065",7172,47,7,40,3.69343049517823e-06,"hammock",0.485184197480176
"7066",7173,46,14,32,3.56146917726501e-06,"hog",0.3923551949107
"7067",7174,35,7,28,3.26925591735321e-06,"Leo",0.186795975859667
"7068",7175,36,5,31,3.38081119183737e-06,"bandana",0.265270221384696
"7069",7176,41,7,34,3.63431520415766e-06,"aggravate",0.443599181592016
"7070",7177,35,6,29,3.60202001282319e-06,"chimpanzee",0.420880930162152
"7071",7178,43,11,32,3.52412971616659e-06,"algae",0.366088520819686
"7072",7179,92,56,36,3.6583938187778e-06,"infection",0.460537431480616
"7073",7180,68,26,42,3.67242012486228e-06,"McDonald's",0.470404322961745
"7074",7181,39,10,29,3.48562007438313e-06,"cyclone",0.338998675912125
"7075",7183,43,8,35,3.61595649281148e-06,"cocoon",0.430684632922175
"7076",7184,36,7,29,3.34879359710664e-06,"pier",0.242747246996993
"7077",7185,42,7,35,3.67244709839955e-06,"cosmetics",0.470423297662813
"7078",7186,34,2,32,3.45745600387235e-06,"oligarchy",0.319186486892222
"7079",7187,198,153,45,3.80626129983823e-06,"cars",0.564555722570488
"7080",7188,32,4,28,3.65370211366667e-06,"mink",0.457237022597895
"7081",7189,45,15,30,3.45095332585627e-06,"dryer",0.314612137955662
"7082",7190,35,2,33,3.67109890674675e-06,"hitchhike",0.469474903933641
"7083",7191,38,7,31,3.43208588451717e-06,"frosted",0.301339720036208
"7084",7192,32,3,29,3.39129048776931e-06,"vacancy",0.272641946708266
"7085",7193,34,8,26,3.486604465643e-06,"tangerine",0.339691152012217
"7086",7194,45,7,38,3.66722163954145e-06,"roam",0.466747416416431
"7087",7195,31,5,26,3.43939274081768e-06,"mitten",0.306479773144352
"7088",7196,51,11,40,3.65505091485924e-06,"stocking",0.458185845111574
"7089",7197,42,8,34,3.66921310055845e-06,"stud",0.468148321945323
"7090",7198,240,188,52,3.96745103173564e-06,"American",0.677945633137442
"7091",7199,61,27,34,3.53091136353204e-06,"planets",0.37085911246478
"7092",7200,52,26,26,3.51682978895504e-06,"Easter",0.360953342021885
"7093",7201,37,8,29,3.60690505904504e-06,"unlawful",0.424317346041068
"7094",7202,61,16,45,3.57678096866382e-06,"gymnast",0.40312636896065
"7095",7203,37,10,27,3.34599233767755e-06,"synagogue",0.240776683783065
"7096",7204,43,20,23,3.51134691756411e-06,"Newton",0.357096382342443
"7097",7205,47,13,34,3.58674911407297e-06,"pick up",0.410138522297941
"7098",7206,42,18,24,3.60999101112238e-06,"hours",0.426488178053413
"7099",7207,31,6,25,3.43646154427709e-06,"dissimilar",0.304417804868336
"7100",7208,27,2,25,3.61169901545085e-06,"juggler",0.427689684227367
"7101",7209,46,10,36,3.61293865591456e-06,"cuff",0.428561716953404
"7102",7210,80,51,29,3.60499363718623e-06,"marijuana",0.422972744551417
"7103",7211,32,5,27,3.68434044779474e-06,"chowder",0.478789747612122
"7104",7212,37,6,31,3.54475429535602e-06,"twine",0.380597008191936
"7105",7213,44,8,36,3.5219700491667e-06,"slogan",0.364569289755216
"7106",7214,80,45,35,3.67629488296515e-06,"hiking",0.473130045435385
"7107",7216,54,16,38,3.66899770320744e-06,"wanted",0.46799679935092
"7108",7217,34,2,32,3.4794711203897e-06,"tarnish",0.334673156319852
"7109",7218,27,3,24,3.24376224520248e-06,"tutu",0.168862295027969
"7110",7219,44,6,38,3.5206432919423e-06,"stairway",0.363635974206839
"7111",7220,55,24,31,3.61338252351409e-06,"roses",0.428873958352538
"7112",7221,37,7,30,3.61145118943145e-06,"hare",0.427515349486283
"7113",7222,32,3,29,3.60577356463169e-06,"marrow",0.423521389320833
"7114",7224,37,2,35,3.37933737952662e-06,"disbelieve",0.264233459029297
"7115",7225,29,5,24,3.34147539504593e-06,"perch",0.23759921264389
"7116",7226,36,8,28,3.71053383450277e-06,"mare",0.497215646962583
"7117",7227,35,9,26,3.31292571095386e-06,"glacier",0.217515761373091
"7118",7229,39,9,30,3.58037952022914e-06,"sue",0.405657792242762
"7119",7230,62,14,48,3.7445750469008e-06,"smoky",0.521162147673064
"7120",7231,38,5,33,3.50692617920393e-06,"physiology",0.353986586691068
"7121",7232,71,34,37,3.72812985821922e-06,"don't",0.509593678317658
"7122",7233,38,3,35,3.59842964530279e-06,"hustle",0.418355263996891
"7123",7234,39,10,29,3.518809797774e-06,"slither",0.362346191431462
"7124",7235,32,4,28,3.56466843236576e-06,"pebble",0.394605730633328
"7125",7236,36,8,28,3.50246748834554e-06,"sprain",0.350850093120869
"7126",7237,112,73,39,3.70399179195419e-06,"Chinese",0.492613606802971
"7127",7238,128,100,28,3.68920648857637e-06,"flying",0.482212793996961
"7128",7239,30,5,25,3.45014369848504e-06,"sonnet",0.314042600590377
"7129",7240,29,2,27,3.48411418138995e-06,"croak",0.337939346202905
"7130",7242,69,28,41,3.6455238435487e-06,"knees",0.451483968067971
"7131",7243,40,4,36,3.65550519081737e-06,"frill",0.45850540833473
"7132",7244,61,21,40,3.57002606119025e-06,"burnt",0.398374587657333
"7133",7245,74,29,45,3.69972991971586e-06,"oatmeal",0.489615566504354
"7134",7246,61,16,45,3.61553813669627e-06,"heights",0.430390337733948
"7135",7247,46,9,37,3.63932803447172e-06,"Swiss",0.447125487978333
"7136",7248,44,2,42,3.64685331261921e-06,"caption",0.452419191281211
"7137",7249,43,12,31,3.51350591674396e-06,"cents",0.358615143624792
"7138",7250,35,6,29,3.70329222678962e-06,"otter",0.492121493375441
"7139",7251,68,43,25,3.53369377009788e-06,"humor",0.372816413515833
"7140",7252,39,13,26,3.53189655781361e-06,"coral",0.371552153455442
"7141",7253,44,13,31,3.63337766054079e-06,"noose",0.442939660755189
"7142",7255,40,2,38,3.6492621191995e-06,"evacuate",0.454113681119349
"7143",7256,34,7,27,3.51696584322773e-06,"fawn",0.361049050238721
"7144",7257,40,12,28,3.62081388654542e-06,"utensil",0.434101596488009
"7145",7258,41,11,30,3.58608027082078e-06,"flake",0.409668020389066
"7146",7259,77,31,46,3.78433813818132e-06,"make up",0.549133739356295
"7147",7260,62,16,46,3.68200713572983e-06,"plates",0.47714836485622
"7148",7261,37,2,35,3.43529282436035e-06,"quotient",0.303595661638261
"7149",7262,59,26,33,3.60975644973234e-06,"abandon",0.426323174397617
"7150",7263,35,5,30,3.6246855585278e-06,"crescent",0.436825148011167
"7151",7264,39,3,36,3.71109841090766e-06,"disperse",0.497612801714967
"7152",7265,37,6,31,3.54444019111622e-06,"chipmunk",0.380376049628132
"7153",7266,40,5,35,3.60028226212935e-06,"pass out",0.419658498724103
"7154",7267,26,2,24,3.46957185483311e-06,"wick",0.327709456939457
"7155",7268,53,18,35,3.64613527891112e-06,"unaware",0.451914086042895
"7156",7269,37,10,27,3.48068221371389e-06,"pun",0.335525107384608
"7157",7270,53,13,40,3.53638051454336e-06,"memorial",0.374706420458604
"7158",7271,41,12,29,3.45858004537657e-06,"ivory",0.319977200817586
"7159",7272,36,2,34,3.67237966529932e-06,"orchid",0.47037586143276
"7160",7274,59,21,38,3.50449275971796e-06,"muffin",0.352274782752704
"7161",7276,69,23,46,3.69811544037159e-06,"criticize",0.48847985105707
"7162",7277,57,30,27,3.58964602500547e-06,"Einstein",0.412176372151593
"7163",7278,46,10,36,3.60876641537623e-06,"nomad",0.42562672862669
"7164",7279,33,11,22,3.59537634601902e-06,"despise",0.416207401793477
"7165",7280,36,5,31,3.37420621798722e-06,"transplant",0.260623911813052
"7166",7281,47,17,30,3.33688155071559e-06,"bathtub",0.234367644530689
"7167",7282,87,53,34,3.76116596144805e-06,"taxes",0.532833128787007
"7168",7283,57,14,43,3.64630811303555e-06,"ducks",0.452035667273174
"7169",7284,29,2,27,3.42986105632861e-06,"demi",0.299774650931875
"7170",7285,41,10,31,3.54750823021909e-06,"elders",0.382534280648163
"7171",7286,46,9,37,3.59580297876319e-06,"Los Angeles",0.416507519227365
"7172",7287,39,10,29,3.59855913692158e-06,"cardinal",0.418446355674385
"7173",7288,51,14,37,3.66225243173561e-06,"painter",0.463251796552438
"7174",7289,67,18,49,3.72314680367847e-06,"extravagant",0.506088317882629
"7175",7290,38,2,36,3.65132744009085e-06,"bookbag",0.455566543832162
"7176",7291,36,5,31,3.55670634765382e-06,"toasty",0.389004753059964
"7177",7292,95,51,44,3.67732232097876e-06,"confusion",0.473852803039757
"7178",7293,46,12,34,3.57210471982197e-06,"prune",0.399836832885831
"7179",7295,34,2,32,3.41308577084542e-06,"reappear",0.287973972946479
"7180",7296,44,4,40,3.5762309386891e-06,"lenient",0.402739446984237
"7181",7297,30,3,27,3.41117637828582e-06,"ashtray",0.28663079897986
"7182",7298,41,9,32,3.61976536680892e-06,"relish",0.433364008815709
"7183",7299,44,6,38,3.48508557627633e-06,"violation",0.338622679923946
"7184",7300,40,7,33,3.36610800494145e-06,"soprano",0.254927173924086
"7185",7301,69,26,43,3.69175336134144e-06,"morals",0.484004407343894
"7186",7302,33,5,28,3.34901790050068e-06,"stag",0.242905034602259
"7187",7304,73,43,30,3.73196992032244e-06,"harm",0.512294993676461
"7188",7305,61,23,38,3.57287047987223e-06,"baked",0.400375511513766
"7189",7307,39,6,33,3.49548907135342e-06,"grove",0.345941082668894
"7190",7308,46,15,31,3.61436202895827e-06,"dungeon",0.429562997495467
"7191",7309,27,4,23,3.41122292341805e-06,"drench",0.286663541440057
"7192",7310,22,2,20,3.48939050815994e-06,"succor",0.341651010795484
"7193",7311,75,28,47,3.79056377054959e-06,"fan",0.553513198824037
"7194",7312,42,5,37,3.5755276584942e-06,"cans",0.402244720195726
"7195",7313,53,9,44,3.65450326164416e-06,"fugitive",0.457800595081383
"7196",7314,41,12,29,3.40261048276238e-06,"crochet",0.280605066968922
"7197",7315,56,20,36,3.45034606971079e-06,"hormones",0.31418495987666
"7198",7316,37,3,34,3.74068102838803e-06,"yoke",0.518422876345343
"7199",7317,46,18,28,3.49487825591595e-06,"bury",0.345511400784002
"7200",7318,32,3,29,3.47722072701731e-06,"publisher",0.333090103229359
"7201",7319,39,12,27,3.62878936329262e-06,"snatch",0.43971199477113
"7202",7320,56,17,39,3.48820985070462e-06,"walkway",0.340820470030305
"7203",7321,41,5,36,3.5062375966845e-06,"veal",0.35350219907297
"7204",7322,55,18,37,3.67776862422031e-06,"tackle",0.474166757806294
"7205",7323,55,22,33,3.74704451863593e-06,"harmful",0.522899312788342
"7206",7324,38,5,33,3.38471328093797e-06,"washcloth",0.268015170017176
"7207",7325,36,10,26,3.55421601103229e-06,"doe",0.387252910411718
"7208",7326,43,4,39,3.60759470838008e-06,"conquest",0.424802484117191
"7209",7327,37,3,34,3.4043248542949e-06,"sedative",0.281811052191819
"7210",7328,65,18,47,3.7152622975182e-06,"Jell-O",0.500541913419682
"7211",7329,49,12,37,3.56904495925935e-06,"eyebrows",0.397684425455984
"7212",7330,33,5,28,3.65706929780612e-06,"constructive",0.459605689037999
"7213",7331,51,4,47,3.65684195129087e-06,"disown",0.459445760730349
"7214",7332,51,14,37,3.62998805733929e-06,"sap",0.440555223487682
"7215",7334,46,9,37,3.64391648143425e-06,"hiker",0.45035325927988
"7216",7335,36,7,29,3.34118511836148e-06,"Kleenex",0.237395015720789
"7217",7336,38,3,35,3.77662045342105e-06,"friendliness",0.543704686435554
"7218",7337,39,2,37,3.57195160719963e-06,"biologist",0.399729124867774
"7219",7338,36,5,31,3.5520319398712e-06,"shutter",0.385716512089617
"7220",7339,44,10,34,3.60767279850787e-06,"offend",0.424857417098972
"7221",7340,38,2,36,3.6352796620644e-06,"zenith",0.444277635451975
"7222",7341,42,6,36,3.71857801576677e-06,"dandelion",0.502874375861579
"7223",7342,71,41,30,3.64943524989508e-06,"Egypt",0.45423547097443
"7224",7343,54,11,43,3.75624946003914e-06,"minded",0.529374585562844
"7225",7344,39,9,30,3.59208304896009e-06,"delinquent",0.413890711675648
"7226",7346,31,5,26,3.56099992878e-06,"knapsack",0.392025099171214
"7227",7347,57,22,35,3.60547455256061e-06,"mythology",0.423311047436154
"7228",7348,40,4,36,3.57727997939487e-06,"bartender",0.403477401135585
"7229",7349,77,33,44,3.70427992502537e-06,"protein",0.49281629578811
"7230",7350,32,6,26,3.32460071545407e-06,"Watt",0.225728615260031
"7231",7351,23,5,18,3.27963477987091e-06,"axon",0.194097050678862
"7232",7352,42,4,38,3.67256848422081e-06,"appraise",0.470508687267069
"7233",7353,109,63,46,3.85240659840202e-06,"cats",0.597016917310631
"7234",7354,41,9,32,3.58193130572142e-06,"hardy",0.406749405313377
"7235",7355,78,42,36,3.70404667098805e-06,"Santa",0.492652211797649
"7236",7356,49,11,38,3.67380977747734e-06,"treason",0.471381882660403
"7237",7358,76,41,35,3.5908061000614e-06,"rash",0.412992434101038
"7238",7359,38,13,25,3.49463398950911e-06,"am",0.345339570074311
"7239",7360,28,4,24,3.41357510547947e-06,"omelet",0.288318198411333
"7240",7361,53,13,40,3.69595588507056e-06,"jumpy",0.486960698567852
"7241",7363,52,13,39,3.63649587257718e-06,"caress",0.445133186234594
"7242",7364,43,6,37,3.53525533381648e-06,"tribute",0.373914905140036
"7243",7365,47,6,41,3.67317553371241e-06,"possum",0.470935719974125
"7244",7366,62,27,35,3.613500036135e-06,"ad",0.428956623330133
"7245",7367,36,13,23,3.61746075959441e-06,"flakes",0.431742818663772
"7246",7369,106,74,32,3.70577619335258e-06,"sour",0.493868854966717
"7247",7370,54,23,31,3.7281715555423e-06,"Washington",0.509623010556624
"7248",7371,39,5,34,3.56702075292674e-06,"touchdown",0.396260485032968
"7249",7372,54,9,45,3.69337593026906e-06,"hot dogs",0.485145813458456
"7250",7373,44,13,31,3.55012780460097e-06,"tuba",0.384377036395613
"7251",7374,33,4,29,3.63522680180016e-06,"peroxide",0.444240450573237
"7252",7375,35,7,28,3.49786105796306e-06,"libel",0.347609671271696
"7253",7376,66,28,38,3.69912774567757e-06,"screw",0.489191963464979
"7254",7377,33,2,31,3.52584443974332e-06,"co-pilot",0.367294753690249
"7255",7378,57,19,38,3.61001707538077e-06,"taboo",0.426506513116648
"7256",7379,32,5,27,3.55458238988792e-06,"sonic",0.387510641876281
"7257",7380,38,5,33,3.53500539088322e-06,"husky",0.373739081242844
"7258",7381,60,19,41,3.53739378975146e-06,"crackers",0.375419215150135
"7259",7382,67,27,40,3.64984816631628e-06,"peanut butter",0.454525939576373
"7260",7383,77,46,31,3.57161990820937e-06,"hip",0.399495789168299
"7261",7385,80,38,42,3.65316821013024e-06,"spots",0.456861444863908
"7262",7386,35,4,31,3.47711191084685e-06,"brawl",0.333013555823446
"7263",7387,30,8,22,3.56016319788099e-06,"holler",0.391436495662228
"7264",7388,31,8,23,3.36285923743804e-06,"oboe",0.252641808396593
"7265",7389,43,7,36,3.55531537425027e-06,"slab",0.388026264244501
"7266",7390,31,9,22,3.48476981352997e-06,"artery",0.338400554673482
"7267",7391,49,17,32,3.67887808933788e-06,"pets",0.474947217882607
"7268",7392,41,9,32,3.48716375023538e-06,"Jupiter",0.340084584206473
"7269",7393,39,8,31,3.58403670053581e-06,"nauseous",0.408230458274394
"7270",7394,51,17,34,3.61361755639954e-06,"fountain",0.429039293684682
"7271",7395,63,24,39,3.73692077727952e-06,"mafia",0.515777704522772
"7272",7396,61,25,36,3.68907039115213e-06,"velvet",0.482117055424899
"7273",7397,40,7,33,3.62137771693863e-06,"flipper",0.434498226453881
"7274",7398,35,11,24,3.41976212134684e-06,"apex",0.292670492863462
"7275",7399,35,7,28,3.53071189743988e-06,"drapes",0.370718796812629
"7276",7400,29,5,24,3.39951047049225e-06,"keg",0.278424344227291
"7277",7401,33,7,26,3.49608787766489e-06,"protestant",0.346362316660078
"7278",7402,47,12,35,3.67088328793674e-06,"imitate",0.46932322555255
"7279",7403,51,21,30,3.65961215430389e-06,"handcuffs",0.461394477116941
"7280",7404,30,8,22,3.4991584523922e-06,"Pepsi",0.348522331380743
"7281",7405,37,7,30,3.54207990932275e-06,"decompose",0.378715694850424
"7282",7406,66,22,44,3.68268511937424e-06,"righteous",0.47762529663035
"7283",7407,55,8,47,3.71431012260938e-06,"technician",0.499872100110328
"7284",7408,42,13,29,3.57824000687022e-06,"trench",0.404152738381269
"7285",7409,49,17,32,3.66053648822772e-06,"aluminum",0.46204470551377
"7286",7410,44,12,32,3.6281968949891e-06,"stale",0.439295219290712
"7287",7411,44,12,32,3.66437276931308e-06,"pendulum",0.464743361092251
"7288",7412,36,2,34,3.5633474085556e-06,"flunk",0.393676448290536
"7289",7413,32,5,27,3.40628459507792e-06,"hamper",0.283189643926575
"7290",7414,43,15,28,3.52560825556429e-06,"musty",0.367128608473541
"7291",7416,55,18,37,3.62101055162475e-06,"rag",0.434239941750417
"7292",7417,33,3,30,3.56510051800911e-06,"cougar",0.394909683942754
"7293",7418,38,4,34,3.5749907943987e-06,"cavern",0.401867059838217
"7294",7419,41,2,39,3.71221429870704e-06,"mastery",0.498397779866395
"7295",7420,39,18,21,3.5218708177784e-06,"sow",0.3644994848234
"7296",7421,30,7,23,3.41622227308598e-06,"stray",0.290180364782752
"7297",7422,25,2,23,3.41932946949103e-06,"elm",0.292366141248387
"7298",7423,41,14,27,3.47008956301162e-06,"bog",0.328073641949071
"7299",7424,29,3,26,3.37293154972713e-06,"psalm",0.259727238567724
"7300",7425,51,19,32,3.41924762875177e-06,"reindeer",0.29230856987584
"7301",7426,53,12,41,3.62082699688609e-06,"atomic",0.434110819037973
"7302",7427,54,19,35,3.52579471412856e-06,"crafts",0.367259773900014
"7303",7428,49,8,41,3.72442252828699e-06,"negotiation",0.506985734222773
"7304",7429,45,20,25,3.51598895979467e-06,"moron",0.360361855565675
"7305",7430,51,14,37,3.72296660871249e-06,"ballerina",0.505961558622986
"7306",7431,38,3,35,3.54564665503695e-06,"defrost",0.381224744110489
"7307",7432,42,8,34,3.52731197663509e-06,"slander",0.368327101563481
"7308",7433,44,5,39,3.69018668654447e-06,"vet",0.48290232030011
"7309",7434,46,19,27,3.39725841246114e-06,"blast",0.276840120122363
"7310",7435,28,5,23,3.35200399558876e-06,"moat",0.245005621599933
"7311",7436,55,25,30,3.58646611148171e-06,"nosy",0.409939442380536
"7312",7437,47,15,32,3.57994372328467e-06,"novice",0.405351228195675
"7313",7438,59,21,38,3.52143674619245e-06,"underwater",0.364194134490398
"7314",7439,52,10,42,3.63142489850167e-06,"soothe",0.441565978260854
"7315",7440,49,5,44,3.70679269761839e-06,"nylons",0.494583921158801
"7316",7441,40,15,25,3.50338777597937e-06,"meek",0.351497475130057
"7317",7442,50,13,37,3.59327052296459e-06,"flannel",0.414726047584368
"7318",7444,46,4,42,3.67309458218549e-06,"downstairs",0.470878774123487
"7319",7445,45,10,35,3.59827426766123e-06,"tendency",0.418245962637101
"7320",7447,198,159,39,3.79424564705168e-06,"numbers",0.556103237546579
"7321",7448,36,6,30,3.46042314054163e-06,"spool",0.321273737473315
"7322",7449,44,6,38,3.56310617343776e-06,"comet",0.393506749959782
"7323",7450,46,5,41,3.59564782786915e-06,"paper towel",0.416398377374516
"7324",7451,98,61,37,3.7524156175538e-06,"New York",0.526677645432581
"7325",7452,41,13,28,3.61539434913863e-06,"Valentine",0.430289189490144
"7326",7453,35,2,33,3.57304920446059e-06,"extremity",0.400501236427206
"7327",7454,35,4,31,3.61608724895314e-06,"bluff",0.430776614136083
"7328",7455,35,4,31,3.69676200615881e-06,"providence",0.487527769416763
"7329",7456,30,4,26,3.55904816815791e-06,"Harley",0.390652121129858
"7330",7457,33,5,28,3.54146524583081e-06,"lit",0.378283306027886
"7331",7458,28,8,20,3.55768067681317e-06,"Billy",0.389690150913421
"7332",7459,39,4,35,3.51569229254779e-06,"scallop",0.360153163162035
"7333",7460,37,2,35,3.56182436644049e-06,"bologna",0.39260505492578
"7334",7461,50,8,42,3.75709621547698e-06,"dishwasher",0.529970240895469
"7335",7462,44,10,34,3.58840943751682e-06,"descent",0.411306487059682
"7336",7463,60,22,38,3.58874426249511e-06,"slippers",0.411542021754709
"7337",7464,35,4,31,3.73293117221505e-06,"jaws",0.512971192246009
"7338",7465,90,38,52,3.64345180624123e-06,"crunch",0.450026380650837
"7339",7466,54,10,44,3.58239325363702e-06,"horoscope",0.407074365422315
"7340",7467,35,10,25,3.51905745565108e-06,"buck",0.362520407891794
"7341",7468,51,12,39,3.57030647510782e-06,"ointment",0.398571846556281
"7342",7469,47,10,37,3.66218537249919e-06,"heater",0.463204623319181
"7343",7470,25,2,23,3.29482777935197e-06,"cuss",0.204784659821966
"7344",7471,35,4,31,3.62569749355532e-06,"hooked",0.437536999944413
"7345",7473,38,2,36,3.482840047088e-06,"annually",0.337043048573718
"7346",7474,46,12,34,3.31888512011045e-06,"oregano",0.221707944481431
"7347",7475,54,16,38,3.768195674865e-06,"whiskers",0.537778224025253
"7348",7476,43,9,34,3.62069589775155e-06,"topping",0.434018596543612
"7349",7477,43,12,31,3.5665754812202e-06,"elk",0.395947255906095
"7350",7478,35,10,25,3.5333691381406e-06,"honk",0.372588049164269
"7351",7479,36,7,29,3.40430167559728e-06,"seashore",0.281794746994098
"7352",7480,70,32,38,3.66535324841932e-06,"marble",0.465433085163758
"7353",7481,41,11,30,3.63055474876561e-06,"lily",0.44095386606493
"7354",7482,47,8,39,3.6831055946374e-06,"outrageous",0.477921082546265
"7355",7483,33,2,31,3.47919268812865e-06,"deputy",0.334477291429401
"7356",7484,53,7,46,3.68109902892608e-06,"deteriorate",0.476509551527041
"7357",7485,28,2,26,3.44113254554339e-06,"upstream",0.307703649503781
"7358",7486,30,4,26,3.66840549086934e-06,"stopper",0.467580203930956
"7359",7487,41,4,37,3.49881565090217e-06,"polyester",0.348281185559361
"7360",7488,44,11,33,3.57109696956711e-06,"rodeo",0.399127924756717
"7361",7489,40,8,32,3.52185841424803e-06,"cobbler",0.364490759483496
"7362",7490,26,6,20,3.30091831547537e-06,"mow",0.20906908500344
"7363",7491,32,7,25,3.37920034603012e-06,"scuba",0.264137061971428
"7364",7493,26,3,23,3.4419971844463e-06,"mutton",0.308311885070154
"7365",7494,49,9,40,3.64199216971684e-06,"feature",0.448999590339733
"7366",7496,56,29,27,3.508008784054e-06,"Mars",0.354748151746631
"7367",7497,44,10,34,3.48355587449445e-06,"drowsy",0.337546601775548
"7368",7498,30,4,26,3.36683332491625e-06,"dill",0.25543740473164
"7369",7499,41,8,33,3.5654310071273e-06,"clench",0.395142168550266
"7370",7500,39,9,30,3.6276704188871e-06,"macaroni",0.438924866431271
"7371",7501,31,2,29,3.68697575813439e-06,"slacks",0.480643572916078
"7372",7502,63,17,46,3.63706459790432e-06,"announce",0.445533259571911
"7373",7503,45,12,33,3.51335778630353e-06,"bud",0.358510940353307
"7374",7504,57,20,37,3.67188073731365e-06,"interrupt",0.470024887465573
"7375",7506,67,36,31,3.6276967390634e-06,"sheets",0.438943381521539
"7376",7507,41,2,39,3.56819171180429e-06,"depletion",0.397084203273827
"7377",7508,33,4,29,3.46820007352584e-06,"receptionist",0.326744468922429
"7378",7509,61,15,46,3.65351522967823e-06,"peanuts",0.45710555790417
"7379",7510,295,252,43,4.04394964473902e-06,"kids",0.731759054034937
"7380",7511,30,4,26,3.51216085696725e-06,"usurp",0.35766895303316
"7381",7512,57,13,44,3.62089255001358e-06,"raccoon",0.434156932789612
"7382",7513,41,9,32,3.68368899350566e-06,"jobless",0.478331478076538
"7383",7514,48,11,37,3.69403081560506e-06,"New Year",0.485606496585146
"7384",7515,52,15,37,3.50639742209662e-06,"bounty",0.353614629244375
"7385",7516,62,25,37,3.62626284603613e-06,"strap",0.437934700632188
"7386",7517,79,38,41,3.74400023961602e-06,"Latin",0.520757795945146
"7387",7518,31,8,23,3.56742795579243e-06,"veteran",0.396546934399065
"7388",7519,58,20,38,3.64333233748916e-06,"earring",0.44994233962072
"7389",7520,51,8,43,3.62414696640778e-06,"goblin",0.436446272064158
"7390",7521,68,38,30,3.61717289001262e-06,"dollars",0.431540315031874
"7391",7522,45,6,39,3.58122578196065e-06,"warmer",0.40625310027462
"7392",7523,50,10,40,3.64988813092879e-06,"ridicule",0.454554052929404
"7393",7524,40,6,34,3.64826360893533e-06,"Colt",0.453411272918642
"7394",7525,63,21,42,3.71068528935924e-06,"scout",0.497322188815018
"7395",7526,41,3,38,3.62404189392429e-06,"thicket",0.436372358177923
"7396",7527,53,16,37,3.61908415456385e-06,"put down",0.432884805862536
"7397",7528,38,6,32,3.55897216883764e-06,"secluded",0.390598658939513
"7398",7529,37,18,19,3.35248721026129e-06,"uncommon",0.24534554194013
"7399",7531,37,3,34,3.60961312166562e-06,"pounce",0.426222349385532
"7400",7533,49,2,47,3.58194413599926e-06,"elimination",0.406758430851414
"7401",7534,35,2,33,3.55997308660347e-06,"jogger",0.3913027607121
"7402",7535,48,12,36,3.56987312670908e-06,"marsh",0.39826700495378
"7403",7536,35,7,28,3.54529468489421e-06,"adversary",0.38097714854384
"7404",7537,40,8,32,3.55357187276791e-06,"smother",0.386799787378816
"7405",7538,43,11,32,3.51346888296284e-06,"trance",0.358589091983162
"7406",7539,54,13,41,3.59950470815216e-06,"cooked",0.419111523585568
"7407",7540,44,10,34,3.50930140336963e-06,"terms",0.355657452772644
"7408",7541,34,6,28,3.49191273011705e-06,"sphinx",0.3434252833796
"7409",7542,46,11,35,3.57900839993271e-06,"highlight",0.404693269217885
"7410",7543,39,4,35,3.62095810551472e-06,"gazelle",0.434203048211011
"7411",7544,48,10,38,3.55849091517269e-06,"orange juice",0.390260118082189
"7412",7545,62,23,39,3.69111290745273e-06,"choke",0.483553876107765
"7413",7546,45,2,43,3.62575007704719e-06,"exclamation point",0.437573990125921
"7414",7547,69,26,43,3.70577619335258e-06,"reckless",0.493868854966717
"7415",7548,38,4,34,3.55265027710672e-06,"dwarfs",0.386151485229719
"7416",7549,47,14,33,3.52247869781008e-06,"astrology",0.364927101778992
"7417",7550,73,37,36,3.68577989259637e-06,"mist",0.479802333931376
"7418",7551,36,5,31,3.44998896003533e-06,"fungi",0.313933748874031
"7419",7552,32,9,23,3.51154420156264e-06,"suds",0.357235162987377
"7420",7553,78,38,40,3.73288936835779e-06,"flirt",0.512941785064919
"7421",7554,32,6,26,3.5878558256015e-06,"ewe",0.410917045345079
"7422",7555,44,9,35,3.73854137069881e-06,"frustrate",0.516917720953814
"7423",7556,56,13,43,3.67393125339839e-06,"ribs",0.471467335645908
"7424",7557,28,2,26,3.52921661978691e-06,"suede",0.369666934529916
"7425",7558,29,5,24,3.30171391969571e-06,"malaria",0.209628757696794
"7426",7559,75,31,44,3.62266338211853e-06,"fiber",0.435402635550243
"7427",7560,47,8,39,3.71226942166555e-06,"adorn",0.498436556451369
"7428",7561,36,16,20,3.57820159587791e-06,"minutes",0.404125717931943
"7429",7562,35,5,30,3.55420337862573e-06,"evict",0.387244024067454
"7430",7564,36,12,24,3.47214988576627e-06,"doze",0.329522988691811
"7431",7565,84,48,36,3.74437875139946e-06,"anatomy",0.52102406239257
"7432",7566,52,15,37,3.70310023551718e-06,"monument",0.491986435931301
"7433",7567,30,9,21,3.48790568703022e-06,"scalpel",0.340606504218516
"7434",7568,64,27,37,3.55703528223296e-06,"elf",0.389236144117401
"7435",7569,32,9,23,3.31899527375073e-06,"sleigh",0.221785432738734
"7436",7570,39,11,28,3.59197982744129e-06,"loaf",0.413818099861931
"7437",7571,76,38,38,3.71991979852914e-06,"mint",0.50381826121727
"7438",7572,39,11,28,3.42678166945949e-06,"crease",0.297608437255733
"7439",7573,51,20,31,3.64204522691763e-06,"daring",0.449036913754705
"7440",7574,51,14,37,3.46083032241095e-06,"demolish",0.32156017206939
"7441",7575,62,19,43,3.6416340740417e-06,"spike",0.44874768572956
"7442",7576,84,40,44,3.70231876224079e-06,"underground",0.49143670373759
"7443",7577,116,66,50,3.85101204596568e-06,"careless",0.596035910802485
"7444",7579,43,9,34,3.52506142419532e-06,"scarecrow",0.366743936576061
"7445",7580,32,6,26,3.48688408551235e-06,"corporal",0.339887852333042
"7446",7581,40,9,31,3.62434399373713e-06,"Hispanic",0.436584872153578
"7447",7582,58,14,44,3.59699291392396e-06,"FBI",0.417344586451637
"7448",7583,37,4,33,3.60805028178873e-06,"geyser",0.425122960039911
"7449",7584,43,11,32,3.63669424493136e-06,"victor",0.445272732490015
"7450",7585,31,10,21,3.37437700564533e-06,"gavel",0.260744053443983
"7451",7586,48,5,43,3.55522689458041e-06,"hung",0.387964022675299
"7452",7587,31,7,24,3.48937833235631e-06,"inmate",0.341642445651361
"7453",7588,32,4,28,3.36848913156982e-06,"snorkel",0.25660219212941
"7454",7589,62,20,42,3.74974220522339e-06,"prairie",0.524797017048344
"7455",7590,36,7,29,3.44650507153221e-06,"anteater",0.311482986029876
"7456",7591,41,9,32,3.45677476001341e-06,"mailman",0.318707261700084
"7457",7592,39,9,30,3.57354717439625e-06,"musk",0.400851536448208
"7458",7593,38,3,35,3.45134637021902e-06,"lubricate",0.314888627435587
"7459",7595,38,2,36,3.38189737970591e-06,"navigator",0.266034306936691
"7460",7596,37,11,26,3.53937197383696e-06,"brook",0.376810780939714
"7461",7597,41,11,30,3.59660480506402e-06,"squad",0.417071568881591
"7462",7598,49,11,38,3.55920017653633e-06,"standards",0.390759052360723
"7463",7599,39,7,32,3.41914241070055e-06,"clipper",0.292234553589086
"7464",7600,36,8,28,3.45164419071024e-06,"dandruff",0.31509813109607
"7465",7601,264,219,45,3.87353677148457e-06,"drugs",0.611881067823765
"7466",7602,71,24,47,3.64374387395561e-06,"communist",0.450231837484986
"7467",7603,28,5,23,3.34206726912999e-06,"inebriated",0.238015570116969
"7468",7604,60,17,43,3.7859857949813e-06,"lifestyle",0.550292793689316
"7469",7605,68,36,32,3.64940861333421e-06,"tornado",0.454216733321484
"7470",7606,35,3,32,3.55299108554537e-06,"aardvark",0.386391229026818
"7471",7607,39,5,34,3.34394478478371e-06,"sickle",0.239336320077635
"7472",7608,46,13,33,3.62661792492176e-06,"ecstasy",0.438184483063185
"7473",7609,44,4,40,3.58031542578901e-06,"headband",0.405612704613737
"7474",7610,75,44,31,3.61279507503775e-06,"Thanksgiving",0.4284607141005
"7475",7611,34,7,27,3.36011343742965e-06,"rabbi",0.250710258454042
"7476",7612,35,5,30,3.63291566912857e-06,"Morse",0.44261467004829
"7477",7613,39,6,33,3.6207090072378e-06,"bugle",0.434027818492528
"7478",7614,36,8,28,3.45237108846356e-06,"flashlight",0.315609471801642
"7479",7615,51,16,35,3.5216971763032e-06,"acrobat",0.364377335657247
"7480",7616,55,15,40,3.76747164977584e-06,"patriot",0.537268904112981
"7481",7617,38,6,32,3.45208505937586e-06,"captive",0.31540826287666
"7482",7618,45,7,38,3.58095647347406e-06,"mussel",0.406063653559564
"7483",7619,95,58,37,3.68164112834937e-06,"Spanish",0.476890894708164
"7484",7620,36,5,31,3.59603573021102e-06,"orchard",0.41667124966815
"7485",7622,86,48,38,3.73926829997906e-06,"polish",0.517429083837206
"7486",7623,36,3,33,3.35907504509558e-06,"quart",0.249979794965413
"7487",7624,36,4,32,3.61455799377573e-06,"labyrinth",0.429700850154348
"7488",7625,47,2,45,3.66832474945342e-06,"aerobics",0.467523405884192
"7489",7626,39,7,32,3.57990527570641e-06,"compulsion",0.405324182009732
"7490",7627,139,95,44,3.80953832205075e-06,"stuck",0.566860964047282
"7491",7628,23,3,20,3.58279113760784e-06,"hornet",0.407354259354366
"7492",7629,64,26,38,3.69467228256854e-06,"builder",0.486057740474962
"7493",7630,53,22,31,3.68988712635281e-06,"dependent",0.482691592836625
"7494",7631,53,18,35,3.60516259283294e-06,"custard",0.42309159744263
"7495",7632,160,121,39,3.78988857727583e-06,"plants",0.553038229953338
"7496",7633,27,2,25,3.47633830333833e-06,"rung",0.332469356852626
"7497",7634,45,5,40,3.55194362355081e-06,"whom",0.385654385429603
"7498",7635,31,10,21,3.45163227690375e-06,"woodwind",0.315089750255446
"7499",7636,37,5,32,3.63151721157582e-06,"lieutenant",0.441630916461934
"7500",7637,36,2,34,3.59876634289765e-06,"fray",0.418592115995591
"7501",7638,46,15,31,3.61295170928745e-06,"suffocate",0.428570899429033
"7502",7639,51,10,41,3.73752135059072e-06,"voodoo",0.516200181520801
"7503",7641,65,21,44,3.62798628621184e-06,"confuse",0.439147065248038
"7504",7642,53,22,31,3.48469695332945e-06,"reptile",0.33834930071628
"7505",7643,35,8,27,3.4482164100619e-06,"test tube",0.31268683766823
"7506",7644,28,6,22,3.56056883647732e-06,"pail",0.391721844633395
"7507",7645,46,4,42,3.66045609282917e-06,"repress",0.461988150875058
"7508",7646,170,134,36,3.83335633347133e-06,"helpful",0.583615891008644
"7509",7647,42,7,35,3.55210764307002e-06,"threshold",0.385769765971499
"7510",7648,33,5,28,3.45418370730629e-06,"molasses",0.316884569700559
"7511",7649,40,9,31,3.56904495925935e-06,"spank",0.397684425455984
"7512",7650,54,9,45,3.63191289220119e-06,"electrician",0.441909260437047
"7513",7651,55,12,43,3.68577989259637e-06,"sergeant",0.479802333931376
"7514",7653,54,11,43,3.70337451485794e-06,"series",0.492179379424372
"7515",7654,33,2,31,3.49231516048934e-06,"periscope",0.343708375505797
"7516",7655,32,3,29,3.61457105885245e-06,"erupt",0.429710040863104
"7517",7656,39,11,28,3.53184666134535e-06,"rye",0.371517053477252
"7518",7657,35,4,31,3.49926865285155e-06,"piston",0.348599852573213
"7519",7659,50,9,41,3.70763104621933e-06,"upstairs",0.495173662650184
"7520",7660,56,22,34,3.41470577187717e-06,"injection",0.289113572658853
"7521",7661,49,12,37,3.723701359151e-06,"monastery",0.506478423348368
"7522",7662,41,5,36,3.54830125077619e-06,"fascism",0.383092135847675
"7523",7663,68,27,41,3.70374485642433e-06,"questions",0.492439898482244
"7524",7664,118,80,38,3.64862300967615e-06,"Indian",0.453664095585321
"7525",7665,63,27,36,3.60673594004162e-06,"prickly",0.424198378235572
"7526",7668,48,13,35,3.52045737782253e-06,"intestine",0.363505191773203
"7527",7669,49,13,36,3.69516376965827e-06,"ivy",0.486403480098037
"7528",7670,26,2,24,3.37791049212778e-06,"escargot",0.263229706292449
"7529",7671,47,14,33,3.72913085147245e-06,"ox",0.510297833192323
"7530",7673,60,23,37,3.61908415456385e-06,"fierce",0.432884805862536
"7531",7674,47,11,36,3.55966895078758e-06,"unnatural",0.39108881449755
"7532",7675,77,30,47,3.71693323272834e-06,"yogurt",0.501717343093832
"7533",7677,37,9,28,3.41182812574634e-06,"emerald",0.2870892747487
"7534",7678,38,3,35,3.58865411116215e-06,"blue jay",0.411478604243794
"7535",7680,42,6,36,3.75797159725067e-06,"petals",0.530586033600511
"7536",7681,63,28,35,3.66387601443567e-06,"wrinkle",0.464393915811465
"7537",7682,32,3,29,3.34916371382066e-06,"shingle",0.243007607881074
"7538",7683,35,8,27,3.42190360497545e-06,"skillet",0.294176932723311
"7539",7684,40,5,35,3.68126164198994e-06,"incense",0.476623942689256
"7540",7685,68,21,47,3.713096462533e-06,"cinnamon",0.499018343447922
"7541",7686,59,27,32,3.54315922248914e-06,"slut",0.379474944350809
"7542",7688,45,11,34,3.45319368618066e-06,"reap",0.316188133236694
"7543",7689,49,9,40,3.72557420412421e-06,"custom",0.507795887690041
"7544",7690,40,11,29,3.53250790398644e-06,"zest",0.371982208689392
"7545",7691,60,26,34,3.44311119527605e-06,"yours",0.309095542855727
"7546",7692,90,57,33,3.58500035850004e-06,"slippery",0.408908349409854
"7547",7693,46,13,33,3.63149083593288e-06,"unjust",0.441612362353308
"7548",7694,71,24,47,3.67343190375608e-06,"rot",0.471116065061759
"7549",7695,59,21,38,3.69591490525522e-06,"grind",0.486931871064133
"7550",7696,59,28,31,3.67026352492109e-06,"brothers",0.468887249438622
"7551",7697,32,4,28,3.39940646363145e-06,"friar",0.278351179959905
"7552",7698,126,87,39,3.65720304425581e-06,"slimy",0.459699773802522
"7553",7699,36,5,31,3.59169599885066e-06,"scrambled",0.413618438890173
"7554",7700,44,7,37,3.620551699668e-06,"overview",0.433917159512819
"7555",7701,41,6,35,3.56290305340792e-06,"cashew",0.393363863922646
"7556",7702,34,9,25,3.43759560812785e-06,"convent",0.305215569075159
"7557",7703,29,2,27,3.35157708459716e-06,"ahoy",0.24470530843117
"7558",7704,30,2,28,3.59442002235729e-06,"perish",0.415534670018321
"7559",7705,40,9,31,3.50428398717432e-06,"husk",0.352127920419891
"7560",7706,42,3,39,3.56375377312431e-06,"sash",0.393962307951454
"7561",7707,35,3,32,3.58326614709308e-06,"limousine",0.407688407704978
"7562",7708,38,10,28,3.61018650223471e-06,"checkers",0.426625697481493
"7563",7709,55,13,42,3.64265549585648e-06,"theme",0.449466211201779
"7564",7710,38,9,29,3.57359825608405e-06,"graze",0.400887470176388
"7565",7711,43,14,29,3.35102675459761e-06,"scotch",0.244318175400446
"7566",7712,38,8,30,3.51172917544599e-06,"vault",0.357365284005904
"7567",7714,74,33,41,3.73412994772218e-06,"nerves",0.513814478266425
"7568",7715,58,11,47,3.6400433893172e-06,"wimp",0.447628708754237
"7569",7716,75,32,43,3.78440974561198e-06,"steps",0.549184112044817
"7570",7717,40,14,26,3.55218334949577e-06,"stadium",0.385823022123391
"7571",7718,329,291,38,3.97118508105189e-06,"eyes",0.680572373147725
"7572",7719,49,10,39,3.64927543636211e-06,"diver",0.454123049159483
"7573",7720,27,4,23,3.5861317114455e-06,"vacate",0.409704206613632
"7574",7721,47,2,45,3.77567933910509e-06,"chairperson",0.543042653768435
"7575",7722,60,21,39,3.75485314769339e-06,"dots",0.528392341035578
"7576",7723,56,17,39,3.66126020576282e-06,"frantic",0.462553809075242
"7577",7724,31,3,28,3.46001605447449e-06,"interstate",0.320987370269884
"7578",7725,34,6,28,3.61540742026219e-06,"chlorine",0.430298384452588
"7579",7726,43,4,39,3.69119465515014e-06,"reprimand",0.483611382029448
"7580",7727,49,8,41,3.58552737729429e-06,"fort",0.40927908402951
"7581",7729,39,2,37,3.65783178363193e-06,"shortcake",0.460142064392555
"7582",7730,37,9,28,3.39520529108793e-06,"eyelash",0.275395839235784
"7583",7731,45,8,37,3.48681113687477e-06,"fleet",0.339836536164244
"7584",7732,46,11,35,3.66076429436938e-06,"hound",0.462204957148447
"7585",7733,42,2,40,3.58446064620657e-06,"padding",0.408528685469923
"7586",7734,105,63,42,3.64673362069594e-06,"grease",0.452334993259944
"7587",7735,45,3,42,3.54336009751327e-06,"Vaseline",0.379616251124839
"7588",7736,33,4,29,3.44826397150355e-06,"pelt",0.312720295057555
"7589",7737,34,3,31,3.53848276935815e-06,"hull",0.376185264567543
"7590",7738,38,10,28,3.45577131087773e-06,"postage",0.318001379219766
"7591",7739,119,83,36,3.65994700396738e-06,"bang",0.461630029176928
"7592",7740,41,8,33,3.65099416571132e-06,"slum",0.455332099915397
"7593",7741,33,6,27,3.6449126132201e-06,"almighty",0.451053994325352
"7594",7742,39,5,34,3.61993570994179e-06,"bouquet",0.433483837742615
"7595",7743,35,8,27,3.35081340995527e-06,"tenor",0.244168096796614
"7596",7744,41,6,35,3.66119318285829e-06,"motionless",0.462506661399884
"7597",7745,31,4,27,3.51685452531256e-06,"checkbook",0.360970742965068
"7598",7746,38,8,30,3.64545739553942e-06,"disappoint",0.451437224806221
"7599",7747,41,18,23,3.57921336048763e-06,"quack",0.404837449983733
"7600",7748,36,9,27,3.39457140141486e-06,"clog",0.274949925637613
"7601",7749,44,4,40,3.7037997281411e-06,"condemn",0.492478498329665
"7602",7750,39,8,31,3.39305103148751e-06,"air force",0.273880412039812
"7603",7751,40,10,30,3.68337691996022e-06,"guys",0.478111948017205
"7604",7752,49,12,37,3.52046977148631e-06,"elements",0.363513910172391
"7605",7753,132,85,47,3.8389779105211e-06,"rocks",0.587570424038851
"7606",7754,29,4,25,3.5916443984714e-06,"swoon",0.413582140285288
"7607",7755,48,12,36,3.62613135298213e-06,"seller",0.437842201032753
"7608",7756,44,6,38,3.6816817922427e-06,"adults",0.476919499974597
"7609",7757,40,5,35,3.4035485397075e-06,"turnip",0.281264948909677
"7610",7758,73,34,39,3.58864123277004e-06,"gangster",0.411469544859472
"7611",7759,43,5,38,3.67721414256559e-06,"discourage",0.473776704268145
"7612",7760,51,11,40,3.61545970570158e-06,"hallucination",0.430335164967243
"7613",7761,50,11,39,3.55666839757862e-06,"thriller",0.38897805684562
"7614",7762,30,7,23,3.42346166749971e-06,"chime",0.295272961410772
"7615",7763,45,8,37,3.62342471610467e-06,"gauze",0.435938200636082
"7616",7765,23,4,19,3.30915444485625e-06,"chauffeur",0.214862840988534
"7617",7766,115,70,45,3.73216491690335e-06,"goods",0.512432165223367
"7618",7767,85,47,38,3.66402368424909e-06,"buzz",0.464497795052037
"7619",7768,93,58,35,3.72851906951078e-06,"sleepy",0.509867471400022
"7620",7769,59,20,39,3.70646295946241e-06,"pajamas",0.494351964820292
"7621",7770,38,4,34,3.6740662360661e-06,"haystack",0.471562290035622
"7622",7771,33,7,26,3.62601301738673e-06,"vagrant",0.437758957128684
"7623",7772,129,91,38,3.71947704152796e-06,"cards",0.503506801075387
"7624",7773,26,5,21,3.43694579249096e-06,"famished",0.304758452259561
"7625",7774,32,9,23,3.39307405723437e-06,"rinse",0.273896609643384
"7626",7776,91,47,44,3.74364983396913e-06,"Roman",0.520511300932748
"7627",7777,58,12,46,3.66780001687188e-06,"critic",0.467154279514963
"7628",7779,46,7,39,3.5911800617683e-06,"overpower",0.413255499769062
"7629",7780,38,6,32,3.53296967298833e-06,"hectic",0.372307042940376
"7630",7781,39,11,28,3.3304802219432e-06,"paw",0.229864590344376
"7631",7782,35,4,31,3.50340004974828e-06,"enrage",0.351506109188458
"7632",7783,40,10,30,3.47725700058766e-06,"baptist",0.33311562009603
"7633",7784,37,9,28,3.58812617286874e-06,"pecan",0.41110722279679
"7634",7785,33,2,31,3.69922353298043e-06,"pocketbook",0.489259345633662
"7635",7786,39,5,34,3.61299086997207e-06,"heroine",0.428598447254036
"7636",7787,67,33,34,3.71490344965934e-06,"grandpa",0.500289479681227
"7637",7788,82,39,43,3.73998152449127e-06,"Jack",0.517930806017035
"7638",7790,44,9,35,3.55402653436211e-06,"soft drink",0.387119621880039
"7639",7791,36,6,30,3.49597787745199e-06,"roach",0.346284936332209
"7640",7792,37,5,32,3.62240092733464e-06,"lightheaded",0.435218010114593
"7641",7794,48,17,31,3.62732829134701e-06,"chirp",0.438684194704125
"7642",7795,44,7,37,3.448573152858e-06,"integrate",0.312937790587315
"7643",7796,40,12,28,3.61022560299793e-06,"commander",0.426653203154424
"7644",7797,44,16,28,3.59568661433744e-06,"skunk",0.416425661954738
"7645",7798,58,26,32,3.6312666584358e-06,"legend",0.441454663311031
"7646",7799,48,5,43,3.72278643118802e-06,"fell",0.505834811632682
"7647",7800,72,32,40,3.71998898883259e-06,"Florida",0.503866933562759
"7648",7801,44,6,38,3.52871847531132e-06,"asteroid",0.369316511727724
"7649",7802,56,7,49,3.66664344459152e-06,"blackmail",0.466340681614583
"7650",7803,45,10,35,3.54619989219552e-06,"hoe",0.381613922200154
"7651",7804,29,4,25,3.49896255760167e-06,"wicker",0.34838452798274
"7652",7805,30,5,25,3.28159354182391e-06,"shears",0.195474953849603
"7653",7806,42,10,32,3.32156392515852e-06,"pantyhose",0.223592366406149
"7654",7807,72,35,37,3.56103797134789e-06,"gloomy",0.39205186045011
"7655",7808,49,10,39,3.56200198759711e-06,"cooler",0.39273000362336
"7656",7809,35,10,25,3.4406234409675e-06,"windshield",0.307345516751469
"7657",7810,99,53,46,3.74408434673216e-06,"fairy",0.520816961614484
"7658",7811,35,3,32,3.63964593524342e-06,"scapegoat",0.447349117235906
"7659",7812,48,7,41,3.61968675230845e-06,"nightgown",0.433308706960731
"7660",7813,53,10,43,3.6407192604971e-06,"hostess",0.448104154502188
"7661",7814,36,11,25,3.46194457426737e-06,"Jane",0.322343999406656
"7662",7815,43,3,40,3.67434973195619e-06,"hotter",0.471761716967129
"7663",7816,55,19,36,3.5475837407142e-06,"blunt",0.382587398971434
"7664",7817,34,12,22,3.40300417208311e-06,"quiver",0.280882010148517
"7665",7818,49,7,42,3.56160870742097e-06,"sprinkle",0.392453348259054
"7666",7819,40,7,33,3.62102366338964e-06,"rearrange",0.434249165302259
"7667",7820,47,5,42,3.68249525878735e-06,"meteorite",0.4774917380301
"7668",7822,51,12,39,3.67329696769335e-06,"dynamite",0.47102114345661
"7669",7823,51,23,28,3.50247975566701e-06,"harbor",0.350858722643782
"7670",7824,35,2,33,3.55161562995006e-06,"parkway",0.385423656309224
"7671",7825,44,4,40,3.73417177937019e-06,"antidote",0.513843904997094
"7672",7826,39,7,32,3.43944005915837e-06,"tangent",0.306513059522805
"7673",7827,48,7,41,3.61833773564425e-06,"erode",0.432359732872199
"7674",7828,21,2,19,3.49253470706365e-06,"saltine",0.343862816896902
"7675",7829,36,5,31,3.62627599586605e-06,"diameter",0.437943950961103
"7676",7830,40,10,30,3.52440296613754e-06,"untruthful",0.366280740196211
"7677",7831,39,5,34,3.63890425315129e-06,"closing",0.446827376396055
"7678",7832,106,71,35,3.798699325351e-06,"Italian",0.5592362050012
"7679",7833,33,7,26,3.60231845215581e-06,"viola",0.421090869150428
"7680",7834,44,12,32,3.5168916305013e-06,"junior",0.360996844838822
"7681",7835,54,28,26,3.48842888140039e-06,"broom",0.340974548523477
"7682",7836,404,368,36,3.96180816924845e-06,"words",0.673976126735061
"7683",7837,104,65,39,3.75051569590819e-06,"scream",0.525341133838794
"7684",7838,63,30,33,3.64674691941054e-06,"stir",0.452344348322708
"7685",7839,45,9,36,3.60524057770375e-06,"sliver",0.423146456380746
"7686",7841,49,15,34,3.67624082318385e-06,"obsession",0.47309201674897
"7687",7842,38,9,29,3.51127294177958e-06,"thigh",0.357044343620791
"7688",7843,38,2,36,3.50174386844649e-06,"manufacturer",0.350341058242082
"7689",7844,66,21,45,3.7362924769751e-06,"curtains",0.51533572280043
"7690",7845,51,11,40,3.75000937502344e-06,"kidnap",0.524984959291171
"7691",7846,37,5,32,3.55845292700546e-06,"chromosomes",0.390233395071765
"7692",7848,35,5,30,3.41581385180833e-06,"feud",0.289893058317256
"7693",7849,72,32,40,3.75486724666849e-06,"stuck up",0.528402259046526
"7694",7850,66,32,34,3.59820953093741e-06,"melt",0.418200423189653
"7695",7851,67,33,34,3.53839512550687e-06,"Mary",0.376123610960074
"7696",7852,35,2,33,3.56775887658408e-06,"conceit",0.396779722669934
"7697",7853,46,5,41,3.62529002320186e-06,"climber",0.437250362412392
"7698",7854,33,3,30,3.42699305348508e-06,"broil",0.297757136651621
"7699",7855,46,12,34,3.63292886725278e-06,"throw up",0.442623954350124
"7700",7856,50,8,42,3.58833217908648e-06,"cups",0.411252139140596
"7701",7857,48,11,37,3.54812499334727e-06,"pickles",0.382968146472748
"7702",7858,40,13,27,3.56956729705225e-06,"Venus",0.398051867196381
"7703",7859,42,11,31,3.41412286062526e-06,"starch",0.28870352014531
"7704",7860,20,2,18,3.374832523936e-06,"rummy",0.261064490593623
"7705",7861,38,10,28,3.55611188950449e-06,"crumb",0.388586577810247
"7706",7862,78,47,31,3.64221767349704e-06,"frozen",0.449158222364049
"7707",7863,40,8,32,3.68609237347488e-06,"stallion",0.480022150531667
"7708",7864,51,20,31,3.54113918447565e-06,"tar",0.378053936157571
"7709",7865,41,7,34,3.51762152502964e-06,"meatballs",0.36151029364426
"7710",7866,37,7,30,3.63975191450951e-06,"pitchfork",0.447423669003951
"7711",7867,37,8,29,3.40550738654552e-06,"colonel",0.282642911793312
"7712",7868,48,12,36,3.50369464600421e-06,"inventor",0.351713344740749
"7713",7870,28,3,25,3.64349163089972e-06,"orthodontist",0.450054395552354
"7714",7871,56,14,42,3.76041635329864e-06,"stripe",0.532305812313299
"7715",7872,47,6,41,3.59704466810069e-06,"preview",0.417380993246298
"7716",7873,48,18,30,3.49891358733113e-06,"real estate",0.348350079544051
"7717",7874,46,11,35,3.54705523474412e-06,"disallow",0.382215618188771
"7718",7875,45,5,40,3.50283554537398e-06,"glands",0.351109005106435
"7719",7876,41,11,30,3.55501203371573e-06,"rouge",0.387812877475519
"7720",7877,41,7,34,3.54288305651607e-06,"hairspray",0.379280673694611
"7721",7878,27,5,22,3.43910885811269e-06,"thimble",0.306280074105511
"7722",7879,44,11,33,3.58606741089519e-06,"foil",0.409658973995133
"7723",7880,43,4,39,3.55901016809205e-06,"bravado",0.390625389749276
"7724",7881,51,12,39,3.5846919315754e-06,"ancestor",0.408691384588403
"7725",7882,65,23,42,3.59435542424177e-06,"snotty",0.415489228075738
"7726",7883,36,4,32,3.41710946710178e-06,"amp",0.290804466882329
"7727",7884,37,2,35,3.63825552923884e-06,"siding",0.446371027560745
"7728",7885,33,2,31,3.41450755971974e-06,"mousse",0.288974139094819
"7729",7886,39,13,26,3.42679341233234e-06,"disregard",0.297616697852029
"7730",7887,34,4,30,3.63222949878865e-06,"amuse",0.442131979292735
"7731",7888,61,31,30,3.60189027201475e-06,"spill",0.420789663190662
"7732",7889,55,22,33,3.6487561390322e-06,"conceited",0.453757746251522
"7733",7890,34,6,28,3.44915599152887e-06,"Uranus",0.313347792043281
"7734",7891,43,11,32,3.56374107282861e-06,"gums",0.393953373850156
"7735",7892,41,6,35,3.57313857346016e-06,"cylinder",0.400564103600868
"7736",7893,59,21,38,3.68383826476482e-06,"hygiene",0.478436483863991
"7737",7894,39,14,25,3.42834417832875e-06,"mascara",0.298707593751991
"7738",7895,39,3,36,3.48909831232315e-06,"dashboard",0.341445463832833
"7739",7896,49,15,34,3.68065191706755e-06,"flick",0.476195027933914
"7740",7897,55,14,41,3.58780433550276e-06,"raisin",0.410880824317703
"7741",7898,30,2,28,3.33918804303546e-06,"roost",0.235990160771605
"7742",7899,81,36,45,3.62890788017346e-06,"Jewish",0.439795366201563
"7743",7900,37,6,31,3.57269177316265e-06,"typhoon",0.400249799177263
"7744",7901,32,2,30,3.53068696576293e-06,"brisk",0.370701258470784
"7745",7902,49,8,41,3.59541512663052e-06,"checking",0.416234682253703
"7746",7903,69,25,44,3.68443547079716e-06,"deception",0.478856592128953
"7747",7904,86,37,49,3.75099401341355e-06,"parade",0.525677609236561
"7748",7905,33,5,28,3.46982466975944e-06,"Neptune",0.327887301157872
"7749",7906,51,17,34,3.64902242689184e-06,"states",0.453945068087927
"7750",7907,34,7,27,3.25108098442732e-06,"copier",0.174010707252492
"7751",7908,47,14,33,3.61759162455187e-06,"handkerchief",0.431834876424822
"7752",7909,32,4,28,3.50513151253435e-06,"havoc",0.352724117359024
"7753",7910,46,10,36,3.61491078400185e-06,"magnify",0.429949022613708
"7754",7911,44,3,41,3.62522431075423e-06,"mints",0.437204136586019
"7755",7912,125,84,41,3.75067043233978e-06,"sore",0.52544998413548
"7756",7913,40,13,27,3.61411383735765e-06,"prim",0.42938840558402
"7757",7914,40,20,20,3.5400986979517e-06,"bizarre",0.37732199949816
"7758",7915,50,14,36,3.58622173608994e-06,"repulsive",0.409767535004729
"7759",7916,25,4,21,3.40921100629681e-06,"gull",0.285248245938543
"7760",7917,34,7,27,3.57215576027977e-06,"twister",0.399872737610516
"7761",7918,52,17,35,3.63755410861737e-06,"living room",0.445877608900619
"7762",7921,85,39,46,3.73123190352527e-06,"California",0.51177583121094
"7763",7922,51,9,42,3.64013614109168e-06,"bumps",0.447693955561766
"7764",7923,72,28,44,3.68055708912101e-06,"mixed",0.476128320630347
"7765",7924,35,3,32,3.57925179320515e-06,"bourbon",0.404864485715791
"7766",7925,42,11,31,3.65328832482117e-06,"pious",0.4569459402837
"7767",7926,27,3,24,3.39120998372219e-06,"jeopardy",0.272585315640048
"7768",7927,51,12,39,3.52774749794509e-06,"fumes",0.368633471713799
"7769",7928,84,42,42,3.67184028963476e-06,"poetry",0.469996434296515
"7770",7929,115,72,43,3.69173973234887e-06,"nuts",0.483994819945056
"7771",7930,29,4,25,3.42899074515398e-06,"shag",0.299162425170997
"7772",7931,33,6,27,3.5218708177784e-06,"mower",0.3644994848234
"7773",7932,43,8,35,3.53523033793267e-06,"hatch",0.373897321631477
"7774",7933,44,8,36,3.41715617428863e-06,"scroll",0.290837323340851
"7775",7934,31,7,24,3.40975736166614e-06,"molten",0.285632582991139
"7776",7935,27,2,25,3.53553031186913e-06,"swatter",0.374108340146287
"7777",7936,61,30,31,3.51679268507122e-06,"can't",0.360927241066076
"7778",7937,27,8,19,3.37422898867609e-06,"Popeye",0.260639929994508
"7779",7938,34,3,31,3.58039233939255e-06,"graft",0.405666809962284
"7780",7939,49,11,38,3.69348506169967e-06,"doorbell",0.485222582636063
"7781",7940,54,5,49,3.76575497738664e-06,"misses",0.536061300338273
"7782",7941,61,17,44,3.67295967090281e-06,"waterfall",0.470783869950019
"7783",7942,141,99,42,3.72831055335585e-06,"Greek",0.509720789425427
"7784",7943,43,7,36,3.45294328885942e-06,"hindsight",0.316011989697478
"7785",7944,40,3,37,3.53952230606957e-06,"menthol",0.376916533075476
"7786",7945,41,12,29,3.5401864262172e-06,"zit",0.377383712487336
"7787",7946,50,3,47,3.68139716385163e-06,"decency",0.476719276378289
"7788",7947,30,7,23,3.44315861598796e-06,"stoplight",0.309128901247848
"7789",7948,51,4,47,3.68187156895593e-06,"revival",0.477052999573412
"7790",7949,71,29,42,3.67015576141051e-06,"covered",0.468811442532793
"7791",7950,79,42,37,3.64652085445277e-06,"vacuum",0.452185321534571
"7792",7951,58,12,46,3.77847553626014e-06,"heart attack",0.54500965589448
"7793",7952,41,3,38,3.68761477700993e-06,"subtlety",0.481093094683349
"7794",7953,54,11,43,3.7173201095866e-06,"constitution",0.501989494004698
"7795",7954,186,154,32,3.8013274235363e-06,"stars",0.561084956870717
"7796",7955,70,45,25,3.57950803241602e-06,"years",0.405044738768284
"7797",7956,67,31,36,3.70104443473948e-06,"mechanic",0.490540270201127
"7798",7957,29,3,26,3.60176054055222e-06,"strand",0.420698402793607
"7799",7958,63,12,51,3.68223762215823e-06,"impulse",0.477310501955128
"7800",7959,39,12,27,3.46268780752996e-06,"rays",0.322866831426934
"7801",7960,48,18,30,3.63748795082116e-06,"digestion",0.445831069791046
"7802",7961,45,7,38,3.5632966195005e-06,"passenger",0.393640720416634
"7803",7962,37,6,31,3.59540219966707e-06,"freckle",0.416225588701571
"7804",7963,23,3,20,3.53445564081448e-06,"hula",0.373352356168021
"7805",7964,53,22,31,3.64168712080933e-06,"puke",0.448785001805255
"7806",7965,54,14,40,3.63311365106123e-06,"apathetic",0.442753941659291
"7807",7966,45,10,35,3.75202140153007e-06,"lollipop",0.526400331740523
"7808",7967,82,45,37,3.72576853290412e-06,"snob",0.507932589468223
"7809",7968,37,7,30,3.61055147563239e-06,"Tarzan",0.426882440267993
"7810",7969,39,5,34,3.54930877211663e-06,"grate",0.383800882945532
"7811",7970,35,5,30,3.47849075243233e-06,"discreet",0.333983510436706
"7812",7972,52,9,43,3.64371732041028e-06,"geese",0.450213158229833
"7813",7973,42,3,39,3.60316213508975e-06,"renounce",0.421684363111247
"7814",7975,35,8,27,3.54108902651922e-06,"blot",0.378018652233919
"7815",7976,40,12,28,3.58096929676925e-06,"Saturn",0.406072674185611
"7816",7977,32,7,25,3.67317553371241e-06,"spook",0.470935719974125
"7817",7978,41,6,35,3.55068244116519e-06,"hypnotize",0.384767198905808
"7818",7979,60,16,44,3.69270764095065e-06,"disintegrate",0.48467570121771
"7819",7980,65,27,38,3.73394868807713e-06,"bravery",0.513686970051727
"7820",7981,26,5,21,3.33181180594195e-06,"slay",0.230801301316927
"7821",7982,33,5,28,3.45558024375663e-06,"veer",0.317866971875583
"7822",7983,98,50,48,3.66763859089325e-06,"sales",0.467040723415178
"7823",7984,43,7,36,3.43759560812785e-06,"loosen",0.305215569075159
"7824",7985,49,16,33,3.55510050269121e-06,"oyster",0.38787511152169
"7825",7986,46,10,36,3.60590358534993e-06,"slurp",0.423612853196604
"7826",7987,34,8,26,3.36834163068155e-06,"inferno",0.256498431720281
"7827",7989,39,5,34,3.55510050269121e-06,"remover",0.38787511152169
"7828",7990,37,5,32,3.47152309604316e-06,"admission",0.329082069597206
"7829",7991,72,37,35,3.71680889655378e-06,"tickle",0.501629878045356
"7830",7993,65,28,37,3.72257855571397e-06,"sophisticated",0.505688580349005
"7831",7994,28,3,25,3.65280791344306e-06,"saber",0.456607991938246
"7832",7995,57,17,40,3.67725470872465e-06,"Band-Aid",0.47380524078281
"7833",7996,27,2,25,3.39802031336543e-06,"sentry",0.27737608401027
"7834",7997,35,4,31,3.6962700938483e-06,"cafeteria",0.487181730669513
"7835",7998,34,3,31,3.57664024721737e-06,"racquetball",0.40302737759166
"7836",7999,73,37,36,3.56488446209458e-06,"saint",0.394757698077794
"7837",8000,59,19,40,3.70107183040208e-06,"accomplished",0.490559541848866
"7838",8001,31,6,25,3.3921532710534e-06,"Advil",0.273248876928136
"7839",8002,52,16,36,3.63957970133609e-06,"curved",0.447302524585492
"7840",8004,37,5,32,3.41078079593981e-06,"components",0.286352524139969
"7841",8005,69,30,39,3.62289962394302e-06,"excel",0.435568821318004
"7842",8006,139,93,46,3.6517141146054e-06,"sauce",0.455838552403101
"7843",8007,53,28,25,3.50220989444339e-06,"grape",0.350668887102452
"7844",8008,28,6,22,3.34861417602325e-06,"protractor",0.24262103212983
"7845",8009,39,5,34,3.59528586117882e-06,"haunt",0.416143749674841
"7846",8010,55,14,41,3.48963404207801e-06,"ashes",0.341822326231428
"7847",8011,42,9,33,3.62690729987632e-06,"Frankenstein",0.438388045658844
"7848",8012,51,19,32,3.67598406093311e-06,"aids",0.472911395760865
"7849",8013,47,8,39,3.76101035782253e-06,"dare",0.532723668457405
"7850",8014,36,7,29,3.47177619541934e-06,"klutz",0.329260113913626
"7851",8015,31,2,29,3.56168481938696e-06,"head and shoulders",0.39250688969073
"7852",8017,40,2,38,3.68425900340794e-06,"parasol",0.478732455056159
"7853",8018,40,13,27,3.57929022674804e-06,"brainy",0.404891522028461
"7854",8019,46,8,38,3.61192078335338e-06,"desktop",0.427845688225504
"7855",8020,49,17,32,3.65700242824961e-06,"senses",0.45955864923625
"7856",8021,51,8,43,3.75352831661762e-06,"preppy",0.527460380448325
"7857",8022,57,20,37,3.68659517129764e-06,"photos",0.480375846759619
"7858",8023,72,34,38,3.60703516137875e-06,"uncaring",0.424408867329745
"7859",8024,32,7,25,3.18252412353286e-06,"Torah",0.125783960833419
"7860",8025,48,5,43,3.70838725946473e-06,"catchy",0.495705625519384
"7861",8026,34,3,31,3.42422364289456e-06,"avocado",0.295808977699526
"7862",8027,46,4,42,3.67524100392883e-06,"spacecraft",0.472388687730585
"7863",8028,50,21,29,3.5277599429914e-06,"pleased",0.368642226258346
"7864",8029,56,10,46,3.68379755322167e-06,"stimulate",0.478407845077988
"7865",8030,48,11,37,3.55978299562859e-06,"images",0.391169040043994
"7866",8031,49,14,35,3.58363853988231e-06,"heroic",0.407950369708205
"7867",8032,48,4,44,3.67043865412355e-06,"traffic jam",0.469010445155691
"7868",8033,53,14,39,3.54118934385303e-06,"banned",0.3780892210808
"7869",8034,42,13,29,3.62626284603613e-06,"serenity",0.437934700632188
"7870",8035,33,2,31,3.59507905578844e-06,"predicament",0.41599827114811
"7871",8036,47,13,34,3.57528477143204e-06,"leftover",0.402073859794559
"7872",8037,94,57,37,3.62618394905937e-06,"drinks",0.437879200067518
"7873",8039,41,9,32,3.64045418306388e-06,"board game",0.4479176841477
"7874",8040,44,9,35,3.66734268016738e-06,"eater",0.466832563190902
"7875",8041,42,10,32,3.57256413645766e-06,"anyone",0.400160012350311
"7876",8042,35,4,31,3.56073365356198e-06,"convert",0.391837786227627
"7877",8043,42,11,31,3.482439797322e-06,"payback",0.336761490408467
"7878",8044,63,38,25,3.55846558963775e-06,"lacking",0.390242302678511
"7879",8045,26,2,24,3.49574567751047e-06,"feely",0.346121593851935
"7880",8046,61,20,41,3.66348676015885e-06,"hold back",0.464120092490853
"7881",8047,57,13,44,3.67652465477433e-06,"donuts",0.473291679830996
"7882",8048,49,7,42,3.71888225275011e-06,"lousy",0.503088393242998
"7883",8049,41,11,30,3.47575832357225e-06,"United Kingdom",0.332061366510855
"7884",8051,59,10,49,3.73936617743293e-06,"fairy tales",0.517497936335499
"7885",8052,39,8,31,3.61447960529883e-06,"junkie",0.42964570729704
"7886",8053,37,6,31,3.4281443797287e-06,"sauna",0.298567044195112
"7887",8054,58,10,48,3.6232146609758e-06,"regime",0.435790436060781
"7888",8055,46,6,40,3.59828721528552e-06,"catapult",0.418255070723227
"7889",8056,43,7,36,3.62404189392429e-06,"heartbreak",0.436372358177923
"7890",8057,55,16,39,3.62815740398081e-06,"scholar",0.43926743909749
"7891",8058,46,5,41,3.59076741881275e-06,"opal",0.412965223538219
"7892",8059,42,7,35,3.62349036332738e-06,"clingy",0.43598438057958
"7893",8060,82,49,33,3.66466820094109e-06,"annoyed",0.464951184292181
"7894",8061,40,4,36,3.55602337018559e-06,"compliant",0.388524308349682
"7895",8062,50,12,38,3.73422755635883e-06,"rushed",0.51388314166359
"7896",8065,68,19,49,3.64972827772972e-06,"hips",0.454441603211098
"7897",8067,41,3,38,3.41706276119173e-06,"constipation",0.290771611321988
"7898",8068,62,22,40,3.6285655191933e-06,"timely",0.439554530259562
"7899",8069,36,3,33,3.45623712551671e-06,"enunciate",0.318329059399096
"7900",8070,49,16,33,3.6363239673749e-06,"answers",0.445012258460328
"7901",8072,27,3,24,3.45302675059824e-06,"hubris",0.316070701372151
"7902",8073,40,4,36,3.69143991996958e-06,"functional",0.483783915078636
"7903",8074,51,12,39,3.57588565748022e-06,"tips",0.402496556789343
"7904",8075,52,19,33,3.61348697879967e-06,"ethnicity",0.428947438067104
"7905",8076,41,5,36,3.31875294539324e-06,"hobbit",0.221614965361809
"7906",8077,80,40,40,3.67034435170708e-06,"seeds",0.468944107539487
"7907",8078,28,2,26,3.50202592199587e-06,"agitate",0.350539470550136
"7908",8079,36,7,29,3.5559601447987e-06,"Linux",0.388479832061516
"7909",8080,42,6,36,3.55859222091741e-06,"disciple",0.390331382232812
"7910",8081,51,19,32,3.69848473080579e-06,"Microsoft",0.488739630689522
"7911",8082,70,34,36,3.54135237164368e-06,"boats",0.378203903985133
"7912",8083,43,8,35,3.57697287939163e-06,"Capricorn",0.40326136974517
"7913",8084,41,13,28,3.40440598222219e-06,"puss",0.281868122132393
"7914",8086,46,10,36,3.56096188702492e-06,"pimp",0.391998338464094
"7915",8087,38,3,35,3.56572341396623e-06,"bros",0.39534786394367
"7916",8088,55,12,43,3.66875541141423e-06,"restart",0.467826357695367
"7917",8089,59,21,38,3.64374387395561e-06,"anguish",0.450231837484986
"7918",8090,63,29,34,3.53726866262946e-06,"chains",0.375331193704812
"7919",8091,45,3,42,3.65139410226825e-06,"rampage",0.455613437751797
"7920",8092,119,73,46,3.80762362402001e-06,"babies",0.565514057914289
"7921",8093,44,12,32,3.58905338716913e-06,"no one",0.411759477412268
"7922",8094,46,6,40,3.53361884973639e-06,"compelled",0.372763710325691
"7923",8095,35,2,33,3.43534002995616e-06,"lawbreaker",0.30362886870564
"7924",8096,42,7,35,3.71488964920297e-06,"bummer",0.500279771665118
"7925",8097,44,8,36,3.51795564561522e-06,"prohibition",0.361745332829896
"7926",8098,47,4,43,3.63775259644592e-06,"strokes",0.446017236387202
"7927",8099,46,12,34,3.59436834367912e-06,"muse",0.415498316333587
"7928",8100,36,2,34,3.60063227102679e-06,"state of mind",0.419904714640658
"7929",8101,37,5,32,3.60704817212834e-06,"declaration",0.424418019821746
"7930",8102,48,11,37,3.56929973908419e-06,"prediction",0.397863651894371
"7931",8103,34,3,31,3.58276546500713e-06,"microbe",0.407336199805135
"7932",8104,42,5,37,3.52059371292375e-06,"Austria",0.363601097540603
"7933",8105,35,11,24,3.34505216608853e-06,"simile",0.240115314283027
"7934",8106,45,4,41,3.63332485557534e-06,"addicted",0.442902514776721
"7935",8107,35,8,27,3.4991584523922e-06,"LSD",0.348522331380743
"7936",8108,49,6,43,3.55228429641681e-06,"squirt",0.385894033857292
"7937",8109,49,11,38,3.50180518057058e-06,"bowels",0.350384188633741
"7938",8110,47,15,32,3.56318234941991e-06,"strawberries",0.393560336424023
"7939",8111,53,21,32,3.52794662922339e-06,"seventies",0.36877355183908
"7940",8112,51,9,42,3.62337220003913e-06,"lumpy",0.435901257886039
"7941",8113,53,13,40,3.62624969630159e-06,"backyard",0.43792545037036
"7942",8114,40,10,30,3.54952294411631e-06,"puncture",0.383951543558984
"7943",8115,33,11,22,3.40277257909745e-06,"crustacean",0.280719094635081
"7944",8116,52,19,33,3.56726251841599e-06,"Native American",0.39643055645676
"7945",8117,51,12,39,3.64048068907018e-06,"hairdresser",0.447936329961234
"7946",8118,36,4,32,3.5008244441566e-06,"tunes",0.349694283557515
"7947",8119,42,12,30,3.43485623409232e-06,"app",0.303288539522831
"7948",8120,72,39,33,3.66919963748308e-06,"bees",0.468138851261954
"7949",8121,29,3,26,3.26372887551485e-06,"infuriate",0.182907944206695
"7950",8122,59,22,37,3.54509359047079e-06,"science fiction",0.380835687432026
"7951",8123,37,4,33,3.55141381784088e-06,"preschool",0.385281690336938
"7952",8124,54,14,40,3.64588270466163e-06,"Australian",0.451736411130081
"7953",8125,63,24,39,3.63530609277301e-06,"outcast",0.44429622829688
"7954",8126,47,13,34,3.65993360880434e-06,"allowance",0.461620606266908
"7955",8127,85,43,42,3.74515003071023e-06,"buildings",0.521566623578328
"7956",8128,42,7,35,3.54184154509296e-06,"lubricant",0.378548016063562
"7957",8129,35,5,30,3.53455558265382e-06,"pharaoh",0.373422660870998
"7958",8130,40,5,35,3.55321832750013e-06,"cleavage",0.386551083780745
"7959",8131,56,20,36,3.62623654666241e-06,"rainforest",0.43791620017562
"7960",8132,48,10,38,3.63516072863162e-06,"closure",0.44419397099551
"7961",8133,40,4,36,3.50595486433708e-06,"cleric",0.353303309260253
"7962",8134,47,9,38,3.59252180660737e-06,"scenic",0.414199358447371
"7963",8135,71,30,41,3.63834818992178e-06,"toxic",0.446436210289367
"7964",8136,43,15,28,3.71158050232531e-06,"brash",0.497951931894591
"7965",8137,82,35,47,3.77046893322122e-06,"cheating",0.539377361629572
"7966",8138,71,34,37,3.49652794774789e-06,"Indians",0.346671886672798
"7967",8139,40,11,29,3.54136491286472e-06,"gritty",0.378212726184379
"7968",8140,57,22,35,3.60436993811297e-06,"oily",0.422533999593501
"7969",8141,39,8,31,3.57476075913619e-06,"peppy",0.401705240114738
"7970",8142,45,7,38,3.58478188394627e-06,"singers",0.408754662138209
"7971",8143,38,4,34,3.61679349555858e-06,"cloves",0.431273427664376
"7972",8144,52,8,44,3.52457687454621e-06,"allergic",0.366403077138362
"7973",8146,41,8,33,3.63102932419282e-06,"believable",0.44128770907475
"7974",8147,70,30,40,3.65805925324378e-06,"bubbly",0.46030207929326
"7975",8148,45,11,34,3.48143351506416e-06,"Oregon",0.336053614950901
"7976",8149,35,4,31,3.49180299247516e-06,"esoteric",0.343348087758933
"7977",8150,57,12,45,3.65843397075448e-06,"diva",0.460565676636127
"7978",8151,53,26,27,3.46241205473381e-06,"gasp",0.322672851422587
"7979",8152,49,10,39,3.6122469621003e-06,"insensitive",0.428075140675777
"7980",8153,109,57,52,3.71464125852046e-06,"bugs",0.500105039708285
"7981",8154,49,7,42,3.70022275340976e-06,"grunt",0.489962253404426
"7982",8155,72,26,46,3.76785492251406e-06,"bastard",0.537538519683395
"7983",8156,34,10,24,3.59385163861665e-06,"IQ",0.415134836972134
"7984",8157,46,8,38,3.4905110457222e-06,"woven",0.34243925985128
"7985",8158,61,27,34,3.72153952647131e-06,"oral",0.504957668823097
"7986",8159,70,14,56,3.70892367035086e-06,"spying",0.496082967063971
"7987",8160,31,3,28,3.45392123678012e-06,"kerosene",0.316699933190907
"7988",8161,37,8,29,3.40648185367117e-06,"nightclub",0.283328406700007
"7989",8162,50,11,39,3.66075089322322e-06,"Brazil",0.462195530029568
"7990",8163,41,5,36,3.52833251005575e-06,"West Coast",0.369045002089385
"7991",8164,43,15,28,3.69996263037743e-06,"booger",0.489779268253795
"7992",8165,70,32,38,3.65287462968983e-06,"prostitute",0.456654923893313
"7993",8166,58,30,28,3.64407582592979e-06,"savings",0.450465351147556
"7994",8168,36,6,30,3.50840262428516e-06,"teepee",0.355025201085097
"7995",8169,42,8,34,3.52985195800888e-06,"revelation",0.370113867118745
"7996",8170,65,24,41,3.67432273046271e-06,"teenage",0.471742722600089
"7997",8171,37,4,33,3.46524360662555e-06,"so so",0.324664724056099
"7998",8172,33,3,30,3.40926912088586e-06,"pm",0.285289127004462
"7999",8173,32,6,26,3.39519376370809e-06,"amplifier",0.275387730229381
"8000",8174,34,5,29,3.51496319833531e-06,"kernel",0.359640277343726
"8001",8175,45,10,35,3.52360817477097e-06,"doormat",0.365721639309858
"8002",8176,77,39,38,3.66233290606116e-06,"Mexican",0.463308406712832
"8003",8177,44,10,34,3.54149032996065e-06,"podium",0.378300951613658
"8004",8178,46,7,39,3.6611529702934e-06,"exceed",0.46247837362322
"8005",8179,47,17,30,3.49214442112468e-06,"not real",0.343588267847192
"8006",8180,38,4,34,3.50391562571173e-06,"stationery",0.351868794278247
"8007",8181,37,5,32,3.61098171759956e-06,"blimp",0.427185096632056
"8008",8182,54,14,40,3.65706929780612e-06,"to do",0.459605689037999
"8009",8183,93,46,47,3.79156982365409e-06,"organized",0.554220913082268
"8010",8184,48,13,35,3.53207120655552e-06,"thrifty",0.371675011189571
"8011",8186,50,5,45,3.64823698947484e-06,"barbarian",0.453392547295063
"8012",8187,24,3,21,3.43042581875688e-06,"Yiddish",0.300171936543556
"8013",8188,30,3,27,3.47872066568799e-06,"opossum",0.334145244333708
"8014",8189,36,6,30,3.51201283991894e-06,"perspiration",0.357564829528069
"8015",8190,48,13,35,3.64314651278016e-06,"orphan",0.449811620083644
"8016",8191,41,3,38,3.48840454329808e-06,"amplify",0.340957427735368
"8017",8193,71,31,40,3.63325885152688e-06,"Spain",0.442856083821946
"8018",8194,43,7,36,3.49323012002739e-06,"obviously",0.344352009433157
"8019",8195,77,45,32,3.56661364301051e-06,"ships",0.39597410105274
"8020",8196,43,5,38,3.68930176274838e-06,"bio",0.482279815200584
"8021",8197,50,15,35,3.5984425940453e-06,"warfare",0.418364372869631
"8022",8198,37,3,34,3.58037952022914e-06,"bad mood",0.405657792242762
"8023",8199,40,8,32,3.65127411210142e-06,"unattractive",0.455529029929256
"8024",8200,30,4,26,3.46407923042016e-06,"ailment",0.323845636436553
"8025",8201,51,9,42,3.71486204859783e-06,"bundle",0.500260355849283
"8026",8202,40,4,36,3.48904961777461e-06,"raspberries",0.341411209352488
"8027",8203,50,10,40,3.5480620485091e-06,"slur",0.382923867538316
"8028",8204,61,24,37,3.68602443834203e-06,"limited",0.479974361143672
"8029",8205,33,3,30,3.50740588753152e-06,"beetroot",0.354324040471306
"8030",8206,49,6,43,3.63218991994653e-06,"housewife",0.442104137312261
"8031",8207,48,5,43,3.53605538877161e-06,"distinguished",0.374477708730205
"8032",8208,45,7,38,3.60266885708933e-06,"vortex",0.421337363661008
"8033",8209,35,6,29,3.48422343628052e-06,"detain",0.338016202229185
"8034",8210,52,16,36,3.67660575756462e-06,"varnish",0.473348732088783
"8035",8211,46,14,32,3.59744581347243e-06,"furnace",0.417663181430938
"8036",8212,63,25,38,3.69405810753403e-06,"unimportant",0.485625695260821
"8037",8213,73,39,34,3.60006192106504e-06,"Google",0.419503498444109
"8038",8214,47,16,31,3.57224508459076e-06,"submissive",0.399935573347729
"8039",8215,51,13,38,3.64241667061262e-06,"dripping",0.449298208111733
"8040",8216,49,9,40,3.68192579446754e-06,"atheism",0.477091144843828
"8041",8217,48,10,38,3.45572354211663e-06,"jellyfish",0.317967775990297
"8042",8218,71,34,37,3.63200523008753e-06,"Japanese",0.441974216092413
"8043",8219,50,13,37,3.66237314455021e-06,"fatal",0.463336712726003
"8044",8220,60,25,35,3.65039442511763e-06,"allowed",0.45491020869763
"8045",8221,40,3,37,3.5983907996344e-06,"wanker",0.418327937771998
"8046",8222,54,19,35,3.43539903877535e-06,"cowboys",0.303670378823258
"8047",8223,57,13,44,3.64697301239971e-06,"old age",0.452503394829702
"8048",8224,64,14,50,3.61698972413219e-06,"exile",0.431411465864149
"8049",8225,79,37,42,3.71501385700169e-06,"old fashioned",0.500367146406811
"8050",8226,54,20,34,3.59043221623019e-06,"stealing",0.412729423215142
"8051",8227,41,5,36,3.69617445943449e-06,"ambiance",0.487114456051573
"8052",8228,42,3,39,3.41814900395138e-06,"allspice",0.291535735487468
"8053",8229,116,84,32,3.70913002355298e-06,"clouds",0.496228127496073
"8054",8230,62,21,41,3.69795133496043e-06,"ruined",0.488364410093955
"8055",8231,48,5,43,3.69186239690474e-06,"prestigious",0.484081109083059
"8056",8232,40,4,36,3.59228950979617e-06,"instinctive",0.41403594782353
"8057",8233,88,52,36,3.70115401982338e-06,"Disney",0.490617358503939
"8058",8234,49,7,42,3.69527300676974e-06,"fingernails",0.486480323617499
"8059",8235,69,31,38,3.54205481684035e-06,"Star Wars",0.37869804338899
"8060",8236,31,2,29,3.58012315623657e-06,"rocker",0.405477451411817
"8061",8237,61,20,41,3.59187661185463e-06,"said",0.413745492221217
"8062",8238,59,22,37,3.67629488296515e-06,"prepared",0.473130045435385
"8063",8239,39,4,35,3.64588270466163e-06,"give away",0.451736411130081
"8064",8240,42,3,39,3.7404991322042e-06,"ecological",0.518294920353521
"8065",8241,46,5,41,3.62680206727718e-06,"demolition",0.438314019138263
"8066",8242,45,8,37,3.58435786228897e-06,"mystic",0.408456381489474
"8067",8243,40,7,33,3.52527267984179e-06,"airhead",0.366892545662868
"8068",8244,50,2,48,3.69520473281822e-06,"logistics",0.486432295885425
"8069",8245,52,10,42,3.71574547143521e-06,"disadvantage",0.500881805090152
"8070",8246,34,8,26,3.42542004213267e-06,"cornflakes",0.296650592118843
"8071",8247,49,15,34,3.53947219390644e-06,"have to",0.376881281365404
"8072",8248,57,11,46,3.81683759737707e-06,"long hair",0.571995684272399
"8073",8249,39,6,33,3.70060615928889e-06,"streak",0.490231962633633
"8074",8250,32,6,26,3.61229915616692e-06,"eon",0.428111856913689
"8075",8251,41,2,39,3.4848669652036e-06,"footprints",0.338468896617199
"8076",8252,53,14,39,3.57885469492053e-06,"sheer",0.404585144479542
"8077",8253,41,9,32,3.61736915975749e-06,"delayed",0.431678382193818
"8078",8254,44,10,34,3.57803515777346e-06,"hash",0.404008636021349
"8079",8255,41,8,33,3.51798039781322e-06,"hippo",0.361762744916168
"8080",8256,53,20,33,3.69482244530739e-06,"lessen",0.486163373379296
"8081",8257,42,5,37,3.505659887889e-06,"confinement",0.353095806259452
"8082",8258,31,8,23,3.48193052155837e-06,"shard",0.33640323723308
"8083",8259,71,20,51,3.64122301398594e-06,"signs",0.448458522999327
"8084",8260,55,5,50,3.6931031299049e-06,"sporty",0.484953910360593
"8085",8261,44,7,37,3.64710602137204e-06,"premium",0.452596960811231
"8086",8262,27,2,25,3.40902505292511e-06,"bless you",0.285117435892901
"8087",8263,41,9,32,3.5936191698021e-06,"chimp",0.414971305351467
"8088",8264,39,5,34,3.63813640100995e-06,"baptism",0.446287226073756
"8089",8265,40,5,35,3.57315134082504e-06,"seaman",0.400573084882402
"8090",8266,37,3,34,3.43994881356165e-06,"incognito",0.306870945944043
"8091",8267,55,10,45,3.5985850363637e-06,"gelatin",0.418464574796607
"8092",8268,34,2,32,3.57094394332198e-06,"mileage",0.399020277501238
"8093",8269,38,2,36,3.50927677314982e-06,"trashed",0.355640126492684
"8094",8270,51,14,37,3.52866866859802e-06,"graphic",0.369281474888219
"8095",8271,40,3,37,3.54929617456858e-06,"Peru",0.3837920211227
"8096",8272,24,3,21,3.36370761307944e-06,"loath",0.253238603471399
"8097",8273,66,25,41,3.71951854551947e-06,"manly",0.503535997314066
"8098",8274,36,2,34,3.6255923311471e-06,"renegade",0.43746302280007
"8099",8275,47,4,43,3.59758817688621e-06,"hoarding",0.417763327851969
"8100",8276,34,8,26,3.45401667599251e-06,"genome",0.316767070493207
"8101",8277,50,15,35,3.69134453533355e-06,"tequila",0.483716816168414
"8102",8278,50,17,33,3.65983984540836e-06,"feminism",0.461554647828002
"8103",8279,36,11,25,3.57347055460263e-06,"subscription",0.40079763778206
"8104",8280,53,20,33,3.67433623115984e-06,"disrespect",0.471752219748713
"8105",8282,43,9,34,3.59526000920387e-06,"broker",0.416125563943692
"8106",8283,41,8,33,3.59130903214222e-06,"cloister",0.41334622477364
"8107",8285,45,12,33,3.56908317391428e-06,"whirl",0.397711307790573
"8108",8286,42,10,32,3.42054585070686e-06,"Louisiana",0.293221812113112
"8109",8287,41,7,34,3.60599460543207e-06,"funnel",0.423676881834481
"8110",8288,33,9,24,3.47377818536775e-06,"Hoover",0.330668426084224
"8111",8289,56,18,38,3.63013300807342e-06,"easygoing",0.44065718997516
"8112",8290,44,11,33,3.47927742366465e-06,"dialect",0.334536899164562
"8113",8291,98,63,35,3.59862388622591e-06,"a lot",0.418491903971668
"8114",8292,30,8,22,3.36509987616432e-06,"vogue",0.25421799952115
"8115",8293,39,8,31,3.48298561526941e-06,"carnivore",0.337145449408296
"8116",8294,63,26,37,3.77848981319146e-06,"gifts",0.545019699089831
"8117",8295,27,3,24,3.57006429685799e-06,"echidna",0.398401484773511
"8118",8296,47,15,32,3.5909737284362e-06,"consciousness",0.413110353314646
"8119",8297,59,22,37,3.6467868161363e-06,"sarcastic",0.452372413920391
"8120",8298,37,5,32,3.56466843236576e-06,"augment",0.394605730633328
"8121",8299,35,11,24,3.54959854040508e-06,"grains",0.384004722234336
"8122",8300,38,2,36,3.68947871355256e-06,"bittersweet",0.482404292334608
"8123",8301,46,9,37,3.61083829221792e-06,"sunscreen",0.427084203163185
"8124",8302,22,2,20,3.35211635866304e-06,"sumo",0.245084664097204
"8125",8303,59,14,45,3.65970590603339e-06,"Photoshop",0.461460427348999
"8126",8304,28,3,25,3.51882217983996e-06,"Belgian",0.362354901672094
"8127",8305,37,4,33,3.51674321444397e-06,"blood pressure",0.360892440648374
"8128",8306,58,21,37,3.65545174072612e-06,"sleek",0.458467808538542
"8129",8307,42,16,26,3.55814905086374e-06,"fortitude",0.390019631526613
"8130",8308,47,16,31,3.54211754871297e-06,"booty",0.378742172511503
"8131",8309,85,52,33,3.64952848092027e-06,"Rome",0.454301054913826
"8132",8310,62,27,35,3.59165729842721e-06,"guts",0.41359121483873
"8133",8311,36,5,31,3.50154768407636e-06,"occasional",0.350203051137528
"8134",8312,66,31,35,3.50132700293411e-06,"Freud",0.35004781162761
"8135",8313,49,18,31,3.6638894384723e-06,"let go",0.464403359032788
"8136",8314,27,5,22,3.58146947692638e-06,"daffodil",0.406424529000537
"8137",8315,31,8,23,3.58238042014158e-06,"terrified",0.407065337620829
"8138",8316,49,10,39,3.62755198281991e-06,"hairdo",0.4388415518497
"8139",8317,52,11,41,3.66591759750424e-06,"tournament",0.465830080006513
"8140",8319,42,11,31,3.377511179562e-06,"eradicate",0.262948807406468
"8141",8320,49,11,38,3.57644837217952e-06,"rookie",0.402892401913459
"8142",8321,39,5,34,3.48934180545524e-06,"says",0.341616750577631
"8143",8322,37,9,28,3.48842888140039e-06,"edible",0.340974548523477
"8144",8323,39,4,35,3.77132211239294e-06,"adored",0.539977535777391
"8145",8325,33,9,24,3.34125210081226e-06,"oink",0.237442134938704
"8146",8326,66,27,39,3.63728949187066e-06,"buttons",0.445691462618901
"8147",8327,34,4,30,3.53930933917555e-06,"facial hair",0.376766720201031
"8148",8328,33,3,30,3.47583081045947e-06,"monsoon",0.332112357858523
"8149",8329,53,10,43,3.66017473674193e-06,"excellence",0.461790229201057
"8150",8330,69,30,39,3.72151182696459e-06,"hard work",0.504938183434336
"8151",8331,43,3,40,3.55446867802201e-06,"bedsheets",0.387430650563219
"8152",8332,52,16,36,3.66509800472065e-06,"dreaming",0.465253532410463
"8153",8333,44,9,35,3.39097999321804e-06,"eyelid",0.272423527402112
"8154",8334,42,3,39,3.59785999287624e-06,"incest",0.417954538485776
"8155",8335,54,13,41,3.71158050232531e-06,"foreigner",0.497951931894591
"8156",8336,41,4,37,3.52065568691513e-06,"colder",0.363644693526884
"8157",8337,28,2,26,3.61098171759956e-06,"Isaac",0.427185096632056
"8158",8338,48,6,42,3.63760703658705e-06,"whirlwind",0.445914841407172
"8159",8339,68,31,37,3.67985280588776e-06,"sticks",0.475632888248324
"8160",8340,39,4,35,3.39079602327442e-06,"penance",0.272294112611181
"8161",8342,42,11,31,3.5150126188953e-06,"eyeliner",0.359675042541305
"8162",8343,44,3,41,3.5763204669244e-06,"chanting",0.402802426173263
"8163",8344,44,4,40,3.57752313763089e-06,"pasty",0.403648452295681
"8164",8345,36,4,32,3.38333908500978e-06,"Korea",0.267048483420175
"8165",8346,38,4,34,3.61559042591655e-06,"puma",0.430427120908299
"8166",8347,29,2,27,3.4198673775431e-06,"molecular",0.292744535983579
"8167",8348,50,16,34,3.35925558896149e-06,"Caribbean",0.250106799660856
"8168",8349,43,7,36,3.58514173857863e-06,"snails",0.40900780409769
"8169",8351,55,17,38,3.6174738456641e-06,"skeptical",0.431752024140162
"8170",8352,47,10,37,3.57742075118681e-06,"took",0.403576427920423
"8171",8353,42,2,40,3.59350294667242e-06,"toxins",0.414889547474427
"8172",8354,36,3,33,3.53613041248961e-06,"cortisone",0.374530484627123
"8173",8355,42,4,38,3.60634572593936e-06,"shitty",0.42392387971984
"8174",8356,65,21,44,3.62674945326752e-06,"glowing",0.438277007488827
"8175",8357,43,2,41,3.71846739647787e-06,"best friend",0.502796560040881
"8176",8358,58,13,45,3.66006756484725e-06,"slaves",0.461714838471073
"8177",8359,44,6,38,3.64189932333511e-06,"isle",0.448934276980148
"8178",8360,33,2,31,3.46140533056421e-06,"hearsay",0.32196466509947
"8179",8361,62,27,35,3.64378370499927e-06,"pigs",0.450259856878189
"8180",8362,56,6,50,3.77646356845596e-06,"radar",0.54359432473973
"8181",8363,48,4,44,3.67713301293248e-06,"defender",0.473719633127602
"8182",8364,67,28,39,3.62263713492874e-06,"disability",0.435384171802782
"8183",8365,48,5,43,3.58960736874601e-06,"batteries",0.412149179167571
"8184",8366,45,7,38,3.67753869690094e-06,"adolescence",0.474005014016078
"8185",8367,143,103,40,3.73907256044211e-06,"lights",0.517291389653289
"8186",8368,49,11,38,3.57435188064524e-06,"tailor",0.401417612019721
"8187",8369,41,3,38,3.68911121932504e-06,"crosswalk",0.482145776254818
"8188",8370,33,4,29,3.40703894245511e-06,"get better",0.283720294239282
"8189",8372,27,4,23,3.37933737952662e-06,"cantaloupe",0.264233459029297
"8190",8373,27,6,21,3.31772894818039e-06,"impede",0.220894628209939
"8191",8374,38,4,34,3.62195484146704e-06,"butch",0.434904208261106
"8192",8375,41,3,38,3.60726936923288e-06,"contaminate",0.424573622288517
"8193",8377,51,5,46,3.60676195731758e-06,"masked",0.424216680248729
"8194",8378,40,12,28,3.36376418667546e-06,"wail",0.253278400516268
"8195",8381,38,6,32,3.60888362793853e-06,"sector",0.425709182526205
"8196",8382,44,4,40,3.61672809076541e-06,"hummus",0.431227418259429
"8197",8383,72,33,39,3.6396326882691e-06,"Hollywood",0.447339798570159
"8198",8384,37,7,30,3.57941834451902e-06,"hold on",0.404981647264247
"8199",8385,43,5,38,3.62173183973112e-06,"boardwalk",0.43474733631527
"8200",8386,30,2,28,3.61819372532844e-06,"haunting",0.432258427927787
"8201",8387,40,9,31,3.4503698796511e-06,"June",0.314201709125947
"8202",8388,48,9,39,3.63726303231345e-06,"wipe out",0.445672849480268
"8203",8389,45,12,33,3.69378520639025e-06,"urinate",0.485433721268911
"8204",8390,124,79,45,3.79220247327445e-06,"bones",0.554665954357721
"8205",8391,43,7,36,3.65359532047511e-06,"impaired",0.457161898268959
"8206",8392,43,4,39,3.70824974320371e-06,"tourists",0.495608888857838
"8207",8393,39,5,34,3.60980857185143e-06,"mainstream",0.426359840023607
"8208",8394,43,8,35,3.70979050813001e-06,"pornography",0.496692749443381
"8209",8395,60,25,35,3.58596453481075e-06,"tacky",0.409586605179348
"8210",8396,48,7,41,3.65188747804303e-06,"gardener",0.455960505982011
"8211",8398,60,17,43,3.71756885866918e-06,"caveman",0.502164478080273
"8212",8399,57,24,33,3.62790731422394e-06,"presents",0.439091511916321
"8213",8400,46,10,36,3.78542686366028e-06,"younger",0.549899610005981
"8214",8401,58,11,47,3.66952277856265e-06,"rebirth",0.468366166846402
"8215",8402,63,32,31,3.60742552470004e-06,"holidays",0.424683470814524
"8216",8403,40,3,37,3.4565835819193e-06,"pretzels",0.318572776291253
"8217",8404,77,39,38,3.58145665004871e-06,"lying",0.406415505854365
"8218",8405,35,4,31,3.62551346334425e-06,"whoops",0.437407542757966
"8219",8406,65,15,50,3.71524849439555e-06,"global warming",0.500532203527959
"8220",8407,50,15,35,3.38348790233901e-06,"basil",0.267153169887814
"8221",8408,62,12,50,3.69530031705677e-06,"campfire",0.486499535207264
"8222",8409,40,8,32,3.4878448606606e-06,"rowing",0.340563715533836
"8223",8410,54,14,40,3.66936120090853e-06,"unemployed",0.46825250404956
"8224",8411,66,19,47,3.75264092104819e-06,"tablecloth",0.526836136564604
"8225",8412,48,10,38,3.64511190493548e-06,"vengeance",0.451194187311084
"8226",8413,38,9,29,3.36207910972145e-06,"occasionally",0.252093022745216
"8227",8414,44,5,39,3.63025161273928e-06,"pianist",0.440740623158507
"8228",8416,45,10,35,3.60117686459935e-06,"crotch",0.420287812346454
"8229",8417,47,15,32,3.41192125285748e-06,"North Pole",0.287154785589124
"8230",8418,33,4,29,3.45430302527859e-06,"procreate",0.316968504663716
"8231",8419,42,8,34,3.39437551976375e-06,"veggie",0.274812131482619
"8232",8420,32,5,27,3.48304627226973e-06,"dealer",0.337188118949093
"8233",8421,35,6,29,3.52993917914794e-06,"lard",0.370175223366698
"8234",8422,33,3,30,3.5573010045818e-06,"tentacles",0.389423068141753
"8235",8423,35,5,30,3.33626925027357e-06,"cilantro",0.233936918010187
"8236",8424,35,3,32,3.5210027815922e-06,"eggnog",0.363888859417152
"8237",8425,35,10,25,3.3836023861164e-06,"lunar",0.267233704206766
"8238",8426,54,15,39,3.60603361544536e-06,"taking",0.423704323668812
"8239",8427,30,3,27,3.21819697296393e-06,"improbable",0.150878246673116
"8240",8428,36,7,29,3.44485476492311e-06,"sax",0.31032206767229
"8241",8429,50,10,40,3.5830093695695e-06,"intolerant",0.407507775973099
"8242",8430,55,13,42,3.62381863512495e-06,"involved",0.436215305399232
"8243",8431,31,3,28,3.49526915320114e-06,"mutiny",0.345786379888977
"8244",8433,41,3,38,3.66025511978185e-06,"skater",0.461846775146012
"8245",8434,66,19,47,3.68753318779869e-06,"dedicated",0.481035700249738
"8246",8435,44,6,38,3.49327893133611e-06,"gladiator",0.344386346049178
"8247",8436,41,4,37,3.5227268724174e-06,"martial art",0.365101681736402
"8248",8438,57,22,35,3.51731221070107e-06,"Buddha",0.361292704573044
"8249",8439,55,12,43,3.75081111290317e-06,"dedication",0.525548946745027
"8250",8441,42,13,29,3.74432267075047e-06,"fowl",0.520984612114328
"8251",8442,51,11,40,3.66769239797397e-06,"starter",0.467078574337803
"8252",8443,49,14,35,3.58875714162671e-06,"prostitution",0.411551081659228
"8253",8444,39,8,31,3.61829845896669e-06,"not nice",0.432332103451246
"8254",8445,43,6,37,3.43518661651294e-06,"concave",0.303520949073278
"8255",8446,40,9,31,3.62943471554305e-06,"wink",0.440165971790011
"8256",8447,37,4,33,3.69538225033997e-06,"down under",0.486557171680419
"8257",8448,37,4,33,3.6159434177174e-06,"celestial",0.430675435166644
"8258",8449,48,15,33,3.54057498937828e-06,"belly button",0.377657049638312
"8259",8450,40,12,28,3.51151953985048e-06,"mortal",0.357217814553931
"8260",8451,47,8,39,3.56866285771384e-06,"swimsuit",0.397415633768308
"8261",8452,37,3,34,3.6064757879248e-06,"deranged",0.424015372625269
"8262",8453,56,15,41,3.65587938522732e-06,"brute",0.458768637699154
"8263",8454,50,13,37,3.66778656416426e-06,"exhaustion",0.467144816124857
"8264",8455,54,16,38,3.58372843939378e-06,"tasteless",0.408013610073734
"8265",8456,46,3,43,3.67893222671052e-06,"poetic",0.474985301151126
"8266",8458,53,18,35,3.4944263899081e-06,"post office",0.345193532855219
"8267",8459,63,27,36,3.6941263391208e-06,"tires",0.48567369319115
"8268",8460,42,10,32,3.62592098392992e-06,"gnome",0.437694215626142
"8269",8461,38,11,27,3.45026273750746e-06,"searching",0.314126339324521
"8270",8462,29,4,25,3.61599571866107e-06,"pinball",0.43071222658788
"8271",8463,36,8,28,3.40619177540934e-06,"ransom",0.283124349358521
"8272",8465,45,10,35,3.41214245012301e-06,"junk food",0.28731038816914
"8273",8466,120,72,48,3.749882816162e-06,"asshole",0.52489593067991
"8274",8467,69,29,40,3.82763398632769e-06,"desperate",0.579590470634698
"8275",8468,33,3,30,3.49782435325228e-06,"haphazard",0.347583851116631
"8276",8469,40,4,36,3.61526364310117e-06,"wither",0.430197243522348
"8277",8470,53,11,42,3.66084470330684e-06,"uplifting",0.462261521311191
"8278",8471,36,7,29,3.45352760577292e-06,"idiom",0.31642303103233
"8279",8472,40,9,31,3.36360578540195e-06,"fastener",0.253166972163946
"8280",8473,46,12,34,3.72765735373604e-06,"breezy",0.509261292126186
"8281",8474,27,2,25,3.29038286895063e-06,"precedent",0.201657860199226
"8282",8475,35,6,29,3.4784423535141e-06,"February",0.333949463919313
"8283",8476,46,10,36,3.55371078480149e-06,"decor",0.386897505905167
"8284",8477,52,6,46,3.78542686366028e-06,"imperfection",0.549899610005981
"8285",8478,52,15,37,3.58379265609209e-06,"speakers",0.40805878370603
"8286",8479,35,3,32,3.40897856775174e-06,"torpedo",0.285084735611133
"8287",8480,59,25,34,3.65479710393877e-06,"unclean",0.458007300254938
"8288",8481,32,5,27,3.33540128212825e-06,"Arizona",0.23332634046772
"8289",8482,50,21,29,3.52521054319969e-06,"enthusiastic",0.366848835258942
"8290",8483,31,2,29,3.44006715011077e-06,"in fact",0.306954190519012
"8291",8485,39,2,37,3.68462553150723e-06,"avid",0.478990291507091
"8292",8486,42,9,33,3.60756867908873e-06,"killed",0.424784173651728
"8293",8488,50,5,45,3.70358025102867e-06,"charged",0.492324105801946
"8294",8489,46,9,37,3.65250105009405e-06,"biker",0.456392127023706
"8295",8490,36,7,29,3.60098234798453e-06,"infatuation",0.420150978434649
"8296",8491,39,12,27,3.52273928206573e-06,"ecstatic",0.365110411380022
"8297",8492,54,16,38,3.63846733202106e-06,"e-mail",0.446520021533567
"8298",8493,57,22,35,3.65557200562958e-06,"Batman",0.458552409626263
"8299",8496,18,2,16,3.24888400834313e-06,"constrictor",0.17246523088268
"8300",8498,35,6,29,3.48758941307358e-06,"biceps",0.340384019354025
"8301",8500,32,8,24,3.54710556186152e-06,"hump",0.382251021109755
"8302",8501,41,4,37,3.50843955134075e-06,"enzyme",0.355051177649989
"8303",8502,39,9,30,3.57681934916195e-06,"slate",0.403153367958658
"8304",8503,54,21,33,3.41764667685125e-06,"CD",0.291182370392259
"8305",8504,43,6,37,3.48285217730504e-06,"termites",0.337051581649673
"8306",8505,42,11,31,3.55564405158528e-06,"hurts",0.388257474341965
"8307",8506,35,6,29,3.37364843209689e-06,"morphine",0.260231533889997
"8308",8508,31,8,23,3.47028223805442e-06,"external",0.328209180395685
"8309",8509,32,4,28,3.55757942296062e-06,"poultry",0.389618923266656
"8310",8511,44,4,40,3.59761406235385e-06,"limestone",0.417781537143747
"8311",8512,83,49,34,3.65538493031009e-06,"trump",0.458420810339528
"8312",8514,33,5,28,3.32281109818907e-06,"evaporate",0.22446969796276
"8313",8515,40,2,38,3.63251976998885e-06,"Pokemon",0.442336172357907
"8314",8516,48,5,43,3.73764707641246e-06,"hype",0.516288624125149
"8315",8517,61,12,49,3.70304538452423e-06,"workshop",0.491947850662183
"8316",8518,35,8,27,3.51751016560438e-06,"hoax",0.361431957170081
"8317",8519,47,4,43,3.59560904223762e-06,"reconcile",0.416371093382921
"8318",8520,40,6,34,3.69945617994155e-06,"ponytail",0.489423002572628
"8319",8521,43,6,37,3.67494386523246e-06,"Latino",0.472179663682892
"8320",8522,48,19,29,3.7015787233255e-06,"good-looking",0.490916118800613
"8321",8523,45,6,39,3.57412192759544e-06,"tendon",0.401255850129278
"8322",8524,41,5,36,3.69532762774748e-06,"fodder",0.486518747081002
"8323",8525,33,4,29,3.64749180226217e-06,"flip flops",0.452868340756565
"8324",8526,71,35,36,3.74703047834591e-06,"bullshit",0.522889436059779
"8325",8528,51,11,40,3.6816817922427e-06,"refugee",0.476919499974597
"8326",8529,49,11,38,3.54619989219552e-06,"publicity",0.381613922200154
"8327",8530,42,6,36,3.58676197888832e-06,"oxen",0.410147572131606
"8328",8531,39,6,33,3.59554440137781e-06,"ex",0.416325621371607
"8329",8532,45,3,42,3.65979966256647e-06,"good news",0.461526380960162
"8330",8533,97,55,42,3.72336860604526e-06,"pills",0.506244346124863
"8331",8534,51,21,30,3.39520529108793e-06,"bowel",0.275395839235784
"8332",8535,69,21,48,3.76265191707115e-06,"flies",0.533878433430341
"8333",8536,50,13,37,3.578739424825e-06,"shorten",0.40450405702025
"8334",8537,42,4,38,3.59041932507298e-06,"neurotic",0.412720354851131
"8335",8538,29,2,27,3.62985629398932e-06,"ladybird",0.440462533746883
"8336",8539,41,10,31,3.59652719334211e-06,"illicit",0.417016972437371
"8337",8540,51,11,40,3.46217230539129e-06,"claustrophobia",0.322504198269646
"8338",8541,52,2,50,3.75054382885518e-06,"old person",0.525360924133786
"8339",8542,52,12,40,3.71994747434166e-06,"rejection",0.503837729938195
"8340",8543,101,50,51,3.75231705578195e-06,"fields",0.52660831154658
"8341",8544,33,4,29,3.44173656260003e-06,"frosty",0.308128549025771
"8342",8545,48,4,44,3.78792183244507e-06,"forgiving",0.551654711178023
"8343",8546,36,2,34,3.54491765156295e-06,"babbling",0.380711922122724
"8344",8547,40,9,31,3.7120627190117e-06,"insomnia",0.498291150195289
"8345",8548,42,6,36,3.5847433323774e-06,"sailors",0.408727542799434
"8346",8549,56,16,40,3.59682472313442e-06,"give in",0.417226271603911
"8347",8550,42,2,40,3.50871037350222e-06,"masonry",0.355241689168974
"8348",8551,36,11,25,3.50815646377828e-06,"pinnacle",0.354852037959062
"8349",8552,57,18,39,3.7400654511454e-06,"explosive",0.51798984473925
"8350",8553,42,10,32,3.50992959081241e-06,"mollusk",0.356099355101764
"8351",8554,41,5,36,3.71928336848056e-06,"swanky",0.503370560576284
"8352",8555,33,8,25,3.45763532320246e-06,"contraception",0.319312630180413
"8353",8556,50,3,47,3.63422274878072e-06,"saucy",0.443534143287162
"8354",8557,48,6,42,3.63240101707228e-06,"bravo",0.442252634886691
"8355",8558,43,9,34,3.45271677019062e-06,"inject",0.315852643743523
"8356",8559,31,4,27,3.34347520813133e-06,"trowel",0.239005993486784
"8357",8560,71,23,48,3.71459986330272e-06,"traveling",0.500075919987187
"8358",8561,52,9,43,3.73251317577151e-06,"imperial",0.512677150071039
"8359",8562,44,9,35,3.62955327458296e-06,"swimming pool",0.4402493728775
"8360",8563,37,8,29,3.46841659845447e-06,"cheetah",0.326896784718256
"8361",8564,36,2,34,3.4433245987666e-06,"poncho",0.309245662856692
"8362",8565,48,19,29,3.55204455684692e-06,"dodge",0.385725387578964
"8363",8566,47,7,40,3.51073054791972e-06,"sewage",0.356662793316448
"8364",8567,43,11,32,3.7862581546535e-06,"smiles",0.550484386779705
"8365",8569,48,5,43,3.64052044880336e-06,"imperialism",0.447964299190638
"8366",8570,62,21,41,3.61059058430187e-06,"muddy",0.426909951502631
"8367",8571,31,3,28,3.53448062574445e-06,"showers",0.373369931971029
"8368",8572,35,3,32,3.42894371388894e-06,"schematic",0.299129340737676
"8369",8573,41,13,28,3.34816570741719e-06,"for sure",0.242305554124285
"8370",8574,51,3,48,3.57303643782559e-06,"cheeseburger",0.400492255659114
"8371",8575,63,31,32,3.6819122379399e-06,"TV show",0.477081608420889
"8372",8576,45,19,26,3.50992959081241e-06,"fizzy",0.356099355101764
"8373",8578,31,3,28,3.56319504573361e-06,"fauna",0.393569267724158
"8374",8579,61,16,45,3.68697575813439e-06,"pipes",0.480643572916078
"8375",8581,40,7,33,3.56292844214517e-06,"nebulous",0.393381723786376
"8376",8582,80,38,42,3.6458428277157e-06,"horns",0.451708359446644
"8377",8583,40,8,32,3.40926912088586e-06,"sulfur",0.285289127004462
"8378",8584,40,6,34,3.64438127516901e-06,"sappy",0.450680221297847
"8379",8585,41,11,30,3.67066769445362e-06,"diabetes",0.469171564987809
"8380",8586,37,5,32,3.56679174216376e-06,"domination",0.396099385999997
"8381",8587,34,3,31,3.50633594905995e-06,"lisp",0.353571385657779
"8382",8588,62,17,45,3.77066797383156e-06,"genes",0.539517377973914
"8383",8589,53,8,45,3.64557700370026e-06,"treachery",0.451521363904296
"8384",8590,40,5,35,3.69800603514585e-06,"panty",0.48840288927659
"8385",8591,35,2,33,3.39467511261835e-06,"pretending",0.275022881923042
"8386",8592,39,3,36,3.42362575662129e-06,"too many",0.295388390914887
"8387",8593,40,8,32,3.60359061769147e-06,"pessimist",0.421985781838829
"8388",8594,52,21,31,3.47794634224383e-06,"applause",0.333600541733554
"8389",8596,48,12,36,3.7104787630748e-06,"suspenders",0.497176906627086
"8390",8597,41,7,34,3.47758349677976e-06,"gravestone",0.333345295855069
"8391",8598,29,5,24,3.54307134682771e-06,"elongate",0.379413127675062
"8392",8599,63,22,41,3.61633571167679e-06,"old man",0.430951396770694
"8393",8600,99,63,36,3.78512596899225e-06,"porn",0.549687943796871
"8394",8601,42,7,35,3.64666712857784e-06,"road trip",0.452288218969567
"8395",8602,93,58,35,3.73830378204194e-06,"boobs",0.516750587748508
"8396",8603,38,5,33,3.51961481335483e-06,"paranoia",0.362912484604361
"8397",8604,41,11,30,3.54151541444584e-06,"ripped",0.378318597449398
"8398",8605,30,7,23,3.52001126403605e-06,"detest",0.363191370280008
"8399",8606,35,8,27,3.35965059633798e-06,"rind",0.250384670034898
"8400",8607,38,3,35,3.65146076687979e-06,"figs",0.455660333383746
"8401",8608,33,6,27,3.58268844941244e-06,"leave out",0.407282022710282
"8402",8609,48,9,39,3.5631696531967e-06,"palm trees",0.393551405187535
"8403",8610,53,17,36,3.53873320428753e-06,"humans",0.376361434562432
"8404",8611,46,9,37,3.61844247761993e-06,"abrasive",0.432433414260685
"8405",8612,70,24,46,3.73694870664205e-06,"driven",0.515797351605017
"8406",8613,52,11,41,3.64148820339897e-06,"newbie",0.448645072126697
"8407",8614,285,245,40,3.94824638636749e-06,"books",0.664436006965036
"8408",8615,32,4,28,3.48922005464119e-06,"saturate",0.341531104216946
"8409",8616,46,9,37,3.55757942296062e-06,"mostly",0.389618923266656
"8410",8617,55,15,40,3.72799087387834e-06,"unfinished",0.509495908926289
"8411",8618,52,12,40,3.66890347481848e-06,"clams",0.467930513809832
"8412",8619,70,22,48,3.78270622368655e-06,"interested",0.547985759044913
"8413",8620,30,5,25,3.49811801250927e-06,"missionary",0.347790427531242
"8414",8621,34,10,24,3.5651767792906e-06,"canine",0.394963330411339
"8415",8622,32,4,28,3.58425508426584e-06,"come back",0.408384081655519
"8416",8623,59,29,30,3.63014618598691e-06,"embarrassed",0.440666460059643
"8417",8624,44,12,32,3.63234824049051e-06,"lineage",0.442215508874899
"8418",8625,42,3,39,3.52960277850331e-06,"aftershave",0.369938580259467
"8419",8626,59,13,46,3.79072182925073e-06,"obsessed",0.553624386191711
"8420",8627,34,3,31,3.53872068169915e-06,"fractal",0.376352625470442
"8421",8628,44,3,41,3.61440122022185e-06,"turmoil",0.429590566831432
"8422",8629,41,10,31,3.51286410836483e-06,"granola",0.358163659564025
"8423",8630,44,17,27,3.59925855273814e-06,"hiss",0.418938364042135
"8424",8631,28,4,24,3.40088627096221e-06,"dimple",0.279392159549091
"8425",8632,39,7,32,3.39820506808304e-06,"polar bear",0.2775060508553
"8426",8633,41,7,34,3.64191258681409e-06,"Portland",0.448943607256204
"8427",8634,39,13,26,3.47581872910164e-06,"duvet",0.332103859152881
"8428",8635,46,4,42,3.70640800880643e-06,"paisley",0.49431330944259
"8429",8636,30,4,26,3.56103797134789e-06,"cockpit",0.39205186045011
"8430",8637,51,13,38,3.71755503840234e-06,"ends",0.502154756128368
"8431",8638,58,21,37,3.56764432013186e-06,"take away",0.396699137227426
"8432",8639,51,13,38,3.5367682426506e-06,"pins",0.374979170185808
"8433",8640,47,12,35,3.63999039042537e-06,"body part",0.447591426357064
"8434",8641,36,7,29,3.48846538919064e-06,"limo",0.34100023015358
"8435",8642,41,11,30,3.61202515414317e-06,"let down",0.427919108500985
"8436",8643,31,3,28,3.4251384612223e-06,"rodents",0.29645251229162
"8437",8644,32,3,29,3.57398141529664e-06,"solder",0.401157005886492
"8438",8645,40,5,35,3.62996170390402e-06,"chestnut",0.440536685001187
"8439",8646,40,18,22,3.4206862580771e-06,"modify",0.293320582543257
"8440",8647,40,8,32,3.43549345710271e-06,"prawn",0.303736797977688
"8441",8648,45,11,34,3.61437509261836e-06,"wiggly",0.429572187207692
"8442",8649,51,18,33,3.69396258754691e-06,"combat",0.485558501137044
"8443",8650,67,26,41,3.7191173790636e-06,"cult",0.503253794297671
"8444",8651,31,3,28,3.41603555409805e-06,"envious",0.290049016159653
"8445",8652,50,7,43,3.61700280679418e-06,"Velcro",0.431420668943371
"8446",8653,34,4,30,3.47193289448102e-06,"frontal",0.329370344834544
"8447",8655,43,8,35,3.65222091553874e-06,"led",0.456195064643866
"8448",8656,40,6,34,3.40930399059032e-06,"creed",0.285313656313018
"8449",8657,31,6,25,3.51065659810354e-06,"exterior",0.356610772862393
"8450",8659,55,16,39,3.54588553172326e-06,"ooze",0.38139278338805
"8451",8660,47,11,36,3.64620175163532e-06,"on top",0.451960846690511
"8452",8661,56,12,44,3.71542794299047e-06,"scouts",0.500658437748281
"8453",8662,38,2,36,3.62136460260956e-06,"bombshell",0.434489001098249
"8454",8663,45,9,36,3.61480624638519e-06,"expertise",0.429875484982843
"8455",8664,44,11,33,3.45343219358559e-06,"patty",0.316355912740985
"8456",8665,38,2,36,3.65446319590115e-06,"mortality",0.457772410587477
"8457",8666,29,4,25,3.46054288996858e-06,"tripod",0.321357975945907
"8458",8667,33,5,28,3.53091136353204e-06,"black cat",0.37085911246478
"8459",8668,43,8,35,3.50057934588174e-06,"beehive",0.349521867665145
"8460",8669,43,11,32,3.50132700293411e-06,"loot",0.35004781162761
"8461",8670,40,2,38,3.56973294827814e-06,"humane",0.398168395572399
"8462",8671,98,60,38,3.57014077065059e-06,"Shakespeare",0.398455280734343
"8463",8672,43,7,36,3.58394678555813e-06,"mockingbird",0.408167207029055
"8464",8675,48,6,42,3.64811720670962e-06,"destructive",0.453308285370461
"8465",8676,57,23,34,3.65103415542452e-06,"talkative",0.455360230925667
"8466",8677,46,9,37,3.51577881532317e-06,"nappy",0.360214028141753
"8467",8678,45,7,38,3.42702828669148e-06,"appetizer",0.297781921667859
"8468",8679,36,7,29,3.49871771995564e-06,"expedition",0.348212295431321
"8469",8680,34,6,28,3.52657805551539e-06,"conundrum",0.367810820227532
"8470",8681,47,16,31,3.5087226845939e-06,"boob",0.355250349482309
"8471",8682,51,5,46,3.65002135262491e-06,"censorship",0.454647768552797
"8472",8683,70,19,51,3.67398524527526e-06,"allergies",0.471505316564527
"8473",8684,86,46,40,3.66472192090064e-06,"windows",0.46498897392889
"8474",8685,35,6,29,3.56826810539237e-06,"Wikipedia",0.397137942814291
"8475",8686,34,3,31,3.31121442100105e-06,"wharf",0.216311943906437
"8476",8687,42,7,35,3.53729368734569e-06,"subconscious",0.375348797495704
"8477",8689,39,6,33,3.57981556790194e-06,"trademark",0.405261076501673
"8478",8690,68,28,40,3.74742364624321e-06,"artificial",0.523166012440839
"8479",8691,33,2,31,3.59199272980672e-06,"Alpine",0.413827176110428
"8480",8692,45,8,37,3.50842724223585e-06,"portable",0.355042518734267
"8481",8694,30,3,27,3.37954295061136e-06,"postulate",0.264378069276111
"8482",8695,37,4,33,3.64914226910965e-06,"ambient",0.45402937183482
"8483",8696,48,3,45,3.55590956610791e-06,"accusation",0.38844425216969
"8484",8697,56,10,46,3.76840867638414e-06,"cleanliness",0.537928061256946
"8485",8698,89,48,41,3.73883490426713e-06,"spiritual",0.517124208951957
"8486",8699,46,13,33,3.68204780770874e-06,"sisters",0.477176975810506
"8487",8700,75,30,45,3.64817044252307e-06,"roads",0.453345734431614
"8488",8701,39,10,29,3.49724941333641e-06,"Bambi",0.347179406088563
"8489",8702,42,2,40,3.7169884959206e-06,"suburban",0.501756218327103
"8490",8703,31,5,26,3.47045084626944e-06,"magma",0.328327788883935
"8491",8704,62,24,38,3.64424846486033e-06,"blah",0.450586795067493
"8492",8705,37,7,30,3.52357092772099e-06,"fern",0.365695437642941
"8493",8706,111,80,31,3.71697467996848e-06,"vagina",0.501746499410412
"8494",8707,55,13,42,3.58519315228108e-06,"spotted",0.409043971383617
"8495",8708,49,10,39,3.78329297820823e-06,"scrubs",0.548398515130274
"8496",8709,35,8,27,3.61098171759956e-06,"Aboriginal",0.427185096632056
"8497",8710,52,8,44,3.56806439642623e-06,"prude",0.396994642486284
"8498",8711,60,12,48,3.7104787630748e-06,"motivated",0.497176906627086
"8499",8712,40,18,22,3.50874730703644e-06,"lunatic",0.355267670291302
"8500",8713,54,22,32,3.68507360934535e-06,"Reddit",0.479305494624515
"8501",8714,43,8,35,3.65996039922848e-06,"cosmetic",0.461639452155923
"8502",8715,92,52,40,3.7524156175538e-06,"pictures",0.526677645432581
"8503",8716,24,4,20,3.51017600022465e-06,"mote",0.356272693321812
"8504",8717,40,10,30,3.58389540759643e-06,"boiling",0.408131064885173
"8505",8718,46,18,28,3.518351722585e-06,"manual",0.36202395561593
"8506",8719,43,2,41,3.56164676299734e-06,"contradictory",0.392480118688849
"8507",8720,37,13,24,3.49071818035843e-06,"tremble",0.342584969988025
"8508",8721,50,10,40,3.57404528315374e-06,"aisle",0.401201934124285
"8509",8722,33,6,27,3.55571990883134e-06,"stranded",0.388310836589331
"8510",8724,59,23,36,3.63468507271188e-06,"stuffy",0.443859367906558
"8511",8725,45,13,32,3.58202111959652e-06,"November",0.406812585437481
"8512",8726,48,19,29,3.55511314147573e-06,"homosexual",0.387884002352571
"8513",8727,29,5,24,3.44011448701013e-06,"cosine",0.306987489952676
"8514",8728,42,2,40,3.50378057924501e-06,"debunk",0.351773795008726
"8515",8729,39,4,35,3.5524862074723e-06,"Super Bowl",0.386036069433968
"8516",8730,74,37,37,3.64227073726844e-06,"grades",0.449195550401157
"8517",8731,71,40,31,3.54457839012339e-06,"gooey",0.380473266571663
"8518",8732,37,7,30,3.55940287457376e-06,"Manhattan",0.390901641544699
"8519",8734,53,4,49,3.69696700826642e-06,"cloths",0.487671979413111
"8520",8735,69,29,40,3.50826723173158e-06,"Star Trek",0.35492995835864
"8521",8736,34,5,29,3.54312156095763e-06,"contraceptive",0.379448451114305
"8522",8737,47,9,38,3.50353506688248e-06,"onward",0.351601087823835
"8523",8738,40,4,36,3.70823599213854e-06,"babysitter",0.495599215586278
"8524",8739,60,34,26,3.41915410127534e-06,"lungs",0.292242777395994
"8525",8740,58,16,42,3.7485052835182e-06,"drowning",0.523926896849748
"8526",8741,53,13,40,3.52470110534627e-06,"documents",0.36649046806049
"8527",8742,32,2,30,3.47666462702342e-06,"rhubarb",0.332698911260545
"8528",8743,53,21,32,3.6651383039939e-06,"larger",0.465281881182661
"8529",8744,34,5,29,3.51965197681253e-06,"hunch",0.36293862746778
"8530",8745,62,17,45,3.73998152449127e-06,"injustice",0.517930806017035
"8531",8746,42,7,35,3.58180300799817e-06,"solvent",0.406659153489056
"8532",8747,48,16,32,3.5999971200023e-06,"rugged",0.419457913737056
"8533",8748,33,2,31,3.62089255001358e-06,"of interest",0.434156932789612
"8534",8749,25,2,23,3.51330841226566e-06,"snowball",0.358476207882002
"8535",8750,39,10,29,3.51608786000345e-06,"cog",0.360431427527218
"8536",8751,40,10,30,3.38439253538382e-06,"constellation",0.267789539579856
"8537",8752,77,42,35,3.67537608285768e-06,"hipster",0.472483709835784
"8538",8753,31,2,29,3.4729216300505e-06,"macro",0.330065876966014
"8539",8754,53,18,35,3.74933449312747e-06,"barren",0.524510209461103
"8540",8755,33,10,23,3.44033935507398e-06,"digits",0.307145674778408
"8541",8756,36,7,29,3.63930154524744e-06,"bubblegum",0.447106853970219
"8542",8757,54,19,35,3.77372731046455e-06,"eighties",0.541669487187848
"8543",8758,41,5,36,3.66016133991186e-06,"frolic",0.46178080511836
"8544",8759,57,14,43,3.66046949181702e-06,"craftsman",0.461997576475663
"8545",8760,33,3,30,3.59518245550962e-06,"grunge",0.416071008319388
"8546",8761,29,3,26,3.45295521171795e-06,"gale",0.316020376905806
"8547",8762,44,14,30,3.47834555971798e-06,"furious",0.333881373726741
"8548",8763,31,3,28,3.44872776432774e-06,"bribery",0.313046552978812
"8549",8764,51,4,47,3.63125347238613e-06,"finesse",0.44144538750311
"8550",8765,41,4,37,3.7040055115602e-06,"drugstore",0.492623257944396
"8551",8766,37,8,29,3.64509861814311e-06,"synapse",0.451184840635085
"8552",8767,42,4,38,3.64782443750547e-06,"dormitory",0.453102335069012
"8553",8768,52,17,35,3.40628459507792e-06,"won't",0.283189643926575
"8554",8769,70,28,42,3.66336597392416e-06,"drums",0.464035124669468
"8555",8770,40,6,34,3.36978315445401e-06,"GPS",0.257512480504378
"8556",8771,32,5,27,3.45529368268656e-06,"Ebola",0.31766538872432
"8557",8772,41,5,36,3.53971023931981e-06,"nuke",0.377048735878881
"8558",8773,35,10,25,3.60574756161321e-06,"sprint",0.423503097337189
"8559",8775,36,4,32,3.59984160696929e-06,"corny",0.419348517135315
"8560",8776,25,2,23,3.53700592448492e-06,"smut",0.37514636893737
"8561",8777,38,3,35,3.69497262025288e-06,"red hair",0.486269014870466
"8562",8778,32,3,29,3.69149442768916e-06,"significance",0.483822258869989
"8563",8779,42,8,34,3.62689414546747e-06,"chewing",0.438378792108846
"8564",8780,77,38,39,3.69382613899129e-06,"glitter",0.485462515559446
"8565",8782,43,9,34,3.71473785094986e-06,"hypocrite",0.500172988248197
"8566",8783,38,5,33,3.43174432132108e-06,"warrant",0.301099445300332
"8567",8784,42,5,37,3.49849739536869e-06,"cholesterol",0.348057306742429
"8568",8785,39,4,35,3.55797181374729e-06,"egocentric",0.389894952984458
"8569",8786,44,4,40,3.63640330621789e-06,"grope",0.445068069858514
"8570",8787,66,34,32,3.62110233597312e-06,"Wall Street",0.434304508016088
"8571",8789,40,10,30,3.42745114168398e-06,"musical instrument",0.298079381619046
"8572",8790,41,7,34,3.48778403641247e-06,"cubes",0.340520928341532
"8573",8791,24,4,20,3.4541001896301e-06,"tectonic",0.316825818676394
"8574",8792,56,19,37,3.66500397652931e-06,"maps",0.465187387699628
"8575",8793,38,9,29,3.6095088902204e-06,"concerned",0.426149027132848
"8576",8794,46,11,35,3.64624163643325e-06,"delta",0.451988903897483
"8577",8795,50,14,36,3.61931992978519e-06,"mindful",0.433050663395443
"8578",8796,37,5,32,3.73795444181126e-06,"wholesome",0.516504842209712
"8579",8797,47,9,38,3.63722334369942e-06,"swipe",0.44564493028007
"8580",8798,38,5,33,3.59207014594581e-06,"throttle",0.41388163497071
"8581",8799,55,14,41,3.62044683554844e-06,"noodle",0.433843392201479
"8582",8800,34,6,28,3.38038833901239e-06,"condiment",0.26497276295826
"8583",8801,29,2,27,3.34047080595539e-06,"optic",0.236892528255302
"8584",8802,31,2,29,3.41913072020569e-06,"pointer",0.292226329838414
"8585",8803,71,25,46,3.70149651504103e-06,"worms",0.490858288876127
"8586",8804,72,36,36,3.70561140735416e-06,"problems",0.493752935240294
"8587",8805,38,7,31,3.4642712385809e-06,"ideology",0.32398070576087
"8588",8806,39,13,26,3.52312402453504e-06,"solar system",0.365381060841821
"8589",8807,89,44,45,3.66731578156e-06,"logical",0.466813641199726
"8590",8808,34,8,26,3.64610869050006e-06,"resign",0.451895382261233
"8591",8809,51,23,28,3.61258625049673e-06,"angels",0.428313815189806
"8592",8810,41,6,35,3.59551854568466e-06,"raisins",0.416307433024869
"8593",8811,41,3,38,3.54381214960557e-06,"trapper",0.379934249955872
"8594",8812,72,23,49,3.70240100705307e-06,"rats",0.491494559357793
"8595",8814,39,3,36,3.49556238355408e-06,"pierced",0.345992654588385
"8596",8815,38,8,30,3.47820037912384e-06,"exposed",0.333779245542822
"8597",8816,51,19,32,3.64813051551732e-06,"breakdown",0.453317647533285
"8598",8817,46,4,42,3.66008096099086e-06,"elementary school",0.461724262070877
"8599",8818,41,6,35,3.5042225882188e-06,"researcher",0.352084728946135
"8600",8819,48,9,39,3.55523953426362e-06,"cognitive",0.387972914138371
"8601",8820,40,3,37,3.61514601574758e-06,"sinner",0.430114497835339
"8602",8821,30,3,27,3.52246628999761e-06,"enamel",0.364918373426821
"8603",8822,35,7,28,3.4228757633013e-06,"Miami",0.294860803490556
"8604",8823,51,11,40,3.70955655960886e-06,"entrepreneur",0.496528176913995
"8605",8824,49,2,47,3.51564285287386e-06,"integration",0.360118384518639
"8606",8825,54,16,38,3.58893745917584e-06,"scoundrel",0.411677927150738
"8607",8826,28,9,19,3.501792917974e-06,"polka",0.350375562434582
"8608",8827,51,9,42,3.5020627149391e-06,"burgers",0.350565352772859
"8609",8828,40,4,36,3.49826486062913e-06,"gram",0.34789372874641
"8610",8829,49,7,42,3.73017412452813e-06,"trench coat",0.511031730054664
"8611",8830,39,7,32,3.7310091633585e-06,"heartbeat",0.511619143267536
"8612",8831,66,27,39,3.6990319633352e-06,"programming",0.48912458478578
"8613",8832,48,9,39,3.52588173487485e-06,"ghostly",0.367320989180432
"8614",8833,36,4,32,3.48309479939116e-06,"salami",0.33722225565181
"8615",8834,51,4,47,3.60433096408645e-06,"undone",0.422506583074286
"8616",8835,43,13,30,3.56242073613862e-06,"your",0.393024574866287
"8617",8836,43,6,37,3.66036230266072e-06,"Great Britain",0.461922173602888
"8618",8837,36,9,27,3.35612139762319e-06,"barf",0.247902033443025
"8619",8838,31,5,26,3.42647638301153e-06,"jaguar",0.297393681621956
"8620",8840,49,9,40,3.66104574110549e-06,"utopia",0.46240294258996
"8621",8841,31,4,27,3.44481916421797e-06,"fabricate",0.310297024136799
"8622",8842,36,4,32,3.40624978710939e-06,"yogi",0.283165158046537
"8623",8843,31,3,28,3.3531392089274e-06,"come in",0.245804194421086
"8624",8844,54,16,38,3.53326926338402e-06,"binoculars",0.372517791651072
"8625",8845,33,4,29,3.57624372816256e-06,"bovine",0.402748443818187
"8626",8846,34,2,32,3.53932186593049e-06,"materialism",0.376775532224011
"8627",8847,45,5,40,3.71477924924311e-06,"programmer",0.50020211013279
"8628",8848,29,2,27,3.6073864845658e-06,"poplar",0.424656007791424
"8629",8849,51,18,33,3.62965866689896e-06,"chatter",0.440323511751888
"8630",8850,30,4,26,3.48623981146415e-06,"anterior",0.339434633782174
"8631",8851,32,4,28,3.65078090203495e-06,"grown up",0.455182078267573
"8632",8852,30,5,25,3.38914119162204e-06,"haha",0.271130011084006
"8633",8853,40,5,35,3.59575126031082e-06,"migrant",0.416471137563223
"8634",8854,33,6,27,3.38743060001558e-06,"lavender",0.269926684873397
"8635",8855,47,6,41,3.55887084145942e-06,"suffocation",0.390527379570666
"8636",8856,38,9,29,3.38273250366181e-06,"nautical",0.266621780031639
"8637",8857,52,15,37,3.65903635618524e-06,"pervert",0.460989428380834
"8638",8858,32,3,29,3.52108956595529e-06,"theology",0.363949908412357
"8639",8859,62,18,44,3.61347392155871e-06,"mythical",0.428938252870456
"8640",8860,66,21,45,3.70082528403834e-06,"talented",0.490386107289441
"8641",8861,49,5,44,3.72310521867658e-06,"grinder",0.5060590646567
"8642",8862,44,16,28,3.67916232832109e-06,"yeast",0.475147167547556
"8643",8863,46,7,39,3.6425891523695e-06,"democratic",0.449419541466889
"8644",8865,45,4,41,3.66844586291018e-06,"bunker",0.467608603891961
"8645",8866,39,7,32,3.47639872902862e-06,"nimble",0.332511863676963
"8646",8867,43,8,35,3.65074091786928e-06,"artsy",0.455153951159752
"8647",8868,73,26,47,3.73460409461993e-06,"disabled",0.514148019824553
"8648",8869,38,12,26,3.57213023986855e-06,"boast",0.399854785119918
"8649",8870,36,6,30,3.60987372661704e-06,"cigars",0.426405673545125
"8650",8871,54,17,37,3.71627020257389e-06,"hooker",0.501250930444394
"8651",8872,58,19,39,3.67266290096297e-06,"destroyed",0.470575105306381
"8652",8873,36,3,33,3.59669535630662e-06,"go bad",0.417135267711411
"8653",8874,55,27,28,3.59545390807863e-06,"bouncy",0.416261963302443
"8654",8876,52,18,34,3.56054348135699e-06,"strangle",0.391704008417702
"8655",8877,34,9,25,3.49485382773865e-06,"vines",0.345494216632091
"8656",8878,48,13,35,3.59661774067667e-06,"revolt",0.417080668518051
"8657",8879,48,17,31,3.44931065526555e-06,"semen",0.313456591202277
"8658",8880,39,3,36,3.56641012289849e-06,"prankster",0.395830933575332
"8659",8881,25,2,23,3.33460048151631e-06,"gerbil",0.232763012340665
"8660",8882,36,9,27,3.63498894963359e-06,"latex",0.444073132000408
"8661",8883,70,28,42,3.57508026055185e-06,"jewels",0.401929995355166
"8662",8884,63,26,37,3.69843001645801e-06,"oranges",0.488701141544289
"8663",8885,48,3,45,3.61532899493854e-06,"woodworker",0.430243215675209
"8664",8886,41,11,30,3.34255879560922e-06,"porridge",0.238361337448821
"8665",8887,44,4,40,3.69495896748067e-06,"underworld",0.486259410743686
"8666",8888,59,10,49,3.73569229849676e-06,"impress",0.514913523550006
"8667",8890,35,6,29,3.53057477757379e-06,"janitor",0.370622338997543
"8668",8891,55,12,43,3.58232908707926e-06,"eastern",0.407029227061694
"8669",8892,37,9,28,3.62175807380419e-06,"maple syrup",0.434765790835688
"8670",8893,36,3,33,3.52307437562314e-06,"pending",0.365346135008686
"8671",8894,40,3,37,3.62951375404237e-06,"cosmic",0.440221571909593
"8672",8895,58,16,42,3.54831384126263e-06,"axis",0.383100992702977
"8673",8896,31,4,27,3.44572127560602e-06,"levitate",0.310931619953836
"8674",8897,49,9,40,3.63885128742559e-06,"minimal",0.446790117329797
"8675",8898,55,21,34,3.67480881807124e-06,"masturbation",0.472084663924827
"8676",8899,24,2,22,3.42444643823326e-06,"ramen",0.295965704453966
"8677",8900,52,16,36,3.56931247903029e-06,"facial",0.397872613887991
"8678",8901,63,29,34,3.69272127709073e-06,"creep",0.484685293644507
"8679",8902,48,12,36,3.57903401871835e-06,"discard",0.404711290910568
"8680",8903,57,7,50,3.71867481304362e-06,"rating",0.502942468502694
"8681",8904,36,3,33,3.74559892126751e-06,"dopamine",0.521882398408059
"8682",8905,57,11,46,3.77478144015462e-06,"in love",0.542411021216572
"8683",8906,48,5,43,3.61854722565984e-06,"flattery",0.432507099915084
"8684",8907,46,13,33,3.61586496913859e-06,"peek",0.430620250030281
"8685",8908,41,4,37,3.57921336048763e-06,"antibiotics",0.404837449983733
"8686",8909,44,11,33,3.62299150408492e-06,"folk",0.435633454970227
"8687",8910,49,6,43,3.56912138938757e-06,"mesmerize",0.39773819070084
"8688",8911,42,4,38,3.47284926445053e-06,"nutritious",0.330014970938613
"8689",8912,35,3,32,3.54611186564491e-06,"letterbox",0.381551999380483
"8690",8913,57,25,32,3.53639302057473e-06,"scratchy",0.374715217903465
"8691",8915,47,9,38,3.49704150288856e-06,"puzzled",0.347033150202343
"8692",8917,53,13,40,3.63877184172798e-06,"lofty",0.446734230764069
"8693",8918,37,5,32,3.51401212334183e-06,"drummer",0.358971237776598
"8694",8919,40,6,34,3.66880925126941e-06,"charismatic",0.46786423167339
"8695",8920,53,11,42,3.77273070248246e-06,"retired",0.540968417159198
"8696",8921,62,16,46,3.63401143986801e-06,"exploration",0.443385496729893
"8697",8922,34,3,31,3.53331920005653e-06,"lecturer",0.372552919911186
"8698",8923,37,2,35,3.51857455507625e-06,"excuse me",0.36218070850556
"8699",8924,48,13,35,3.51374048215547e-06,"Israel",0.358780150109507
"8700",8925,62,27,35,3.60578656628157e-06,"smaller",0.423530535411592
"8701",8926,40,5,35,3.64528464205127e-06,"young adult",0.451315700300037
"8702",8927,38,7,31,3.45388544843522e-06,"apartheid",0.316674757659068
"8703",8928,75,37,38,3.66485622769019e-06,"DNA",0.465083452867938
"8704",8929,44,6,38,3.44524642125028e-06,"bam",0.310597580730026
"8705",8930,38,8,30,3.5424312414096e-06,"misfortune",0.378962841572727
"8706",8931,40,8,32,3.52570769767762e-06,"drought",0.367198561641176
"8707",8932,46,3,43,3.67755222124154e-06,"Indonesia",0.474014527796848
"8708",8933,57,21,36,3.45793423009094e-06,"get rid of",0.319522898073745
"8709",8934,50,5,45,3.71908971560121e-06,"leverage",0.503234334264519
"8710",8935,95,57,38,3.64870288612398e-06,"Asian",0.453720285164953
"8711",8936,37,6,31,3.39963759863199e-06,"toga",0.278513773300878
"8712",8937,42,7,35,3.6855217961759e-06,"sundae",0.479620774413344
"8713",8938,47,6,41,3.6266442298277e-06,"tundra",0.438202987411428
"8714",8939,53,14,39,3.61879602656196e-06,"mock",0.432682120443429
"8715",8940,39,3,36,3.60200703832175e-06,"internship",0.420871803169133
"8716",8941,52,9,43,3.74465917984475e-06,"disturbing",0.521221331511123
"8717",8942,48,5,43,3.67651113799049e-06,"upscale",0.473282171366078
"8718",8943,63,24,39,3.74920797981426e-06,"European",0.52442121289103
"8719",8944,46,9,37,3.74447689657755e-06,"earthy",0.521093103223117
"8720",8945,64,22,42,3.7243670438209e-06,"tights",0.506946703333067
"8721",8946,48,4,44,3.68288856315786e-06,"acrobatics",0.477768410414077
"8722",8947,26,3,23,3.41614058101719e-06,"salutations",0.290122897993369
"8723",8948,24,3,21,3.29199682651506e-06,"not smart",0.202793208597261
"8724",8949,52,11,41,3.63783199764268e-06,"overseas",0.446073091648543
"8725",8950,57,16,41,3.63886452871246e-06,"cranky",0.446799431994676
"8726",8951,28,2,26,3.35171188684621e-06,"parsnip",0.244800135904261
"8727",8953,62,34,28,3.45902268772981e-06,"snooty",0.320288580309667
"8728",8954,46,16,30,3.54359866618946e-06,"spirits",0.379784073730777
"8729",8955,32,2,30,3.56927425946482e-06,"penetration",0.397845728099057
"8730",8956,43,5,38,3.58453773801331e-06,"crumbly",0.408582916176612
"8731",8957,50,9,41,3.63114798743623e-06,"integral",0.441371183464831
"8732",8959,33,7,26,3.42430572201486e-06,"seeking",0.29586671676268
"8733",8960,31,4,27,3.51877265209895e-06,"murmur",0.362320061077359
"8734",8961,49,21,28,3.63415671210574e-06,"spending",0.443487689381062
"8735",8962,42,8,34,3.51262965994232e-06,"hooves",0.35799873537594
"8736",8963,39,5,34,3.6027726938652e-06,"exodus",0.4214104082811
"8737",8964,50,8,42,3.62349036332738e-06,"hitchhiker",0.43598438057958
"8738",8965,52,9,43,3.56670269036384e-06,"groin",0.396036741962379
"8739",8966,55,13,42,3.73167746365346e-06,"dread",0.5120892632298
"8740",8967,46,12,34,3.58280397404617e-06,"spiky",0.407363289226037
"8741",8968,31,3,28,3.44056425253742e-06,"downside",0.307303880285453
"8742",8969,46,4,42,3.70101703948245e-06,"shabby",0.490520998838687
"8743",8971,58,16,42,3.65791206379399e-06,"curvy",0.460198537967442
"8744",8972,42,3,39,3.46386324667902e-06,"good job",0.323693701342405
"8745",8973,39,6,33,3.62063035174424e-06,"output",0.433972487800708
"8746",8974,41,8,33,3.64563016540224e-06,"vegan",0.451558760831273
"8747",8975,52,11,41,3.54899386024062e-06,"elections",0.383579356245061
"8748",8976,40,15,25,3.46038721732962e-06,"uterus",0.321248467068378
"8749",8977,35,8,27,3.43074357936339e-06,"Quaker",0.300395467201059
"8750",8978,49,13,36,3.71740302224866e-06,"diapers",0.502047819427944
"8751",8979,23,5,18,3.41086223186359e-06,"Sahara",0.286409810742573
"8752",8980,33,7,26,3.27515565177235e-06,"not often",0.190946180406076
"8753",8981,32,6,26,3.5405499182133e-06,"quantum",0.377639413172755
"8754",8982,46,6,40,3.65172744967007e-06,"stigma",0.455847933036548
"8755",8983,37,9,28,3.65127411210142e-06,"earnest",0.455529029929256
"8756",8985,28,2,26,3.57922617130176e-06,"cataract",0.404846461829908
"8757",8986,46,5,41,3.76437993133771e-06,"loudspeaker",0.535094015718598
"8758",8987,33,9,24,3.43135572864839e-06,"Milky Way",0.300826087389222
"8759",8988,64,26,38,3.65060764364228e-06,"shocking",0.455060198583193
"8760",8989,30,2,28,3.48470909648463e-06,"clementine",0.338357842893643
"8761",8990,37,5,32,3.59378706092907e-06,"forgery",0.415089409399706
"8762",8991,47,6,41,3.61455799377573e-06,"template",0.429700850154348
"8763",8992,38,3,35,3.41314401761182e-06,"rarity",0.28801494699337
"8764",8994,37,3,34,3.6407192604971e-06,"Hong Kong",0.448104154502188
"8765",8995,46,11,35,3.7506141630692e-06,"African",0.525410401170217
"8766",8996,42,5,37,3.6652860755782e-06,"invader",0.465385832014582
"8767",8997,48,12,36,3.6394604863775e-06,"blob",0.447218662087964
"8768",8998,44,5,39,3.581341212284e-06,"olive oil",0.406334300447159
"8769",8999,41,10,31,3.48610612404263e-06,"decipher",0.33934059054138
"8770",9000,34,6,28,3.62860501908646e-06,"damsel",0.439582316702908
"8771",9001,47,7,40,3.71045122797383e-06,"keep going",0.497157536890569
"8772",9002,33,6,27,3.51684215709031e-06,"alloy",0.360962042462878
"8773",9003,31,4,27,3.55003958294135e-06,"busted",0.384314976325308
"8774",9004,60,14,46,3.73029935652336e-06,"handmade",0.511119825273707
"8775",9005,78,34,44,3.79089427195876e-06,"annoyance",0.553745692077708
"8776",9006,53,21,32,3.61069487822932e-06,"bells",0.426983317708816
"8777",9007,32,6,26,3.48156684434263e-06,"scarlet",0.336147406253754
"8778",9008,58,24,34,3.60426600924855e-06,"choices",0.422460890193147
"8779",9009,45,12,33,3.51324669666979e-06,"hers",0.358432793665639
"8780",9010,38,10,28,3.43830477821215e-06,"fully",0.30571443914268
"8781",9011,50,7,43,3.6787698193724e-06,"menopause",0.474871054707957
"8782",9012,37,15,22,3.42053415061296e-06,"blow up",0.293213581609935
"8783",9013,38,3,35,3.53725615040413e-06,"xenophobia",0.37532239190277
"8784",9015,38,4,34,3.4995135676141e-06,"go ahead",0.348772139372719
"8785",9016,74,30,44,3.67598406093311e-06,"squishy",0.472911395760865
"8786",9017,39,7,32,3.69261219078989e-06,"whipped",0.484608556213712
"8787",9018,57,19,38,3.62581580855693e-06,"shelves",0.437620229361651
"8788",9019,46,4,42,3.66009435723253e-06,"bathrobe",0.461733685739664
"8789",9020,41,10,31,3.51791851797129e-06,"Titanic",0.361719215159895
"8790",9021,35,9,26,3.53917155072341e-06,"work out",0.376669792064963
"8791",9022,31,3,28,3.49966053292831e-06,"foal",0.348875523028972
"8792",9023,45,2,43,3.58838368433706e-06,"strategic",0.411288370826625
"8793",9024,30,4,26,3.52841965612022e-06,"unconditional",0.369106305525656
"8794",9025,34,6,28,3.51934230530998e-06,"nana",0.362720787140324
"8795",9027,37,3,34,3.46117770032431e-06,"dissipate",0.321804537203974
"8796",9028,47,9,38,3.68115323168442e-06,"groovy",0.476547680791536
"8797",9029,45,11,34,3.55917484090488e-06,"striped",0.3907412298546
"8798",9030,64,30,34,3.49449965753903e-06,"yucky",0.345245073421864
"8799",9031,47,12,35,3.67233920662784e-06,"fourth",0.470347400530898
"8800",9032,33,7,26,3.28342526924087e-06,"synonym",0.196763493792858
"8801",9033,39,3,36,3.67474129821261e-06,"perverted",0.47203716666404
"8802",9034,39,3,36,3.57725438571388e-06,"dishonor",0.403459397102919
"8803",9035,95,52,43,3.80463937725663e-06,"unwanted",0.563414771132018
"8804",9036,38,8,30,3.65638734304957e-06,"firetruck",0.459125963760553
"8805",9037,42,9,33,3.58128990899942e-06,"watchful",0.40629821083536
"8806",9039,40,5,35,3.53816977553851e-06,"darken",0.375965087135644
"8807",9040,34,3,31,3.44682581810411e-06,"leotards",0.311708617183137
"8808",9041,32,3,29,3.49260789538941e-06,"eucalyptus",0.34391430167583
"8809",9042,74,29,45,3.60504562185235e-06,"musician",0.423009313485258
"8810",9043,47,12,35,3.45146549224801e-06,"wild west",0.314972424561212
"8811",9044,49,4,45,3.49786105796306e-06,"chronic",0.347609671271696
"8812",9046,60,16,44,3.59106399635148e-06,"belittle",0.413173852836108
"8813",9047,55,20,35,3.67774157245519e-06,"Bob",0.474147728075353
"8814",9048,48,7,41,3.6123644008713e-06,"bad luck",0.428157753703194
"8815",9049,63,17,46,3.70972169667832e-06,"werewolf",0.496644343603497
"8816",9050,43,3,40,3.58064874193906e-06,"exploitation",0.405847177914238
"8817",9052,51,16,35,3.5911800617683e-06,"horny",0.413255499769062
"8818",9053,45,6,39,3.68245457692279e-06,"tuck",0.477463120121689
"8819",9054,51,8,43,3.66450705051157e-06,"radioactive",0.464837822029112
"8820",9055,43,7,36,3.58068720548848e-06,"harassment",0.405874235335184
"8821",9057,45,5,40,3.53111085216298e-06,"blindness",0.370999443971975
"8822",9058,58,17,41,3.66539355330582e-06,"distrust",0.465461437884629
"8823",9060,57,14,43,3.53889600600197e-06,"hormone",0.376475958432055
"8824",9061,45,6,39,3.66591759750424e-06,"abstain",0.465830080006513
"8825",9063,69,24,45,3.65978626848192e-06,"betrayal",0.461516958808816
"8826",9064,41,3,38,3.66973823757151e-06,"martyr",0.468517732814398
"8827",9065,30,4,26,3.33178960415008e-06,"astonish",0.230785683329567
"8828",9066,46,13,33,3.61624416880628e-06,"hinder",0.430887000374113
"8829",9067,31,2,29,3.42334447061401e-06,"aesthetics",0.295190518539061
"8830",9068,43,14,29,3.52581957676062e-06,"crate",0.367277263671799
"8831",9069,36,2,34,3.59968610737144e-06,"spirituality",0.419239129984616
"8832",9070,48,3,45,3.75157097034383e-06,"hummingbird",0.52608347314585
"8833",9071,45,11,34,3.51692873647301e-06,"paranormal",0.361022947263367
"8834",9072,58,13,45,3.65978626848192e-06,"shotgun",0.461516958808816
"8835",9073,31,4,27,3.61931992978519e-06,"graphite",0.433050663395443
"8836",9074,26,2,24,3.45904661757127e-06,"parka",0.320305413904157
"8837",9075,45,5,40,3.60615065054958e-06,"clash",0.423786652734341
"8838",9077,42,4,38,3.59572540164253e-06,"rhythmic",0.416452947123608
"8839",9078,54,25,29,3.48867228110326e-06,"in charge",0.341145769544908
"8840",9079,33,5,28,3.3777393466101e-06,"resurrection",0.263109312923001
"8841",9080,47,6,41,3.72942290909905e-06,"massacre",0.51050328293016
"8842",9081,29,4,25,3.39230286479977e-06,"wiper",0.2733541095712
"8843",9082,57,26,31,3.48971928698056e-06,"vile",0.341882292283623
"8844",9083,37,5,32,3.66969783708009e-06,"rucksack",0.468489312839658
"8845",9084,35,8,27,3.65913007841516e-06,"morgue",0.461055357861229
"8846",9086,38,5,33,3.65435635821463e-06,"surfboard",0.457697254958283
"8847",9087,38,4,34,3.46992098989906e-06,"odorous",0.327955058153861
"8848",9088,58,21,37,3.76300588910422e-06,"loner",0.534127437239082
"8849",9089,60,22,38,3.54701749034325e-06,"shocked",0.382189066657302
"8850",9090,33,3,30,3.68223762215823e-06,"circulation",0.477310501955128
"8851",9091,42,10,32,3.55630158859992e-06,"not sure",0.388720022808337
"8852",9092,36,3,33,3.52362059062928e-06,"normally",0.36573037332193
"8853",9093,33,2,31,3.67837739416389e-06,"classics",0.474595000775899
"8854",9095,42,3,39,3.66105914441048e-06,"pesky",0.46241237122748
"8855",9096,32,9,23,3.45346797253802e-06,"mourn",0.316381081665632
"8856",9097,39,3,36,3.55408969100744e-06,"ambush",0.387164049811534
"8857",9098,71,24,47,3.72468610207875e-06,"lush",0.507171146831402
"8858",9099,46,7,39,3.58963313949314e-06,"decorative",0.41216730775851
"8859",9100,42,7,35,3.51590242667585e-06,"humility",0.360300983309809
"8860",9101,43,4,39,3.63304765468609e-06,"glistening",0.442707516102356
"8861",9103,63,14,49,3.67845857871717e-06,"quietly",0.474652110550377
"8862",9105,41,4,37,3.49523250286609e-06,"fingerprint",0.345760597984851
"8863",9106,34,2,32,3.70838725946473e-06,"gig",0.495705625519384
"8864",9107,27,3,24,3.45420757024131e-06,"budgie",0.316901356229304
"8865",9108,59,23,36,3.59058691733751e-06,"surprised",0.412838248662749
"8866",9109,56,18,38,3.53945966608738e-06,"crisps",0.376872468593851
"8867",9110,50,3,47,3.68101772778138e-06,"pageant",0.476452359735617
"8868",9111,32,2,30,3.52780972405472e-06,"belch",0.368677245054219
"8869",9112,32,2,30,3.52101517909644e-06,"earlobe",0.363897580517935
"8870",9114,56,20,36,3.70011322346464e-06,"wrinkled",0.48988520388933
"8871",9115,27,2,25,3.55177961917819e-06,"hanky",0.385539015542671
"8872",9116,44,7,37,3.63562329125705e-06,"bolts",0.444519363525868
"8873",9117,43,15,28,3.59629437827263e-06,"glossy",0.416853197241543
"8874",9118,41,7,34,3.66624016072797e-06,"point of view",0.466056989094703
"8875",9119,46,5,41,3.70901996565447e-06,"bingo",0.496150706588914
"8876",9120,50,14,36,3.65591948202933e-06,"sprite",0.458796844041704
"8877",9121,44,8,36,3.57497801388521e-06,"coincidence",0.401858069307216
"8878",9122,40,4,36,3.60896177387689e-06,"noxious",0.425764154768278
"8879",9123,51,8,43,3.6517141146054e-06,"brownie",0.455838552403101
"8880",9124,48,12,36,3.56205273975286e-06,"closeness",0.392765705540191
"8881",9125,47,8,39,3.73174709203608e-06,"inspector",0.512138243744781
"8882",9126,37,6,31,3.47048697873286e-06,"clitoris",0.328353206488067
"8883",9127,42,11,31,3.60008784214335e-06,"anus",0.419521732786436
"8884",9128,59,21,38,3.59791177200753e-06,"video games",0.417990962834877
"8885",9130,55,11,44,3.67205602088665e-06,"lighting",0.470148191775547
"8886",9131,48,2,46,3.52177159198163e-06,"backpacker",0.364429683824977
"8887",9132,42,7,35,3.57500357500357e-06,"steamy",0.4018760504335
"8888",9133,27,5,22,3.32050511523813e-06,"weeping",0.222847540040553
"8889",9134,42,9,33,3.65788530334843e-06,"empathetic",0.460179713167048
"8890",9135,43,5,38,3.35862377032387e-06,"gopher",0.249662342945343
"8891",9136,62,13,49,3.78276346001808e-06,"dreamy",0.548026022295166
"8892",9137,59,18,41,3.58538596679933e-06,"bakery",0.409179607945095
"8893",9139,69,24,45,3.76302004937082e-06,"overbearing",0.534137398365918
"8894",9140,48,13,35,3.62772305962163e-06,"fanatic",0.438961896880479
"8895",9141,30,6,24,3.49757967486499e-06,"immaculate",0.347411730596761
"8896",9142,46,7,39,3.53825740822645e-06,"hazelnut",0.376026732890192
"8897",9143,50,17,33,3.60973038923723e-06,"outdated",0.426304841981682
"8898",9144,32,5,27,3.45270484897869e-06,"gosh",0.315844257693498
"8899",9145,45,5,40,3.65717629418326e-06,"relieve",0.459680956299082
"8900",9146,51,6,45,3.62596042626791e-06,"hypnosis",0.437721961581946
"8901",9148,56,24,32,3.66301708064865e-06,"Middle East",0.463789693544034
"8902",9149,45,3,42,3.6285655191933e-06,"waxy",0.439554530259562
"8903",9150,51,10,41,3.71886842271634e-06,"devoted",0.503078664420481
"8904",9151,38,5,33,3.53138518583915e-06,"aching",0.371192425687619
"8905",9152,39,10,29,3.41520723477501e-06,"Seattle",0.289466329825637
"8906",9153,35,4,31,3.43417207262587e-06,"wailing",0.302807261921702
"8907",9154,35,2,33,3.40589014641922e-06,"nacho",0.282912166586009
"8908",9155,46,7,39,3.63490967249464e-06,"unethical",0.444017364008302
"8909",9156,42,2,40,3.37048733876431e-06,"trivia",0.258007843298446
"8910",9157,45,5,40,3.6450321856342e-06,"rebuild",0.451138108277162
"8911",9158,39,5,34,3.5672116176948e-06,"bloated",0.396394750030654
"8912",9159,42,7,35,3.47184851630554e-06,"lighten",0.329310988486848
"8913",9160,51,20,31,3.47430922046924e-06,"blemish",0.331041985999964
"8914",9161,63,17,46,3.70185277731505e-06,"magnificent",0.491108903768983
"8915",9162,45,6,39,3.55066983386416e-06,"roughly",0.384758330222178
"8916",9163,43,7,36,3.68368899350566e-06,"childbirth",0.478331478076538
"8917",9165,37,6,31,3.59792471702322e-06,"plunger",0.418000069085968
"8918",9166,39,5,34,3.64025540031889e-06,"malfunction",0.447777849200328
"8919",9167,38,11,27,3.43476185078708e-06,"throw out",0.303222145004924
"8920",9168,42,10,32,3.45939363748322e-06,"brag",0.320549527200448
"8921",9169,43,10,33,3.59700585232852e-06,"vagabond",0.417353688052085
"8922",9170,25,3,22,3.29323273605069e-06,"paella",0.203662616778939
"8923",9172,53,8,45,3.69273491333151e-06,"biological",0.484694886142149
"8924",9173,49,17,32,3.45971678758377e-06,"Darwin",0.320776849130755
"8925",9174,41,2,39,3.61303003150562e-06,"handgun",0.428625995676225
"8926",9175,30,3,27,3.49471947886743e-06,"terrify",0.345399708090427
"8927",9176,60,24,36,3.5734322459379e-06,"cheeks",0.4007706893157
"8928",9177,35,2,33,3.42063945433959e-06,"egoistic",0.293287658165588
"8929",9178,42,10,32,3.60799821043289e-06,"bulky",0.425086330123649
"8930",9179,40,9,31,3.36469226524542e-06,"pact",0.253931263107505
"8931",9180,35,8,27,3.47699101197823e-06,"semi",0.332928508769029
"8932",9181,39,5,34,3.5930768595071e-06,"whim",0.414589813831347
"8933",9182,54,7,47,3.73339107644865e-06,"dressy",0.513294714714243
"8934",9183,28,3,25,3.57114798123005e-06,"capsule",0.399163809225473
"8935",9184,48,8,40,3.84927768304278e-06,"competitive",0.594815862512785
"8936",9185,60,18,42,3.66036230266072e-06,"comics",0.461922173602888
"8937",9186,30,7,23,3.60218868984795e-06,"puny",0.42099958705504
"8938",9187,37,13,24,3.30813636138082e-06,"jester",0.214146663891704
"8939",9188,40,3,37,3.45543695728043e-06,"championship",0.317766176120604
"8940",9189,33,6,27,3.53689333437082e-06,"fulfilled",0.375067166727537
"8941",9190,41,9,32,3.7021268718879e-06,"watermelon",0.491301717285929
"8942",9191,37,2,35,3.64694641176943e-06,"tenderness",0.452484682452348
"8943",9192,40,6,34,3.60720430844483e-06,"contents",0.424527854876091
"8944",9193,42,6,36,3.53111085216298e-06,"scavenger",0.370999443971975
"8945",9194,39,4,35,3.5601378485375e-06,"weirdo",0.391418663510278
"8946",9196,38,14,24,3.67939245871722e-06,"not good",0.475309054193365
"8947",9198,63,29,34,3.70930888156919e-06,"frightening",0.496353946270157
"8948",9199,39,4,35,3.46315548875513e-06,"veggies",0.323195824667831
"8949",9200,40,7,33,3.59451046361996e-06,"fishy",0.415598291482075
"8950",9201,48,8,40,3.57196436608348e-06,"CEO",0.399738100183277
"8951",9202,44,10,34,3.36541697516322e-06,"zodiac",0.2544410647667
"8952",9204,44,15,29,3.61820681670164e-06,"troops",0.432267637134968
"8953",9205,40,3,37,3.45351567896118e-06,"acrid",0.316414641043093
"8954",9207,36,8,28,3.43679223559898e-06,"been",0.304650431717288
"8955",9208,38,7,31,3.43386546801869e-06,"cherries",0.302591579020701
"8956",9209,39,4,35,3.70153761872682e-06,"stagnant",0.49088720351728
"8957",9210,59,22,37,3.4517395041231e-06,"tomatoes",0.31516517990391
"8958",9211,49,9,40,3.50331413517187e-06,"finale",0.351445672050058
"8959",9212,49,10,39,3.5772927763727e-06,"announcement",0.403486403248527
"8960",9213,35,3,32,3.66041589645416e-06,"chomp",0.461959874487264
"8961",9214,46,9,37,3.6044219047928e-06,"penetrate",0.42257055587478
"8962",9215,46,6,40,3.60670992314101e-06,"debris",0.424180076486455
"8963",9217,47,7,40,3.60674894863268e-06,"trainer",0.424207529209145
"8964",9218,54,17,37,3.66044269393941e-06,"filling",0.461978725343458
"8965",9219,51,7,44,3.53092383091112e-06,"speechless",0.370867882719449
"8966",9220,41,6,35,3.68977820743195e-06,"receiving",0.482614973150313
"8967",9221,54,13,41,3.60656683689662e-06,"socialism",0.424079421585775
"8968",9222,34,11,23,3.56600315234679e-06,"scaly",0.395544647631939
"8969",9223,29,4,25,3.33726017614059e-06,"raucous",0.234633990919963
"8970",9225,31,4,27,3.71488964920297e-06,"unicycle",0.500279771665118
"8971",9226,40,9,31,3.60474673049471e-06,"babble",0.422799056517199
"8972",9227,40,7,33,3.61206429474445e-06,"Popsicle",0.427946642198234
"8973",9228,38,7,31,3.58483328732797e-06,"tenant",0.408790822163946
"8974",9230,38,3,35,3.60682700214967e-06,"frisky",0.424262436436836
"8975",9231,30,3,27,3.59663067638236e-06,"immense",0.417089768219967
"8976",9232,37,10,27,3.40759621347909e-06,"laid back",0.284112309976428
"8977",9233,33,6,27,3.52604335622911e-06,"mandarin",0.36743468271841
"8978",9234,39,2,37,3.40064340173161e-06,"whereas",0.27922131169164
"8979",9235,49,19,30,3.39841294115648e-06,"doubtful",0.277652280450259
"8980",9236,50,19,31,3.63168866259433e-06,"fax",0.441751524737824
"8981",9237,46,11,35,3.60695709885227e-06,"tiptoe",0.424353953764267
"8982",9239,25,3,22,3.40176551630296e-06,"dendrite",0.280010670104201
"8983",9240,42,3,39,3.56540558271206e-06,"vibrator",0.395124283588638
"8984",9241,56,22,34,3.6474385862528e-06,"superhero",0.45283090562672
"8985",9242,53,15,38,3.67860742637267e-06,"screaming",0.474756818351217
"8986",9243,35,10,25,3.56122819638037e-06,"Edison",0.392185675421861
"8987",9244,50,6,44,3.54870419066478e-06,"medicinal",0.383375586396249
"8988",9245,55,11,44,3.57355994468129e-06,"vegetation",0.400860519783944
"8989",9246,30,3,27,3.45240684543229e-06,"woolly",0.315634625261725
"8990",9247,56,15,41,3.581341212284e-06,"stuck-up",0.406334300447159
"8991",9248,44,5,39,3.62992217446858e-06,"copious",0.440508877776141
"8992",9249,46,8,38,3.57178575000357e-06,"thong",0.399612451600773
"8993",9250,37,3,34,3.62021091348782e-06,"delirious",0.433677431373578
"8994",9251,43,4,39,3.34685462602246e-06,"buttery",0.241383265834924
"8995",9252,51,9,42,3.51810416402809e-06,"floral",0.361849809022979
"8996",9253,44,8,36,3.65002135262491e-06,"steroids",0.454647768552797
"8997",9254,37,5,32,3.60695709885227e-06,"fleece",0.424353953764267
"8998",9256,34,5,29,3.67246058531677e-06,"foxy",0.470432785117872
"8999",9257,39,16,23,3.29144421989481e-06,"circumference",0.202404474063667
"9000",9258,51,5,46,3.62534259487522e-06,"badly",0.437287344280098
"9001",9259,46,8,38,3.60133249302242e-06,"stand up",0.420397290120042
"9002",9260,46,10,36,3.49584344214729e-06,"shrill",0.34619036698838
"9003",9261,57,15,42,3.7291586645137e-06,"psychotic",0.510317398447646
"9004",9262,30,5,25,3.59030330882353e-06,"look for",0.412638742505269
"9005",9263,45,12,33,3.61729064930367e-06,"shriek",0.431623153531096
"9006",9264,40,9,31,3.43541084078245e-06,"devout",0.303678681017907
"9007",9266,53,10,43,3.75551591399869e-06,"crappy",0.528858568078698
"9008",9267,58,17,41,3.59225079658161e-06,"spikes",0.414008714774098
"9009",9268,51,13,38,3.62934250831119e-06,"imp",0.440101108044342
"9010",9270,47,15,32,3.57866258221977e-06,"longer",0.404450001615903
"9011",9271,58,16,42,3.53758149703374e-06,"not enough",0.375551258994985
"9012",9272,56,12,44,3.59221208420145e-06,"mime",0.413981482311628
"9013",9273,38,6,32,3.57380259743973e-06,"scented",0.401031215362714
"9014",9274,47,2,45,3.62224347271726e-06,"bonding",0.435107247693362
"9015",9275,39,2,37,3.61457105885245e-06,"pretender",0.429710040863104
"9016",9276,35,5,30,3.58799743099384e-06,"paintbrush",0.411016658531252
"9017",9277,52,10,42,3.66069728961973e-06,"spies",0.46215782224425
"9018",9278,51,2,49,3.67134150818709e-06,"songbird",0.469645563412383
"9019",9279,39,11,28,3.56236997349597e-06,"desolate",0.392988865572383
"9020",9280,54,10,44,3.60339584023984e-06,"graphics",0.421848764439766
"9021",9281,37,10,27,3.42230177172563e-06,"gluttony",0.294457025578247
"9022",9282,40,7,33,3.54533239263847e-06,"kittens",0.381003674288993
"9023",9283,36,5,31,3.62179742562639e-06,"hushed",0.434793473117604
"9024",9284,58,20,38,3.64610869050006e-06,"chic",0.451895382261233
"9025",9285,54,16,38,3.6441422235827e-06,"parasite",0.450512058985813
"9026",9286,37,8,29,3.52611795569785e-06,"confound",0.367487160174572
"9027",9287,54,8,46,3.70081158798124e-06,"stunt",0.490376472713646
"9028",9288,25,2,23,3.45849631497218e-06,"honeydew",0.319918300148454
"9029",9289,51,11,40,3.55319307695861e-06,"awaken",0.386533321131651
"9030",9290,56,8,48,3.71180092869259e-06,"dreamer",0.498106992181491
"9031",9291,60,12,48,3.67360733545913e-06,"ties",0.471239473574725
"9032",9292,38,6,32,3.48982889368934e-06,"chastity",0.341959395798596
"9033",9294,42,6,36,3.59087057066115e-06,"put on",0.413037786341863
"9034",9295,52,16,36,3.53829496642158e-06,"disappointed",0.376053153434087
"9035",9296,40,5,35,3.71639450270925e-06,"red tape",0.501338370140871
"9036",9298,40,5,35,3.65263446260615e-06,"alcoholism",0.456485976877774
"9037",9299,60,18,42,3.65765785536889e-06,"fired",0.460019713483727
"9038",9300,48,12,36,3.56667724780917e-06,"caramel",0.396018844240453
"9039",9302,73,33,40,3.56283958314777e-06,"Texas",0.393319215376879
"9040",9303,49,10,39,3.68458480256152e-06,"soggy",0.478961640479156
"9041",9304,50,9,41,3.55201932298512e-06,"swinging",0.385707636663322
"9042",9305,35,6,29,3.46955981694602e-06,"headline",0.327700988813576
"9043",9306,47,8,39,3.56915960567925e-06,"decadent",0.397765074186803
"9044",9307,55,13,42,3.81552690518797e-06,"cynical",0.571073669772138
"9045",9308,54,23,31,3.53635550274598e-06,"claws",0.374688825755547
"9046",9310,41,10,31,3.51000351000351e-06,"boogie",0.356151354012424
"9047",9311,34,2,32,3.58067438421352e-06,"body parts",0.405865216130279
"9048",9312,30,3,27,3.47537177789594e-06,"beeswax",0.331789448571975
"9049",9313,39,4,35,3.51043476734594e-06,"translation",0.356454724648465
"9050",9314,40,2,38,3.47887799226993e-06,"telepathy",0.334255916687627
"9051",9315,41,6,35,3.5793799082247e-06,"cogs",0.404954609016067
"9052",9316,42,6,36,3.5633601060456e-06,"droopy",0.393685380418151
"9053",9317,50,7,43,3.734255445478e-06,"threaten",0.513902760436397
"9054",9318,40,11,29,3.28000052480008e-06,"thyme",0.194354336203944
"9055",9319,42,2,40,3.54942215407332e-06,"succumb",0.383880642181913
"9056",9320,54,21,33,3.54014882785672e-06,"beep",0.377357263688878
"9057",9321,78,26,52,3.60526657341044e-06,"supernatural",0.423164743220868
"9058",9323,36,5,31,3.47887799226993e-06,"folklore",0.334255916687627
"9059",9324,45,4,41,3.59498858591124e-06,"shaman",0.415934629555289
"9060",9325,49,8,41,3.63226907849333e-06,"joystick",0.442159821879985
"9061",9326,49,15,34,3.4385412332672e-06,"next to",0.305880774908796
"9062",9327,55,7,48,3.66394313560254e-06,"snitch",0.464441132610068
"9063",9328,53,15,38,3.69486340090007e-06,"politeness",0.486192183843439
"9064",9329,47,4,43,3.58909203149787e-06,"triangular",0.411786662003543
"9065",9330,43,4,39,3.37983993078088e-06,"peaches",0.264586981807111
"9066",9331,39,5,34,3.40707376655412e-06,"audible",0.283744791466404
"9067",9332,32,7,25,3.59087057066115e-06,"cedar",0.413037786341863
"9068",9333,70,24,46,3.68120743603902e-06,"hippy",0.476585811178924
"9069",9334,37,8,29,3.67220435082771e-06,"amusing",0.470252535386975
"9070",9335,41,10,31,3.50214856814656e-06,"mystical",0.350625746740893
"9071",9337,144,89,55,3.7556851684237e-06,"horses",0.528977631147354
"9072",9338,75,25,50,3.77414034518288e-06,"gardening",0.541960039006634
"9073",9339,38,6,32,3.53700592448492e-06,"grotesque",0.37514636893737
"9074",9340,30,2,28,3.58258576710326e-06,"cloying",0.407209790206902
"9075",9341,68,21,47,3.61589111828665e-06,"gypsy",0.430638644809677
"9076",9343,54,21,33,3.7281159593188e-06,"tits",0.509583901050475
"9077",9344,40,3,37,3.52573255908246e-06,"telegram",0.367216050549675
"9078",9345,38,8,30,3.50513151253435e-06,"fragment",0.352724117359024
"9079",9346,37,7,30,3.57427522634098e-06,"dopey",0.401363689076848
"9080",9347,35,3,32,3.49168106985108e-06,"camper",0.343262320537421
"9081",9349,58,16,42,3.66296341065849e-06,"minerals",0.463751939058607
"9082",9351,41,5,36,3.68938343024114e-06,"wiry",0.482337264701808
"9083",9352,45,5,40,3.77761911777483e-06,"specialist",0.544407203031546
"9084",9353,34,3,31,3.59925855273814e-06,"unprofessional",0.418938364042135
"9085",9354,35,2,33,3.53269509308652e-06,"warship",0.372113888015783
"9086",9355,44,4,40,3.62463300590815e-06,"seminar",0.436788179546913
"9087",9356,33,6,27,3.55300370933587e-06,"no money",0.386400109310069
"9088",9357,37,3,34,3.47615703887039e-06,"beets",0.332341845245238
"9089",9358,48,3,45,3.69644771374709e-06,"provocative",0.487306678482266
"9090",9359,51,4,47,3.64644107351225e-06,"hypnotism",0.452129199140152
"9091",9360,27,3,24,3.36720744018156e-06,"nebula",0.255700578421278
"9092",9361,45,3,42,3.55196885633707e-06,"hairdryer",0.385672135588647
"9093",9362,56,17,39,3.69438564213964e-06,"abortion",0.485856101498243
"9094",9363,48,17,31,3.44492596854094e-06,"Buddhist",0.310372156296188
"9095",9364,32,4,28,3.34910763027191e-06,"constrict",0.242968155562979
"9096",9365,41,10,31,3.53977288817149e-06,"measles",0.377092806599801
"9097",9366,58,19,39,3.6612736106382e-06,"islands",0.462563238817458
"9098",9367,58,25,33,3.44617250850343e-06,"feces",0.311249042517175
"9099",9368,27,5,22,3.35751865940995e-06,"tad",0.248884945860421
"9100",9369,29,2,27,3.37952010814464e-06,"birch",0.264362000602086
"9101",9370,46,11,35,3.52156075572694e-06,"obedient",0.364281369761901
"9102",9371,54,16,38,3.69595588507056e-06,"idle",0.486960698567852
"9103",9372,45,3,42,3.64995474056122e-06,"hustler",0.454600909885956
"9104",9373,79,28,51,3.73162176281812e-06,"fireworks",0.512050080133808
"9105",9374,42,13,29,3.45209697630826e-06,"believer",0.315416645916216
"9106",9375,45,3,42,3.5770624447791e-06,"almonds",0.403324375069117
"9107",9376,42,2,40,3.63046248461592e-06,"mutant",0.440888962280059
"9108",9377,39,9,30,3.62632859613941e-06,"stutter",0.437980952947659
"9109",9378,32,3,29,3.43352355053803e-06,"soundless",0.302351055061159
"9110",9379,47,6,41,3.50784881171621e-06,"tofu",0.35463561821946
"9111",9380,62,22,40,3.71254506101568e-06,"flaky",0.498630456651413
"9112",9382,59,19,40,3.6363239673749e-06,"South America",0.445012258460328
"9113",9383,26,2,24,3.46817601686921e-06,"hydrate",0.326727546119021
"9114",9384,59,24,35,3.73450646629795e-06,"frustrated",0.514079342579619
"9115",9386,36,4,32,3.51767102037083e-06,"cranberry",0.361545111447142
"9116",9387,51,10,41,3.66100553177936e-06,"balm",0.46237465709162
"9117",9389,41,8,33,3.56732614636026e-06,"armed",0.396475315926391
"9118",9390,50,18,32,3.49151039248068e-06,"ours",0.343142256489065
"9119",9391,51,11,40,3.63799081043521e-06,"morbid",0.446184809486458
"9120",9392,40,5,35,3.52823291982443e-06,"bladder",0.368974944727238
"9121",9393,36,2,34,3.44359731950385e-06,"juicer",0.309437509940511
"9122",9394,55,16,39,3.49628345069191e-06,"racial",0.346499893711557
"9123",9395,41,4,37,3.51101405107823e-06,"shipment",0.356862225360978
"9124",9397,40,15,25,3.34119628191678e-06,"pester",0.237402868792579
"9125",9398,37,6,31,3.62532945181393e-06,"membership",0.437278098712618
"9126",9399,30,3,27,3.62313589658121e-06,"brewery",0.435735028761855
"9127",9400,25,2,23,3.51754728462937e-06,"bookcase",0.361458068777037
"9128",9401,31,2,29,3.39586248115296e-06,"giggling",0.275858143638322
"9129",9402,34,3,31,3.53306953080837e-06,"wombat",0.372377288539462
"9130",9403,57,18,39,3.65495740147149e-06,"aging",0.458120062542487
"9131",9404,63,19,44,3.6499280964165e-06,"ancestors",0.454582166898106
"9132",9405,31,4,27,3.49504926271936e-06,"queasy",0.345631696574037
"9133",9406,92,56,36,3.68603802516827e-06,"dreams",0.479983918880348
"9134",9407,34,2,32,3.6377393632501e-06,"finisher",0.44600792741403
"9135",9408,50,16,34,3.58773997495757e-06,"Las Vegas",0.410835549495438
"9136",9409,35,4,31,3.55764270594304e-06,"doorknob",0.389663440070755
"9137",9410,39,8,31,3.5403242937053e-06,"rave",0.377480696221731
"9138",9411,55,20,35,3.59270250267656e-06,"arc",0.41432647021116
"9139",9412,32,4,28,3.52190802889373e-06,"HIV",0.364525661211869
"9140",9413,52,2,50,3.68542671713244e-06,"bulldog",0.479553890474103
"9141",9414,50,11,39,3.67755222124154e-06,"seductive",0.474014527796848
"9142",9415,40,4,36,3.57183678134644e-06,"ferret",0.399648349913499
"9143",9416,38,3,35,3.48919570549793e-06,"hoarse",0.341513975662018
"9144",9417,39,6,33,3.64172690689925e-06,"boiler",0.448812989575476
"9145",9418,49,8,41,3.69437199370479e-06,"ranger",0.485846500422611
"9146",9419,65,15,50,3.72511622362618e-06,"dried",0.507473718485451
"9147",9420,43,6,37,3.61467558286644e-06,"freckles",0.429783568925091
"9148",9421,30,8,22,3.29918675046601e-06,"tusks",0.207851004923273
"9149",9422,49,8,41,3.52439054476505e-06,"clasp",0.366272002305161
"9150",9423,49,4,45,3.56761886414151e-06,"uranium",0.396681230054086
"9151",9424,35,2,33,3.57247479619031e-06,"starfish",0.400097165388503
"9152",9426,46,13,33,3.6474385862528e-06,"leafy",0.45283090562672
"9153",9427,38,3,35,3.45903465260915e-06,"madame",0.320296997077798
"9154",9428,30,6,24,3.40997827843837e-06,"aquarium",0.285787988256414
"9155",9429,46,12,34,3.4720896076886e-06,"spew",0.329480585706483
"9156",9430,46,9,37,3.60518858741501e-06,"troublesome",0.423109883491633
"9157",9431,43,9,34,3.45216847963048e-06,"assure",0.315466945369019
"9158",9433,42,7,35,3.62544774279624e-06,"diagnosis",0.43736131123333
"9159",9434,39,10,29,3.52950311655125e-06,"banister",0.369868472444921
"9160",9435,52,15,37,3.69659802084142e-06,"embarrassing",0.48741241293435
"9161",9436,51,16,35,3.46128552144266e-06,"intestines",0.321880384634348
"9162",9437,40,5,35,3.4283911931487e-06,"reddish",0.298740666616912
"9163",9438,44,8,36,3.64791758624589e-06,"virginity",0.453167861124681
"9164",9439,45,7,38,3.63393220536078e-06,"feminist",0.443329758727332
"9165",9440,34,4,30,3.61600879413339e-06,"toothache",0.430721424609487
"9166",9441,29,3,26,3.56240804534233e-06,"heifer",0.393015647447402
"9167",9442,41,7,34,3.55132553225491e-06,"baggy",0.385219585297247
"9168",9443,39,2,37,3.63274410223995e-06,"cutie",0.442493980262854
"9169",9444,40,5,35,3.64086506954052e-06,"adoption",0.44820672477263
"9170",9445,56,8,48,3.65581255917847e-06,"suspicion",0.458721628503133
"9171",9446,56,25,31,3.59853323785225e-06,"curly",0.418428136814412
"9172",9447,48,7,41,3.77292998196539e-06,"childlike",0.541108601539941
"9173",9448,49,4,45,3.5635251816507e-06,"additive",0.393801503870176
"9174",9449,41,6,35,3.59056113289385e-06,"reset",0.412820110436907
"9175",9450,37,3,34,3.50696307518578e-06,"convincing",0.354012541396951
"9176",9451,56,12,44,3.62405502765154e-06,"elephants",0.436381597179318
"9177",9452,47,9,38,3.5314350692691e-06,"overtake",0.371227516493929
"9178",9454,73,34,39,3.77311504605087e-06,"stressed",0.541238786011706
"9179",9455,43,10,33,3.44286225796678e-06,"marching",0.308920426370933
"9180",9456,47,3,44,3.5047506895597e-06,"scholarly",0.352456225089899
"9181",9457,43,9,34,3.56449054518883e-06,"rehab",0.394480594802117
"9182",9460,34,4,30,3.61292560263599e-06,"muppet",0.428552534544125
"9183",9461,39,6,33,3.50061610843508e-06,"irony",0.349547728509918
"9184",9462,51,12,39,3.68917926828818e-06,"mindless",0.482193645717434
"9185",9463,43,5,38,3.51057032725537e-06,"install",0.356550085102421
"9186",9464,57,13,44,3.71237967249387e-06,"unreasonable",0.498514113076197
"9187",9465,35,3,32,3.47017385571017e-06,"scrawny",0.328132938167494
"9188",9466,45,8,37,3.53179676628688e-06,"undress",0.37148195449079
"9189",9467,53,3,50,3.70543290572638e-06,"landmark",0.493627367169848
"9190",9468,34,10,24,3.59116716524038e-06,"rotund",0.413246427626994
"9191",9469,41,2,39,3.68438117133846e-06,"redemption",0.478818394839996
"9192",9470,35,2,33,3.67805269178286e-06,"chopper",0.474366586884321
"9193",9471,56,21,35,3.71100200765209e-06,"relationships",0.49754498625055
"9194",9472,42,6,36,3.5498883560112e-06,"lengthen",0.38420859480905
"9195",9474,36,6,30,3.5573010045818e-06,"twat",0.389423068141753
"9196",9475,59,15,44,3.76640741228979e-06,"refined",0.536520259692865
"9197",9476,59,19,40,3.5633601060456e-06,"forgiveness",0.393685380418151
"9198",9477,45,6,39,3.68896152044238e-06,"hiccup",0.482040469652984
"9199",9479,74,31,43,3.77626391553253e-06,"teenagers",0.543453877659973
"9200",9480,38,6,32,3.5869806948699e-06,"episode",0.410301429237137
"9201",9481,45,13,32,3.60050263016717e-06,"conspiracy",0.419813517978779
"9202",9482,44,8,36,3.31756384651623e-06,"naval",0.220778486426503
"9203",9483,45,3,42,3.47755930977403e-06,"indigestion",0.333328281356786
"9204",9484,58,21,37,3.71544174744656e-06,"loneliness",0.500668148578016
"9205",9485,30,3,27,3.37576672101651e-06,"caribou",0.261721657288822
"9206",9486,38,4,34,3.50083669997129e-06,"cyclist",0.349702904985913
"9207",9487,55,13,42,3.69719937147611e-06,"filled",0.487835436745383
"9208",9488,47,12,35,3.7151656778134e-06,"animation",0.500473945692721
"9209",9489,36,5,31,3.39364980248958e-06,"celibacy",0.274301621192377
"9210",9490,37,6,31,3.53524283583039e-06,"revolver",0.373906113354676
"9211",9491,51,8,43,3.76412487860697e-06,"warming",0.534914597302873
"9212",9492,34,2,32,3.47829716483998e-06,"disarm",0.333847330051482
"9213",9493,42,8,34,3.4553653184983e-06,"hysterical",0.31771578137769
"9214",9494,41,6,35,3.60589058285615e-06,"dilute",0.4236037065122
"9215",9495,31,3,28,3.36317591427937e-06,"carbohydrate",0.252864576672802
"9216",9496,33,4,29,3.62996170390402e-06,"sitcom",0.440536685001187
"9217",9497,53,14,39,3.54662751189894e-06,"invasion",0.381914733916606
"9218",9499,46,8,38,3.45701376237179e-06,"wake up",0.318875389382427
"9219",9500,29,2,27,3.36275746111812e-06,"eczema",0.252570213216938
"9220",9501,60,15,45,3.71148407402184e-06,"grandparent",0.497884098810079
"9221",9503,42,6,36,3.74428061136614e-06,"extremely",0.520955025181139
"9222",9504,44,3,41,3.43342924045678e-06,"cream cheese",0.302284712053124
"9223",9505,48,4,44,3.57061243144424e-06,"repel",0.39878707342722
"9224",9506,64,24,40,3.56490987907826e-06,"discrimination",0.394775577811644
"9225",9507,46,9,37,3.62674945326752e-06,"autism",0.438277007488827
"9226",9509,43,7,36,3.54228066198141e-06,"whining",0.378856915545708
"9227",9512,40,8,32,3.55422864352864e-06,"nibble",0.387261796819151
"9228",9513,35,4,31,3.475589199259e-06,"absorbent",0.331942394970129
"9229",9514,28,2,26,3.46195655936909e-06,"emu",0.322352430400348
"9230",9515,37,5,32,3.62304400911558e-06,"underdog",0.435670389957712
"9231",9516,41,3,38,3.5706379301726e-06,"reincarnation",0.398805010664876
"9232",9517,35,4,31,3.58229058824794e-06,"rusty",0.407002144821475
"9233",9519,40,9,31,3.57008978775816e-06,"reverend",0.398419416504379
"9234",9520,48,8,40,3.58099494363514e-06,"arrows",0.406090715631523
"9235",9523,41,5,36,3.39570104248022e-06,"screws",0.275744578608783
"9236",9525,38,7,31,3.56042938778417e-06,"astonishing",0.39162374859056
"9237",9526,39,7,32,3.50693847777828e-06,"felon",0.353995238199015
"9238",9527,32,3,29,3.56011249955499e-06,"shanty",0.391400831612266
"9239",9528,35,2,33,3.53488043266936e-06,"spud",0.373651178616994
"9240",9529,46,2,44,3.61370896633469e-06,"barefoot",0.429103596567066
"9241",9530,31,4,27,3.46212435950699e-06,"machete",0.322470470441769
"9242",9531,39,5,34,3.56592685570834e-06,"meatball",0.395490976291286
"9243",9532,40,3,37,3.43871859590242e-06,"crusade",0.306005541747906
"9244",9533,47,5,42,3.60833670111425e-06,"voluntary",0.425324443480102
"9245",9534,41,6,35,3.63171504111101e-06,"imitation",0.441770080867996
"9246",9535,40,10,30,3.55764270594304e-06,"coerce",0.389663440070755
"9247",9537,43,5,38,3.52873092720934e-06,"gambler",0.369325271092145
"9248",9538,34,3,31,3.53205873107258e-06,"wizened",0.371666235234188
"9249",9539,34,8,26,3.50744279360804e-06,"motorway",0.354350002278339
"9250",9540,44,9,35,3.46888582856072e-06,"clause",0.327226867529095
"9251",9541,31,3,28,3.39808959403024e-06,"counterfeit",0.27742481992101
"9252",9543,37,6,31,3.519255607054e-06,"emo",0.362659798717693
"9253",9544,40,6,34,3.45330101043588e-06,"scorpion",0.316263631145629
"9254",9546,45,7,38,3.44917978504712e-06,"duke",0.313364529740366
"9255",9547,22,3,19,3.44573314864204e-06,"ebony",0.310939972114217
"9256",9548,52,15,37,3.65188747804303e-06,"demonstration",0.455960505982011
"9257",9549,35,2,33,3.47052311194866e-06,"spineless",0.328378624621473
"9258",9550,51,11,40,3.63830847762258e-06,"Canadian",0.446408274427692
"9259",9551,50,10,40,3.61188164586223e-06,"interfere",0.427818156716089
"9260",9552,61,16,45,3.49868099726403e-06,"fruits",0.348186462627532
"9261",9553,40,8,32,3.37509450264607e-06,"surreal",0.261248781132208
"9262",9554,41,8,33,3.68208848058619e-06,"collaboration",0.477205587396881
"9263",9555,40,4,36,3.55630158859992e-06,"vanquish",0.388720022808337
"9264",9556,39,3,36,3.66249386532278e-06,"bungalow",0.463421634497658
"9265",9557,32,2,30,3.5294159169599e-06,"finch",0.369807131354839
"9266",9558,48,13,35,3.65170077963812e-06,"putrid",0.455829171838163
"9267",9559,39,8,31,3.49502483215143e-06,"woozy",0.345614510740426
"9268",9560,44,5,39,3.57440298534137e-06,"godly",0.401453561933253
"9269",9561,44,6,38,3.52665267761105e-06,"swish",0.367863313600732
"9270",9562,28,2,26,3.38070832600847e-06,"lasagna",0.265197859783231
"9271",9563,47,5,42,3.59484642816059e-06,"dab",0.415834627809254
"9272",9564,31,5,26,3.33318889514788e-06,"charred",0.231770023207982
"9273",9565,44,6,38,3.45160844953748e-06,"shackle",0.315072988747763
"9274",9566,80,57,23,3.64114346469365e-06,"Christianity",0.448402563559282
"9275",9567,43,7,36,3.65761772042633e-06,"underpants",0.459991480310969
"9276",9570,49,7,42,3.61917584127742e-06,"tempting",0.432949303446411
"9277",9571,51,10,41,3.6026558779132e-06,"forwards",0.421328233379546
"9278",9572,48,7,41,3.63105569313222e-06,"hunk",0.441306258467724
"9279",9573,38,4,34,3.53875824973017e-06,"eruption",0.376379052933452
"9280",9574,48,6,42,3.72047339303453e-06,"backstabber",0.504207690684751
"9281",9575,37,3,34,3.58487184083169e-06,"whisker",0.408817942863802
"9282",9576,53,20,33,3.69823852898864e-06,"Chicago",0.488566438503525
"9283",9577,53,19,34,3.59837785126465e-06,"impolite",0.418318829161474
"9284",9578,48,9,39,3.56947810660603e-06,"diligent",0.397989125627169
"9285",9579,56,12,44,3.65387566591884e-06,"vibration",0.457359108999555
"9286",9580,31,4,27,3.43629622247956e-06,"licorice",0.30430150823073
"9287",9581,55,22,33,3.65732342442507e-06,"unpredictable",0.459784455974674
"9288",9583,40,5,35,3.64846326727182e-06,"pep",0.453551723806258
"9289",9584,59,22,37,3.58627318077327e-06,"sparkly",0.409803724084351
"9290",9585,59,4,55,3.75489544493634e-06,"traumatic",0.528422095291869
"9291",9586,50,10,40,3.54700490905479e-06,"spite",0.382180216272383
"9292",9587,37,3,34,3.60413610659593e-06,"candid",0.422369509371371
"9293",9588,46,6,40,3.5857073704215e-06,"daze",0.409405701304425
"9294",9590,40,5,35,3.54021149223455e-06,"extinction",0.377401345331756
"9295",9591,38,3,35,3.63555720367482e-06,"whispering",0.444472873808746
"9296",9592,29,2,27,3.46964408390987e-06,"Scientology",0.327760266928764
"9297",9593,29,3,26,3.31990983124898e-06,"strainer",0.222428783848724
"9298",9594,49,7,42,3.70849727981725e-06,"aromatic",0.495783020014587
"9299",9595,43,6,37,3.56045474127956e-06,"worsen",0.391641583663185
"9300",9596,34,3,31,3.52096558960329e-06,"herself",0.363862696483285
"9301",9597,49,11,38,3.66546073008647e-06,"calculation",0.465508693805092
"9302",9598,53,14,39,3.64815713342405e-06,"screech",0.45333637206386
"9303",9599,39,6,33,3.53736876361887e-06,"groundhog",0.375401610362888
"9304",9600,38,14,24,3.370032992623e-06,"NASA",0.257688230704494
"9305",9601,31,2,29,3.50133926226782e-06,"minotaur",0.350056435531479
"9306",9602,35,2,33,3.47110134574599e-06,"go on",0.328785386750759
"9307",9603,51,4,47,3.72974283423158e-06,"deprive",0.510728336236839
"9308",9604,42,8,34,3.48114265026352e-06,"backup",0.335849004313837
"9309",9605,35,3,32,3.4552339884457e-06,"get ready",0.317623396442596
"9310",9606,36,11,25,3.56794982035373e-06,"utensils",0.396914043241772
"9311",9607,28,3,25,3.3857217343021e-06,"venison",0.268724572752844
"9312",9608,52,18,34,3.55301633321608e-06,"wobbly",0.386408989656425
"9313",9609,53,11,42,3.53403095104307e-06,"heating",0.373053605530296
"9314",9611,31,5,26,3.39825125990165e-06,"jerky",0.277538544774858
"9315",9612,35,4,31,3.60342180935016e-06,"bodily",0.421867032570506
"9316",9614,43,10,33,3.62897372623022e-06,"shifty",0.439841686016103
"9317",9615,50,4,46,3.7027711539316e-06,"drunken",0.491754941461287
"9318",9617,29,2,27,3.28959271552589e-06,"sleeplessness",0.201102021901645
"9319",9618,40,5,35,3.66568914956012e-06,"wacko",0.465669376891937
"9320",9619,43,8,35,3.59606159334297e-06,"bodybuilder",0.416689443247759
"9321",9620,25,3,22,3.29451298861746e-06,"bridal",0.204563218339225
"9322",9621,51,18,33,3.58566879894438e-06,"bendy",0.409378567961068
"9323",9622,52,24,28,3.57232165184153e-06,"goofy",0.399989435052285
"9324",9624,44,2,42,3.54802428267819e-06,"warranty",0.38289730093175
"9325",9626,45,13,32,3.46229217591214e-06,"expel",0.322588521926484
"9326",9627,51,4,47,3.71484824844905e-06,"psychosis",0.500250648049555
"9327",9628,45,5,40,3.5250241464154e-06,"notification",0.366717713291979
"9328",9629,52,5,47,3.65938449152853e-06,"zesty",0.461234326334172
"9329",9630,46,14,32,3.44580438857647e-06,"ingredients",0.310990086285256
"9330",9631,68,27,41,3.62139083136269e-06,"points",0.434507451876332
"9331",9632,52,13,39,3.42620636726191e-06,"CIA",0.29720373737836
"9332",9633,30,3,27,3.40420896396304e-06,"flapjack",0.281729528423465
"9333",9634,47,18,29,3.49551350841195e-06,"relatives",0.345958273068364
"9334",9636,43,11,32,3.42537310876587e-06,"take out",0.296617576552648
"9335",9637,54,14,40,3.5631188692086e-06,"bitchy",0.393515680878044
"9336",9640,36,2,34,3.56446513418429e-06,"nightlife",0.394462719274326
"9337",9641,26,4,22,3.55526481389966e-06,"cranny",0.387990697254182
"9338",9642,34,5,29,3.55706058741299e-06,"vulva",0.389253945202282
"9339",9643,39,7,32,3.57684493661831e-06,"bathing",0.403171367612567
"9340",9644,47,4,43,3.56931247903029e-06,"hallucinate",0.397872613887991
"9341",9645,39,8,31,3.62717040809294e-06,"nip",0.438573130755771
"9342",9646,40,3,37,3.49964828534732e-06,"outrage",0.348866907392628
"9343",9647,41,4,37,3.55449394669681e-06,"hick",0.387448425968277
"9344",9648,38,10,28,3.52412971616659e-06,"jiggle",0.366088520819686
"9345",9649,30,4,26,3.56272534237791e-06,"toucan",0.393238852003075
"9346",9650,38,10,28,3.40846731450269e-06,"cannabis",0.284725091361433
"9347",9651,47,4,43,3.55155256120213e-06,"chant",0.385379290209699
"9348",9652,34,10,24,3.42719271790091e-06,"white coat",0.297897591815782
"9349",9653,45,3,42,3.50140056022409e-06,"heirloom",0.350099555956693
"9350",9654,89,48,41,3.80807311500381e-06,"German",0.565830255117754
"9351",9655,35,4,31,3.47499739375195e-06,"sideburns",0.331526085737974
"9352",9656,38,3,35,3.5124199168259e-06,"legendary",0.357851190287716
"9353",9657,33,5,28,3.47137848439615e-06,"spacious",0.328980341642653
"9354",9658,43,5,38,3.65693556113848e-06,"breastfeeding",0.459511611154715
"9355",9659,39,3,36,3.59540219966707e-06,"foster",0.416225588701571
"9356",9660,41,3,38,3.53428075619471e-06,"earwax",0.373229332504157
"9357",9661,49,8,41,3.71740302224866e-06,"trader",0.502047819427944
"9358",9664,40,6,34,3.56468113927209e-06,"bimbo",0.394614669384917
"9359",9666,38,4,34,3.48435697934125e-06,"muffled",0.338110143918486
"9360",9667,47,9,38,3.63343046704115e-06,"disobey",0.442976807813397
"9361",9668,41,7,34,3.51345653854262e-06,"gutter",0.35858040822466
"9362",9670,61,9,52,3.52552124831656e-06,"glamorous",0.367067402688766
"9363",9671,39,5,34,3.64803735590252e-06,"doctorate",0.453252113827967
"9364",9672,29,5,24,3.3395225818517e-06,"neurology",0.236225494164175
"9365",9673,47,9,38,3.52504899818107e-06,"lighthouse",0.366735195419742
"9366",9674,43,15,28,3.55104809184431e-06,"of course",0.385024418130108
"9367",9675,35,8,27,3.46029142574388e-06,"wooly",0.321181081886874
"9368",9676,36,2,34,3.69986680479503e-06,"sailboat",0.489711859157129
"9369",9677,42,12,30,3.53892105374913e-06,"underneath",0.376493578424207
"9370",9678,59,19,40,3.58906626851958e-06,"hazy",0.411768538877648
"9371",9679,34,2,32,3.2964243684875e-06,"lubrication",0.205907790291623
"9372",9680,21,2,19,3.31689260233443e-06,"dingo",0.220306295568893
"9373",9681,44,14,30,3.42937880232375e-06,"heard",0.299435406379272
"9374",9682,43,8,35,3.67978510055013e-06,"masturbate",0.47558526051119
"9375",9683,46,10,36,3.61692431224184e-06,"leggings",0.431365451466645
"9376",9684,40,4,36,3.61549892077357e-06,"capitalist",0.43036275105138
"9377",9685,45,8,37,3.56418563704472e-06,"scatter",0.394266105288519
"9378",9688,37,7,30,3.46248398601156e-06,"receiver",0.322723451923348
"9379",9689,37,4,33,3.53018840615524e-06,"unwise",0.370350543641353
"9380",9690,32,3,29,3.49269328564643e-06,"promiscuous",0.343974369978523
"9381",9691,35,4,31,3.59837785126465e-06,"fondue",0.418318829161474
"9382",9692,33,3,30,3.3333555557037e-06,"rotor",0.231887261603369
"9383",9693,39,11,28,3.57564272177924e-06,"a little",0.4023256621729
"9384",9694,43,7,36,3.69250311093387e-06,"nerdy",0.484531823316568
"9385",9695,32,4,28,3.51475317645818e-06,"opium",0.359492536159566
"9386",9696,49,9,40,3.65263446260615e-06,"planner",0.456485976877774
"9387",9697,46,10,36,3.6274203962594e-06,"burrito",0.438748986472536
"9388",9698,41,9,32,3.40281889517276e-06,"jab",0.280751675963778
"9389",9699,47,8,39,3.60218868984795e-06,"asset",0.42099958705504
"9390",9700,31,8,23,3.41716785128486e-06,"samurai",0.290845537595827
"9391",9701,58,20,38,3.58713509868209e-06,"sparkling",0.41041004555065
"9392",9702,49,6,43,3.38907227535534e-06,"blueberries",0.271081531511358
"9393",9704,37,5,32,3.48510986808859e-06,"coy",0.338639768149033
"9394",9705,32,2,30,3.43254533534252e-06,"woodsman",0.301662923551607
"9395",9706,34,3,31,3.5338685966301e-06,"rectangular",0.372939396317652
"9396",9707,52,10,42,3.46363529305818e-06,"roasted",0.323533345962592
"9397",9708,50,15,35,3.69942880819202e-06,"sixties",0.489403747746684
"9398",9709,54,12,42,3.53695588354926e-06,"acidic",0.3751111673327
"9399",9711,57,12,45,3.51308624626735e-06,"Robin Hood",0.358319923840931
"9400",9712,36,3,33,3.56529117733045e-06,"dub",0.395043804417687
"9401",9714,50,6,44,3.72232913578684e-06,"voter",0.505513124363703
"9402",9715,41,7,34,3.62581580855693e-06,"pelvis",0.437620229361651
"9403",9716,37,6,31,3.35613266121183e-06,"trident",0.247909956883887
"9404",9717,37,2,35,3.47087243849614e-06,"necktie",0.328624360534739
"9405",9718,34,4,30,3.42457543826004e-06,"amen",0.296056450318034
"9406",9719,29,2,27,3.42852049055271e-06,"hymen",0.298831621672823
"9407",9720,37,2,35,3.48440554299234e-06,"immune",0.338144306318219
"9408",9722,34,4,30,3.4185112383557e-06,"sorcerer",0.2917905515122
"9409",9723,44,14,30,3.58770135973882e-06,"java",0.410808385381756
"9410",9725,53,10,43,3.54537010118486e-06,"weaken",0.381030200598409
"9411",9726,39,4,35,3.71480684861791e-06,"placenta",0.500221525083125
"9412",9727,52,16,36,3.39145150733062e-06,"french fries",0.272755216911285
"9413",9728,53,7,46,3.73924033593335e-06,"heathen",0.517409412356867
"9414",9729,42,2,40,3.62930299236032e-06,"bugger",0.440073310305099
"9415",9730,60,25,35,3.54547066123028e-06,"inexperienced",0.381100940182265
"9416",9731,51,9,42,3.6235691431346e-06,"dishonesty",0.436039798720616
"9417",9732,42,5,37,3.74005146310813e-06,"runaway",0.517980004768208
"9418",9733,46,5,41,3.72765735373604e-06,"foreplay",0.509261292126186
"9419",9734,40,4,36,3.63001441115721e-06,"mobster",0.440573762243359
"9420",9735,45,3,42,3.45956118925875e-06,"herbivore",0.320667392529829
"9421",9736,34,6,28,3.25816741115792e-06,"untie",0.178995697820832
"9422",9737,31,2,29,3.48310693138279e-06,"rehearsal",0.337230789976116
"9423",9738,35,3,32,3.53338162288218e-06,"flatter",0.372596831632696
"9424",9739,61,20,41,3.68291569069401e-06,"ethnic",0.477787493446613
"9425",9740,38,5,33,3.56405860737974e-06,"dose",0.394176745487607
"9426",9742,40,4,36,3.63345687086694e-06,"freshman",0.442995381747417
"9427",9743,52,9,43,3.60482469737497e-06,"intrude",0.422853902799744
"9428",9744,50,11,39,3.50022401433692e-06,"melting",0.349271907499475
"9429",9745,38,4,34,3.48031879720182e-06,"quirk",0.335269459798894
"9430",9746,35,3,32,3.4712459343032e-06,"adopt",0.328887098462652
"9431",9747,41,17,24,3.53768161572995e-06,"startle",0.375621688109021
"9432",9748,34,3,31,3.52741151488215e-06,"conventional",0.368397122356988
"9433",9750,50,15,35,3.59364499818521e-06,"milkshake",0.414989474486787
"9434",9751,42,5,37,3.60507161474763e-06,"tolerant",0.423027598347679
"9435",9753,46,4,42,3.50174386844649e-06,"infidel",0.350341058242082
"9436",9754,24,2,22,3.39241794589093e-06,"mozzarella",0.273435064074204
"9437",9755,43,13,30,3.5445155710569e-06,"roller",0.380429076112094
"9438",9757,36,2,34,3.47315080768122e-06,"usurper",0.330227093383126
"9439",9758,59,14,45,3.62692045438059e-06,"wandering",0.438397299275966
"9440",9759,63,12,51,3.69691233881462e-06,"wanderer",0.487633521850232
"9441",9760,41,7,34,3.62451476808542e-06,"insincere",0.43670500442163
"9442",9761,48,9,39,3.55405179675089e-06,"roadblock",0.387137392863158
"9443",9762,36,2,34,3.61557735346969e-06,"prolong",0.430417925014966
"9444",9763,26,3,23,3.46043511511137e-06,"aborigine",0.321282161058222
"9445",9764,52,10,42,3.68641849697345e-06,"polished",0.480251564117145
"9446",9765,45,4,41,3.59139931691585e-06,"brotherhood",0.413409736154219
"9447",9766,40,4,36,3.43544624729029e-06,"ovary",0.303703587944115
"9448",9767,48,15,33,3.63923532387375e-06,"genitals",0.447060270136672
"9449",9768,70,23,47,3.64220440779577e-06,"irritable",0.449148890524717
"9450",9770,35,2,33,3.61040808442578e-06,"stepmother",0.426781570839763
"9451",9771,63,28,35,3.52723732663629e-06,"Jew",0.368274588561641
"9452",9772,26,4,22,3.37601744725817e-06,"clef",0.261898032209132
"9453",9773,47,10,37,3.56613032066644e-06,"snappy",0.395634104970335
"9454",9774,48,10,38,3.60187729844795e-06,"leftovers",0.420780536855118
"9455",9775,35,4,31,3.41364502188146e-06,"saturated",0.28836738153532
"9456",9776,42,2,40,3.58860259814828e-06,"catfish",0.411442367096633
"9457",9777,39,10,29,3.50234481985689e-06,"to be",0.350763801216334
"9458",9779,60,23,37,3.59632024512519e-06,"organs",0.416871393438434
"9459",9780,46,8,38,3.55551763003417e-06,"psychological",0.3881685423225
"9460",9781,45,5,40,3.60418806653331e-06,"gremlin",0.422406060909633
"9461",9782,47,7,40,3.5342307923392e-06,"badger",0.373194185121994
"9462",9784,52,18,34,3.67744402930187e-06,"fizz",0.473938419509933
"9463",9785,52,8,44,3.62531630884795e-06,"periods",0.437268853212174
"9464",9786,32,4,28,3.48275513793452e-06,"croissant",0.336983318706275
"9465",9788,62,19,43,3.53711852176743e-06,"congratulations",0.37522557618986
"9466",9789,42,5,37,3.48512201412171e-06,"equator",0.338648312350908
"9467",9790,42,11,31,3.63568938124202e-06,"Mr",0.444565854933211
"9468",9791,60,21,39,3.66013454654593e-06,"greens",0.461761957159925
"9469",9793,31,3,28,3.42329759410645e-06,"craggy",0.295157542970844
"9470",9794,58,19,39,3.60377242897865e-06,"appreciation",0.422113678109587
"9471",9795,44,6,38,3.51824031692309e-06,"inherent",0.361945586616289
"9472",9797,35,2,33,3.53262021506592e-06,"bracket",0.372061214610604
"9473",9798,47,8,39,3.55429180735738e-06,"fruity",0.387306229803859
"9474",9799,47,6,41,3.72109638383853e-06,"charisma",0.504645937406292
"9475",9800,41,2,39,3.63789816795448e-06,"desperation",0.446119639562288
"9476",9801,49,6,43,3.64439455673229e-06,"seashell",0.450689564295413
"9477",9803,43,3,40,3.46338337922316e-06,"creased",0.32335613562241
"9478",9804,51,20,31,3.68457122644638e-06,"handicapped",0.478952090277267
"9479",9805,44,3,41,3.57619257081755e-06,"interpretation",0.402712456868479
"9480",9806,46,2,44,3.76847968224179e-06,"overrated",0.537978010765235
"9481",9807,43,14,29,3.37789908188703e-06,"murky",0.263221679688254
"9482",9808,33,3,30,3.72303591240441e-06,"millionaire",0.506010310732297
"9483",9810,60,14,46,3.70577619335258e-06,"heavenly",0.493868854966717
"9484",9811,40,4,36,3.55392548839821e-06,"skis",0.387048540473833
"9485",9812,50,10,40,3.61092956159704e-06,"logo",0.427148407170563
"9486",9813,41,5,36,3.75138801356502e-06,"do well",0.525954771071947
"9487",9814,40,3,37,3.48008867265938e-06,"popping",0.335107577270895
"9488",9815,32,9,23,3.44056425253742e-06,"menstrual",0.307303880285453
"9489",9816,34,4,30,3.36735484175116e-06,"muggy",0.255804268964078
"9490",9817,36,3,33,3.48535280483767e-06,"shortbread",0.33881066350277
"9491",9818,39,4,35,3.75905933299251e-06,"melted",0.531351208013523
"9492",9819,54,10,44,3.5909737284362e-06,"rubbery",0.413110353314646
"9493",9820,42,3,39,3.4283911931487e-06,"psychiatric",0.298740666616912
"9494",9821,48,6,42,3.62859185235986e-06,"closely",0.439573054487909
"9495",9822,48,4,44,3.61280812737316e-06,"savvy",0.428469895846306
"9496",9823,45,8,37,3.34878238272564e-06,"rancid",0.242739358171545
"9497",9824,34,3,31,3.41899044050273e-06,"osmosis",0.2921276492166
"9498",9825,31,2,29,3.52863131448574e-06,"flounder",0.369255197907659
"9499",9826,47,10,37,3.61194687548535e-06,"eyelashes",0.427864042896589
"9500",9827,37,7,30,3.43862400022007e-06,"cymbal",0.305938997832016
"9501",9828,43,8,35,3.47702728075604e-06,"paranoid",0.332954022264361
"9502",9829,52,7,45,3.73583185767975e-06,"Thailand",0.515011697317602
"9503",9830,44,5,39,3.45563994996233e-06,"bodyguard",0.317908972574048
"9504",9831,47,10,37,3.56074633243128e-06,"James",0.391846705256394
"9505",9832,43,3,40,3.60024337645225e-06,"embassy",0.419631144354832
"9506",9833,48,13,35,3.39211875129324e-06,"drawers",0.273224593790057
"9507",9834,46,13,33,3.62546088671522e-06,"piss",0.437370557404168
"9508",9835,35,3,32,3.62402876029224e-06,"concoction",0.436363119243493
"9509",9836,55,15,40,3.57733116785553e-06,"UFO",0.403513409973795
"9510",9837,33,6,27,3.68048935786502e-06,"ma",0.476080674660789
"9511",9838,61,18,43,3.70842851633192e-06,"shaky",0.495734647916937
"9512",9839,40,9,31,3.59059980969821e-06,"edgy",0.412847317873361
"9513",9840,35,7,28,3.64033491081179e-06,"lashes",0.447833781346711
"9514",9841,46,5,41,3.43813927902219e-06,"meaty",0.305598017717276
"9515",9843,44,7,37,3.63513430003672e-06,"chromosome",0.444175379637506
"9516",9844,41,2,39,3.43914434088799e-06,"astringent",0.306305034682532
"9517",9845,47,5,42,3.54744530726198e-06,"glittery",0.382490017106085
"9518",9846,50,13,37,3.57034471678241e-06,"taco",0.398598747898008
"9519",9847,42,13,29,3.4751543837335e-06,"miser",0.331636521308265
"9520",9848,40,7,33,3.34900668461734e-06,"Norway",0.242897144719985
"9521",9849,46,8,38,3.51114965573178e-06,"translate",0.356957617290457
"9522",9850,97,62,35,3.80157309094503e-06,"dick",0.561257773123822
"9523",9851,37,5,32,3.4079678287837e-06,"browse",0.284373725053299
"9524",9852,62,28,34,3.6021627385082e-06,"anal",0.420981331425113
"9525",9853,37,3,34,3.70943271645467e-06,"beacon",0.49644105868374
"9526",9854,47,14,33,3.53144754034679e-06,"look at",0.371236289350408
"9527",9855,49,8,41,3.4152888822101e-06,"moldy",0.289523765217175
"9528",9856,35,6,29,3.50941224363744e-06,"in spite of",0.355735424042312
"9529",9857,44,5,39,3.65550519081737e-06,"craziness",0.45850540833473
"9530",9858,37,7,30,3.38501117053686e-06,"undercover",0.268224722291874
"9531",9859,47,8,39,3.44574502175988e-06,"crayfish",0.310948324332156
"9532",9860,25,2,23,3.39973006143312e-06,"portly",0.278578816828329
"9533",9861,37,8,29,3.58438355771574e-06,"testicles",0.408474457095838
"9534",9862,52,19,33,3.54479199160593e-06,"vitamins",0.380623525851319
"9535",9863,52,15,37,3.5507706947793e-06,"listening",0.384829281454698
"9536",9864,47,16,31,3.43760742523204e-06,"pus",0.305223881889947
"9537",9865,40,8,32,3.55244834740103e-06,"kosher",0.386009436533442
"9538",9866,33,3,30,3.29168257646579e-06,"himself",0.202572147462887
"9539",9867,31,3,28,3.3574510231832e-06,"shaggy",0.248837366739766
"9540",9868,38,7,31,3.71067152022501e-06,"juggle",0.497312502832667
"9541",9870,38,7,31,3.56923604071784e-06,"pubic",0.397818842885893
"9542",9871,37,4,33,3.48572942373921e-06,"puritan",0.33907559839075
"9543",9872,47,7,40,3.71960155628129e-06,"fallen",0.503594391746195
"9544",9873,31,4,27,3.48252469110006e-06,"paddock",0.336821209459973
"9545",9874,50,2,48,3.68324125230203e-06,"sweatshop",0.478016511766717
"9546",9875,31,4,27,3.49093752618203e-06,"boogers",0.34273927015981
"9547",9876,37,3,34,3.35493914140397e-06,"roasting",0.247070368017526
"9548",9877,35,4,31,3.56538015865942e-06,"icicle",0.395106398882078
"9549",9878,47,5,42,3.60243524622645e-06,"Mormon",0.421173028659405
"9550",9879,63,23,40,3.59101241412992e-06,"gears",0.413137567004368
"9551",9881,50,17,33,3.43608368925434e-06,"cleanse",0.30415200042327
"9552",9882,76,38,38,3.77774755579733e-06,"elite",0.544497553550238
"9553",9883,41,2,39,3.65982645102969e-06,"think about",0.461545225469754
"9554",9885,58,17,41,3.66222560774634e-06,"sassy",0.463232927051824
"9555",9886,40,10,30,3.51605077177314e-06,"prehistoric",0.360405337582979
"9556",9887,49,6,43,3.64041442477812e-06,"bearing",0.447889715936488
"9557",9889,51,4,47,3.57724158901071e-06,"patterned",0.403450395183193
"9558",9890,57,20,37,3.54691684253463e-06,"tropics",0.382118265335879
"9559",9891,41,6,35,3.52452718467818e-06,"condensation",0.366368122494377
"9560",9892,54,11,43,3.67322950337937e-06,"puffy",0.470973685269052
"9561",9893,36,3,33,3.69118103028245e-06,"refuge",0.483601797532281
"9562",9894,38,3,35,3.48017345184484e-06,"graffiti",0.335167215711534
"9563",9895,42,3,39,3.51926799225761e-06,"exposure",0.362668511165524
"9564",9896,64,25,39,3.56386807985916e-06,"fast food",0.394042717728734
"9565",9897,28,2,26,3.42025337236983e-06,"convex",0.293016066423928
"9566",9898,32,3,29,3.50079993278464e-06,"grassy",0.34967704088181
"9567",9899,32,3,29,3.51895838831706e-06,"notorious",0.362450718364971
"9568",9900,32,4,28,3.48706647046106e-06,"barking",0.340016152149538
"9569",9901,36,6,30,3.46092614383609e-06,"khaki",0.3216275782416
"9570",9902,50,11,39,3.76024667218169e-06,"tricks",0.532186449085577
"9571",9903,54,14,40,3.62497462517762e-06,"cheers",0.437028493727956
"9572",9904,56,16,40,3.61104691472152e-06,"tales",0.427230959949404
"9573",9905,55,16,39,3.55265027710672e-06,"graveyard",0.386151485229719
"9574",9906,47,6,41,3.60382437843039e-06,"catalog",0.422150222271656
"9575",9907,32,4,28,3.53531782507247e-06,"clammy",0.373958864999293
"9576",9908,36,5,31,3.38414056366245e-06,"somehow",0.267612288519162
"9577",9910,46,5,41,3.64152798514257e-06,"surgical",0.44867305683947
"9578",9911,29,2,27,3.65894263875625e-06,"insipid",0.460923502277689
"9579",9912,34,4,30,3.47164361495306e-06,"seep",0.329166849367325
"9580",9914,47,10,37,3.46801965673541e-06,"raincoat",0.326617553619013
"9581",9916,36,4,32,3.46041116605475e-06,"mite",0.321265313946705
"9582",9917,37,5,32,3.48564437364713e-06,"gleaming",0.339015769379181
"9583",9918,54,17,37,3.68412327076464e-06,"depressing",0.478636973091498
"9584",9919,25,3,22,3.49592899069034e-06,"pup",0.346250546638361
"9585",9920,50,3,47,3.64578965981137e-06,"pollute",0.451670958156585
"9586",9921,51,11,40,3.64464692482916e-06,"go away",0.450867094188892
"9587",9922,48,13,35,3.60422703746954e-06,"Tumblr",0.422433475254965
"9588",9923,52,5,47,3.62713093942691e-06,"antiseptic",0.438545366279346
"9589",9924,36,7,29,3.41742476539379e-06,"admiral",0.29102626540952
"9590",9926,40,9,31,3.59585469870334e-06,"react",0.416543901938093
"9591",9927,60,18,42,3.60812839164069e-06,"flashy",0.425177906896786
"9592",9928,32,2,30,3.58121295682848e-06,"hijack",0.406244078356333
"9593",9929,44,7,37,3.51985019517569e-06,"projectile",0.363078065397275
"9594",9930,53,6,47,3.71863332787934e-06,"embroidery",0.502913285508139
"9595",9931,39,7,32,3.48547428591346e-06,"frying",0.338896120114409
"9596",9933,39,4,35,3.55160301602128e-06,"speckled",0.385414782963263
"9597",9934,38,4,34,3.35652693445039e-06,"spongy",0.248187310824068
"9598",9935,105,66,39,3.79942096824444e-06,"dogs",0.559743849143201
"9599",9936,43,7,36,3.56454136828485e-06,"Swedish",0.394516346622315
"9600",9937,33,5,28,3.48900092458525e-06,"beta",0.341376955828254
"9601",9938,41,2,39,3.63484361085364e-06,"superstar",0.443970892539703
"9602",9939,57,19,38,3.60782898890593e-06,"chores",0.424967290197332
"9603",9940,75,25,50,3.78380832740537e-06,"oppression",0.548761040699899
"9604",9941,57,12,45,3.63490967249464e-06,"customs",0.444017364008302
"9605",9942,38,12,26,3.54353588184434e-06,"intriguing",0.379739907696163
"9606",9943,32,3,29,3.57841926907208e-06,"unproductive",0.40427884148224
"9607",9944,38,4,34,3.643252696007e-06,"grubby",0.449886315329135
"9608",9945,47,4,43,3.54060006089832e-06,"nutty",0.377674686353643
"9609",9946,60,13,47,3.69603784742756e-06,"realistic",0.487018355493147
"9610",9947,30,5,25,3.45444621772684e-06,"wherever",0.317069234274154
"9611",9948,48,8,40,3.63484361085364e-06,"Chinese food",0.443970892539703
"9612",9949,34,4,30,3.43210944310592e-06,"platoon",0.301356292470691
"9613",9950,50,11,39,3.58895033969415e-06,"parachute",0.411686988030748
"9614",9951,61,32,29,3.6139571023292e-06,"apples",0.429278149362052
"9615",9953,51,8,43,3.69029562958289e-06,"fresh air",0.482978956952067
"9616",9954,35,8,27,3.59588055923134e-06,"slack",0.416562093685939
"9617",9955,76,35,41,3.71515187540867e-06,"thoughtless",0.500464236306024
"9618",9956,39,5,34,3.54430200288506e-06,"surveillance",0.380278840265058
"9619",9957,46,4,42,3.64793089359715e-06,"meatloaf",0.45317722226296
"9620",9958,48,16,32,3.65262112091637e-06,"on time",0.456476591583849
"9621",9959,34,2,32,3.4367804240987e-06,"moaning",0.304642122844605
"9622",9960,38,6,32,3.5307243634104e-06,"thorny",0.370727566076436
"9623",9961,53,10,43,3.59545390807863e-06,"discriminate",0.416261963302443
"9624",9962,50,10,40,3.66103233789864e-06,"funky",0.462393514021477
"9625",9963,42,3,39,3.63259894291371e-06,"shrivel",0.442391867039966
"9626",9964,33,6,27,3.35611013411016e-06,"radiant",0.247894110055347
"9627",9965,41,7,34,3.50471384011495e-06,"sociable",0.352430303120834
"9628",9966,47,15,32,3.58699356134656e-06,"lithe",0.410310480239457
"9629",9967,57,18,39,3.69070422327284e-06,"part of",0.483266384702068
"9630",9968,62,29,33,3.68609237347488e-06,"redo",0.480022150531667
"9631",9969,50,19,31,3.63625785431697e-06,"throw away",0.444965750822165
"9632",9970,53,3,50,3.72334087930418e-06,"flowery",0.506224841577928
"9633",9972,35,6,29,3.52609308885755e-06,"impartial",0.367469667442465
"9634",9973,48,11,37,3.68830843110424e-06,"yo",0.481581049932063
"9635",9974,41,5,36,3.70798849040373e-06,"rapist",0.495425108965184
"9636",9975,50,11,39,3.38202319391506e-06,"regardless",0.26612281171771
"9637",9976,39,4,35,3.60871432334802e-06,"quarterback",0.42559008416832
"9638",9977,54,18,36,3.65343514239263e-06,"delightful",0.457049220009412
"9639",9978,53,17,36,3.59230241438645e-06,"reasoning",0.414045025637113
"9640",9979,92,47,45,3.76813887852651e-06,"exotic",0.537738270290812
"9641",9980,31,6,25,3.33238915640568e-06,"jumbo",0.23120744205975
"9642",9981,49,18,31,3.58327898693536e-06,"unfriendly",0.407697439971188
"9643",9982,33,3,30,3.56374107282861e-06,"beagle",0.393953373850156
"9644",9983,46,8,38,3.48087606688851e-06,"provoke",0.335661474595319
"9645",9984,42,10,32,3.53974782836471e-06,"limber",0.377075178124234
"9646",9985,34,4,30,3.33038039604884e-06,"ferry",0.229794367203602
"9647",9989,32,10,22,3.60156596087979e-06,"hourglass",0.420561524523537
"9648",9991,42,2,40,3.59191531700449e-06,"doorstep",0.413772719597484
"9649",9992,45,5,40,3.62763093933876e-06,"womanly",0.438897094299611
"9650",9993,39,11,28,3.61602186970027e-06,"iPad",0.430730622697614
"9651",9994,51,14,37,3.53273253328717e-06,"somewhere",0.372140225555737
"9652",9995,59,12,47,3.70864856846165e-06,"disturbed",0.495889444944123
"9653",9996,49,11,38,3.54731946804397e-06,"stealthy",0.382401494732438
"9654",9997,44,6,38,3.66840549086934e-06,"arouse",0.467580203930956
"9655",9999,49,4,45,3.70275744346815e-06,"tingly",0.491745296751253
"9656",10000,39,6,33,3.680367447886e-06,"blowjob",0.475994916334523
"9657",10001,63,30,33,3.69419457322817e-06,"wanting",0.485721692894615
"9658",10003,40,5,35,3.50884580026246e-06,"stinging",0.355336955958313
"9659",10004,55,20,35,3.66257435025931e-06,"well done",0.463478252122417
"9660",10005,46,8,38,3.41021085333706e-06,"occult",0.285951594502623
"9661",10006,35,7,28,3.72431156100795e-06,"peat",0.506907673606267
"9662",10007,46,5,41,3.60926136466172e-06,"grudge",0.425974903752713
"9663",10008,46,6,40,3.71607686333384e-06,"bookstore",0.501114924764132
"9664",10009,42,16,26,3.44916788824696e-06,"mucus",0.313356160862958
"9665",10011,50,14,36,3.72050107708506e-06,"plump",0.504227165200757
"9666",10012,41,7,34,3.45390930724941e-06,"sizzle",0.316691541288992
"9667",10013,31,4,27,3.17200515133637e-06,"turquoise",0.118384324996966
"9668",10014,44,15,29,3.53164708956963e-06,"visa",0.371376663481352
"9669",10015,24,5,19,3.27762463987099e-06,"holster",0.19268300530429
"9670",10016,37,4,33,3.54195445046577e-06,"fleshy",0.378627440044078
"9671",10017,32,9,23,3.42554911552322e-06,"chopsticks",0.296741389591107
"9672",10019,27,2,25,3.51999887360036e-06,"weightless",0.363182654151644
"9673",10020,35,4,31,3.65218089982433e-06,"catwalk",0.456166915342885
"9674",10021,59,18,41,3.71918653952008e-06,"impulsive",0.503302445647123
"9675",10022,57,17,40,3.62530316597725e-06,"invade",0.437259607778765
"9676",10023,30,5,25,3.28900846261877e-06,"legume",0.200691025592472
"9677",10024,35,4,31,3.51169217911035e-06,"stole",0.357339258705531
"9678",10025,37,7,30,3.42843820925815e-06,"repent",0.298773740388939
"9679",10026,64,32,32,3.6266442298277e-06,"options",0.438202987411428
"9680",10027,46,10,36,3.58956871331909e-06,"Michael Jackson",0.412121986769217
"9681",10028,68,27,41,3.5537739302252e-06,"spices",0.386941925942741
"9682",10029,46,11,35,3.53430573865223e-06,"goggles",0.373246906567903
"9683",10031,40,8,32,3.49684584504777e-06,"minty",0.346895513488096
"9684",10032,30,4,26,3.29893642289726e-06,"bail",0.207674910451875
"9685",10033,49,11,38,3.40946672530949e-06,"cripple",0.285428133054409
"9686",10034,27,3,24,3.30978969596272e-06,"grub",0.215309712295423
"9687",10035,38,6,32,3.40342111890873e-06,"bong",0.281175313963288
"9688",10036,79,36,43,3.71459986330272e-06,"sweaty",0.500075919987187
"9689",10037,42,8,34,3.61551199265328e-06,"buzzing",0.430371946545743
"9690",10038,38,10,28,3.5445155710569e-06,"fiery",0.380429076112094
"9691",10040,42,8,34,3.69401716979181e-06,"fucking",0.485596897353689
"9692",10041,38,5,33,3.59252180660737e-06,"soapy",0.414199358447371
"9693",10042,28,3,25,3.31696961655831e-06,"pesto",0.220360471699442
"9694",10043,41,8,33,3.53718107891097e-06,"dementia",0.375269582398124
"9695",10044,44,3,41,3.53816977553851e-06,"modesty",0.375965087135644
"9696",10045,46,7,39,3.73735372931842e-06,"planting",0.516082267303493
"9697",10046,43,12,31,3.55994773996718e-06,"runway",0.391284930464552
"9698",10047,26,5,21,3.39245247174087e-06,"stamen",0.273459351496179
"9699",10048,40,5,35,3.52749861545679e-06,"mosaic",0.368458393793158
"9700",10049,33,11,22,3.38778635264146e-06,"jittery",0.270176941251127
"9701",10050,40,10,30,3.42227834758712e-06,"agitated",0.294440547723617
"9702",10051,43,5,38,3.64333233748916e-06,"tyranny",0.44994233962072
"9703",10052,53,13,40,3.62523745305317e-06,"adventurer",0.43721338161723
"9704",10053,25,2,23,3.26614865548991e-06,"rapidly",0.184610153347024
"9705",10054,35,5,30,3.62263713492874e-06,"Steve",0.435384171802782
"9706",10055,43,6,37,3.45956118925875e-06,"ineffective",0.320667392529829
"9707",10056,37,4,33,3.48547428591346e-06,"berate",0.338896120114409
"9708",10057,50,14,36,3.5902646384065e-06,"David",0.412611539562022
"9709",10058,43,8,35,3.58343307222051e-06,"guild",0.407805832214892
"9710",10059,39,7,32,3.50073865585639e-06,"pyramids",0.349633935248883
"9711",10060,48,12,36,3.62230907714432e-06,"antiques",0.435153397531996
"9712",10061,40,6,34,3.51903268829464e-06,"tentative",0.362502985142229
"9713",10062,53,12,41,3.64363766209633e-06,"carry on",0.450157122097825
"9714",10063,43,6,37,3.61530285392007e-06,"cliche",0.43022482661462
"9715",10064,49,10,39,3.56942714263788e-06,"remembrance",0.3979532747096
"9716",10065,38,4,34,3.62287337332986e-06,"tumbling",0.435550355162351
"9717",10066,28,5,23,3.35255464664074e-06,"hypodermic",0.245392980476968
"9718",10067,37,3,34,3.59039354303625e-06,"exoskeleton",0.412702218318463
"9719",10068,49,5,44,3.60234440573926e-06,"crushed",0.421109126358697
"9720",10069,47,10,37,3.58239325363702e-06,"confined",0.407074365422315
"9721",10070,26,3,23,3.58762413179496e-06,"prodigal",0.410754058908576
"9722",10071,49,12,37,3.56398239392697e-06,"buying",0.394123132664436
"9723",10072,23,6,17,3.46970427710446e-06,"hex",0.327802610202563
"9724",10073,41,7,34,3.39354615392447e-06,"sanitary",0.274228708970298
"9725",10074,52,20,32,3.60047670311549e-06,"biased",0.419795279434446
"9726",10075,57,21,36,3.66954970955514e-06,"films",0.468385111619088
"9727",10076,37,2,35,3.62851285400679e-06,"lobotomy",0.439517482609452
"9728",10077,38,10,28,3.62229595606879e-06,"wordy",0.435144167430534
"9729",10078,35,6,29,3.45905858261616e-06,"whoever",0.320313830788744
"9730",10079,47,8,39,3.64131582588684e-06,"zap",0.448523812103163
"9731",10080,40,6,34,3.55174177416605e-06,"laxative",0.385512393235584
"9732",10081,68,16,52,3.66278899405163e-06,"magazines",0.46362924462131
"9733",10083,68,36,32,3.55189315905378e-06,"John",0.385618885868075
"9734",10084,51,16,35,3.63908964533432e-06,"balloons",0.44695779167007
"9735",10085,40,5,35,3.59461383063617e-06,"trainee",0.415671005646843
"9736",10086,37,4,33,3.47235484688651e-06,"laid",0.329667169855342
"9737",10087,36,3,33,3.34441449335465e-06,"tattered",0.239666739467406
"9738",10088,42,2,40,3.60422703746954e-06,"registered",0.422433475254965
"9739",10089,44,12,32,3.59079320621925e-06,"overload",0.412983363848293
"9740",10090,30,7,23,3.42430572201486e-06,"stinger",0.29586671676268
"9741",10092,56,19,37,3.56585056233463e-06,"swords",0.39543730724724
"9742",10093,35,13,22,3.61577345009871e-06,"Forrest",0.430555870397501
"9743",10094,46,11,35,3.58776571889856e-06,"first aid",0.410853659229422
"9744",10095,61,15,46,3.77913238678664e-06,"bodies",0.545471721446541
"9745",10096,44,9,35,3.54980014625177e-06,"hillbilly",0.384146543109999
"9746",10097,38,4,34,3.59368374145602e-06,"forgetting",0.415016728679471
"9747",10098,42,5,37,3.65888908809507e-06,"chatting",0.460885831734966
"9748",10099,34,3,31,3.4676949538103e-06,"casting",0.326389139344693
"9749",10100,43,4,39,3.62254527275955e-06,"admirable",0.435319550793571
"9750",10101,45,3,42,3.59127034005739e-06,"light up",0.413319006588049
"9751",10102,41,4,37,3.48559577545792e-06,"misbehave",0.338981582683392
"9752",10103,23,3,20,3.23622500825237e-06,"wiener",0.163560179231673
"9753",10104,50,6,44,3.68881183370836e-06,"common sense",0.481935171597186
"9754",10105,32,3,29,3.50701227103594e-06,"saga",0.354047148521013
"9755",10106,44,2,42,3.74118483323669e-06,"ultra",0.518777280971866
"9756",10107,26,6,20,3.56008715093346e-06,"Plato",0.391382999968187
"9757",10108,36,3,33,3.67802563583868e-06,"patsy",0.474347554213599
"9758",10109,24,2,22,3.4965034965035e-06,"guinea",0.346654686294201
"9759",10110,28,4,24,3.58653042633087e-06,"indignant",0.409984685057649
"9760",10111,43,9,34,3.57821439945039e-06,"ping",0.404134724683928
"9761",10112,41,5,36,3.6839468332793e-06,"wondrous",0.478512857054778
"9762",10113,26,4,22,3.60288951739295e-06,"bale",0.421492588511861
"9763",10114,34,2,32,3.39473273269196e-06,"dormant",0.275063415119024
"9764",10115,37,5,32,3.47051106745979e-06,"boating",0.328370151851528
"9765",10116,42,6,36,3.58746968588115e-06,"mania",0.410645412978418
"9766",10117,44,7,37,3.39024423319456e-06,"hurray",0.271905952477958
"9767",10118,53,16,37,3.57173472011887e-06,"spoken",0.399576554313801
"9768",10119,35,7,28,3.55483510897347e-06,"inflamed",0.38768841867491
"9769",10120,42,14,28,3.54528211582437e-06,"steadfast",0.380968306754177
"9770",10121,35,2,33,3.46392323946101e-06,"outsmart",0.323735903634727
"9771",10122,36,4,32,3.66235973162228e-06,"Heather",0.463327277319168
"9772",10123,44,10,34,3.51341950580241e-06,"zealot",0.358554357315272
"9773",10124,54,9,45,3.62065656986238e-06,"ordered",0.433990931097537
"9774",10125,45,6,39,3.66103233789864e-06,"clowns",0.462393514021477
"9775",10126,45,14,31,3.50840262428516e-06,"uninformed",0.355025201085097
"9776",10127,31,11,20,3.40043525571273e-06,"wrapping",0.279074890091532
"9777",10128,64,20,44,3.40590174654642e-06,"Jews",0.282920326766997
"9778",10129,38,6,32,3.50057934588174e-06,"carry out",0.349521867665145
"9779",10130,35,3,32,3.5916701984757e-06,"dystopia",0.413600289457358
"9780",10131,40,5,35,3.62056480811007e-06,"kick out",0.433926380727201
"9781",10132,50,20,30,3.69607882996929e-06,"procrastination",0.487047184914764
"9782",10133,43,3,40,3.51812891831608e-06,"loudly",0.361867222579468
"9783",10134,75,34,41,3.6094437486239e-06,"learned",0.426103202875223
"9784",10135,41,7,34,3.77923236232257e-06,"sheltered",0.545542049853592
"9785",10136,37,10,27,3.69242130527093e-06,"overworked",0.484474276618678
"9786",10137,44,8,36,3.65344849002974e-06,"cringe",0.457058609487016
"9787",10138,45,17,28,3.61606109696829e-06,"uninterested",0.430758217361126
"9788",10139,34,6,28,3.44983423546499e-06,"Antarctic",0.313824906921215
"9789",10140,47,8,39,3.6241863701599e-06,"levels",0.436473990876492
"9790",10141,53,6,47,3.55678225023386e-06,"flags",0.389058147197799
"9791",10142,50,14,36,3.66119318285829e-06,"notable",0.462506661399884
"9792",10143,39,5,34,3.52980211929319e-06,"derogatory",0.37007880776696
"9793",10144,38,5,33,3.58039233939255e-06,"caustic",0.405666809962284
"9794",10145,33,6,27,3.46236410220899e-06,"heedless",0.322639118923395
"9795",10146,35,5,30,3.28814328413175e-06,"Poland",0.20008241045233
"9796",10147,27,2,25,3.33092396499865e-06,"photocopier",0.230176744132212
"9797",10148,44,2,42,3.5400986979517e-06,"appraisal",0.37732199949816
"9798",10150,33,2,31,3.53037534950716e-06,"linguistic",0.370482050094687
"9799",10151,38,3,35,3.5762565177275e-06,"keep up",0.402757440716488
"9800",10152,36,2,34,3.61767014807124e-06,"wretched",0.431890114278584
"9801",10153,35,4,31,3.33845229351673e-06,"inhabitant",0.235472593237083
"9802",10154,55,8,47,3.69206685594663e-06,"mistrust",0.484224937056473
"9803",10155,50,9,41,3.53124801367299e-06,"egotistical",0.371095931081732
"9804",10156,29,6,23,3.4692468611989e-06,"basin",0.327480838164029
"9805",10157,32,9,23,3.48458766874116e-06,"snip",0.338272423798952
"9806",10158,39,6,33,3.6130822482043e-06,"herbal",0.428662727834802
"9807",10159,38,4,34,3.59907719660679e-06,"intended",0.418810787953559
"9808",10160,48,16,32,3.45863985529051e-06,"chunky",0.320019274470248
"9809",10161,47,2,45,3.70841476394086e-06,"Americans",0.495724973712669
"9810",10162,53,13,40,3.76972982346355e-06,"roots",0.538857430314252
"9811",10164,36,2,34,3.46218429206987e-06,"blaster",0.32251263037258
"9812",10165,35,8,27,3.49012121190969e-06,"lethal",0.342165028852713
"9813",10166,47,3,44,3.69415363246127e-06,"depressive",0.485692892859754
"9814",10167,42,2,40,3.59589348963484e-06,"spoils",0.416571189657987
"9815",10168,38,7,31,3.58566879894438e-06,"craving",0.409378567961068
"9816",10169,36,6,30,3.5446286469798e-06,"shorter",0.380508620067118
"9817",10170,44,3,41,3.77082437762544e-06,"clean up",0.539627401186874
"9818",10171,43,11,32,3.46008788623231e-06,"blushing",0.321037900762732
"9819",10173,59,15,44,3.55188054315357e-06,"cakes",0.385610011135306
"9820",10174,52,7,45,3.63336445915553e-06,"cultured",0.442930374159349
"9821",10175,42,5,37,3.57783033212999e-06,"bratty",0.403864550159789
"9822",10176,58,23,35,3.62914493716136e-06,"held",0.439962125401049
"9823",10177,36,4,32,3.50295824824064e-06,"tear down",0.351195321194396
"9824",10178,68,24,44,3.59101241412992e-06,"doors",0.413137567004368
"9825",10179,59,13,46,3.72665715126874e-06,"scorn",0.508557693534753
"9826",10180,41,5,36,3.62784150686025e-06,"glob",0.439045219320661
"9827",10181,29,5,24,3.31870888949363e-06,"rook",0.221583973967644
"9828",10183,33,3,30,3.57107146428214e-06,"odometer",0.399109982906777
"9829",10184,31,3,28,3.4541001896301e-06,"bemuse",0.316825818676394
"9830",10185,38,7,31,3.39270568278202e-06,"extraterrestrial",0.273637474364009
"9831",10187,38,7,31,3.59478181471776e-06,"deflate",0.41578917508458
"9832",10188,26,2,24,3.42138846786803e-06,"pertinent",0.293814556349504
"9833",10189,29,4,25,3.27484460862332e-06,"perplexed",0.190727375185447
"9834",10190,47,13,34,3.61474091344503e-06,"knickers",0.429829526123335
"9835",10191,38,5,33,3.64499232729115e-06,"sweetness",0.451110069680036
"9836",10192,47,18,29,3.49711488022382e-06,"credit card",0.34708476794117
"9837",10194,37,4,33,3.39520529108793e-06,"sadden",0.275395839235784
"9838",10195,43,14,29,3.59925855273814e-06,"Mozart",0.418938364042135
"9839",10196,40,4,36,3.62538202463085e-06,"inter",0.437315081384763
"9840",10197,54,15,39,3.60061930652072e-06,"pagan",0.419895594678943
"9841",10199,48,11,37,3.71170448893541e-06,"snobbish",0.498039151039791
"9842",10200,40,4,36,3.43893145521823e-06,"discovered",0.306155278945798
"9843",10201,53,18,35,3.66387601443567e-06,"Ford",0.464393915811465
"9844",10202,32,8,24,3.62768357892751e-06,"treadmill",0.438934123942822
"9845",10203,38,3,35,3.56812805297957e-06,"megaphone",0.397039422081145
"9846",10204,43,6,37,3.48829502604012e-06,"gunk",0.340880387145134
"9847",10205,42,8,34,3.6680421824851e-06,"rundown",0.467324632408427
"9848",10206,39,9,30,3.42735716489015e-06,"maim",0.298013273064106
"9849",10208,47,6,41,3.5405499182133e-06,"informed",0.377639413172755
"9850",10210,44,11,33,3.51722561243691e-06,"milky",0.361231786490281
"9851",10211,37,2,35,3.49993000139997e-06,"flavoring",0.34906508228652
"9852",10212,40,11,29,3.5304999894085e-06,"insignificant",0.370569728801635
"9853",10213,43,6,37,3.52864376576863e-06,"pry",0.369263956839364
"9854",10214,51,12,39,3.67979864141834e-06,"shameful",0.475594785918409
"9855",10215,51,10,41,3.70576246062627e-06,"apes",0.493859194595742
"9856",10216,39,9,30,3.49043794524899e-06,"unfocused",0.342387836872765
"9857",10217,30,8,22,3.55878218473638e-06,"par",0.390465013452315
"9858",10218,54,7,47,3.68276649419044e-06,"kept",0.477682540246444
"9859",10219,47,7,40,3.71288966777063e-06,"seduction",0.498872872397535
"9860",10220,41,5,36,3.51282708811224e-06,"smoked",0.358137617439127
"9861",10221,29,5,24,3.42188018628716e-06,"wriggle",0.294160458702667
"9862",10222,42,11,31,3.53348150399107e-06,"dolls",0.372667093614466
"9863",10223,29,3,26,3.5703957069562e-06,"wane",0.398634617250098
"9864",10224,41,5,36,3.58642752367939e-06,"reactive",0.409912297553114
"9865",10225,40,6,34,3.59629437827263e-06,"wiring",0.416853197241543
"9866",10226,35,3,32,3.69449483324898e-06,"girdle",0.48593291265722
"9867",10227,25,3,22,3.49748181309457e-06,"white flag",0.347342889131084
"9868",10228,46,4,42,3.60803726380886e-06,"computing",0.425113802461724
"9869",10229,56,19,37,3.64147494301092e-06,"blocked",0.44863574402498
"9870",10230,45,2,43,3.64120975552918e-06,"stifle",0.448449196256186
"9871",10231,39,6,33,3.34362053919225e-06,"foretell",0.239108227517488
"9872",10232,33,7,26,3.33976795292263e-06,"q",0.236398101956627
"9873",10233,43,4,39,3.65266114627812e-06,"snaps",0.456504747671312
"9874",10234,43,7,36,3.62065656986238e-06,"gruel",0.433990931097537
"9875",10235,39,7,32,3.39755851445152e-06,"encompass",0.277051228717487
"9876",10236,51,10,41,3.65339510006649e-06,"inequality",0.457021051988244
"9877",10237,43,6,37,3.69929195551971e-06,"slutty",0.489307477890717
"9878",10238,41,8,33,3.47499739375195e-06,"Beyoncé",0.331526085737974
"9879",10239,52,10,42,3.73252710747812e-06,"biting",0.512686950415935
"9880",10240,41,9,32,3.56558356123355e-06,"violate",0.395249483676738
"9881",10241,38,6,32,3.45073897575166e-06,"wistful",0.3144613520532
"9882",10242,40,3,37,3.65902296768717e-06,"hot tub",0.460980010159334
"9883",10243,39,6,33,3.57089293748795e-06,"token",0.398984397132862
"9884",10244,33,3,30,3.52050695300123e-06,"bounce back",0.363540065738273
"9885",10245,57,15,42,3.76019011521222e-06,"addictive",0.532146663736754
"9886",10246,44,3,41,3.56825537290053e-06,"theorize",0.397128986064417
"9887",10247,50,12,38,3.54418894780119e-06,"ropes",0.38019931096937
"9888",10248,36,3,33,3.70992813869195e-06,"childless",0.496789566510615
"9889",10249,27,2,25,3.5358803458091e-06,"disassociate",0.374354573679164
"9890",10250,27,8,19,3.36179654407315e-06,"crucial",0.251894250198027
"9891",10251,51,17,34,3.63578191125783e-06,"granny",0.44463094574324
"9892",10252,39,6,33,3.42134164491264e-06,"mucous",0.29378161845289
"9893",10253,27,4,23,3.55122463981704e-06,"sharpie",0.385148611889867
"9894",10254,52,18,34,3.48531636216619e-06,"angles",0.338785027680867
"9895",10255,61,15,46,3.63182055900982e-06,"accepted",0.441844308084382
"9896",10256,38,8,30,3.49301048601748e-06,"listless",0.34419750653494
"9897",10257,45,9,36,3.53987313094699e-06,"ruling",0.377163322998174
"9898",10258,40,8,32,3.58906626851958e-06,"shuffle",0.411768538877648
"9899",10259,45,14,31,3.68493781667434e-06,"bananas",0.479209970432996
"9900",10260,46,10,36,3.56351248298423e-06,"sawdust",0.393792570914967
"9901",10261,43,16,27,3.42679341233234e-06,"bleeding",0.297616697852029
"9902",10262,29,5,24,3.30362275271062e-06,"tot",0.210971538048246
"9903",10263,46,5,41,3.57139030653243e-06,"frenzied",0.399334274453263
"9904",10264,37,5,32,3.54449044405376e-06,"exemplary",0.380411400366838
"9905",10265,45,7,38,3.49252250930757e-06,"beefy",0.343854236310194
"9906",10266,29,8,21,3.49225418022825e-06,"unfamiliar",0.343665478565217
"9907",10267,42,7,35,3.63407747126353e-06,"horrified",0.443431946922126
"9908",10268,36,2,34,3.68654080816348e-06,"fishing pole",0.480337604677763
"9909",10269,57,17,40,3.47666462702342e-06,"handyman",0.332698911260545
"9910",10270,57,12,45,3.60548755205423e-06,"lookout",0.423320192010077
"9911",10271,31,6,25,3.42982576485115e-06,"idiocy",0.299749824924498
"9912",10272,65,14,51,3.65070093457944e-06,"dictatorship",0.455125824668032
"9913",10273,48,4,44,3.64870288612398e-06,"bigoted",0.453720285164953
"9914",10274,40,4,36,3.49489047013267e-06,"lightweight",0.345519992950043
"9915",10275,53,18,35,3.53400597247009e-06,"lions",0.373036034199155
"9916",10276,40,8,32,3.52087881135131e-06,"scissor",0.36380165178698
"9917",10277,37,3,34,3.36923818155477e-06,"arthritis",0.257129115958888
"9918",10278,33,5,28,3.55114897425062e-06,"torque",0.385095384480723
"9919",10279,59,19,40,3.64684001312862e-06,"distasteful",0.452409835672576
"9920",10280,37,6,31,3.56782252223645e-06,"agnostic",0.39682449459644
"9921",10281,36,5,31,3.61046022536493e-06,"pleasurable",0.426818249704831
"9922",10283,38,4,34,3.67263592425556e-06,"man-made",0.470556128375251
"9923",10284,57,20,37,3.52622986081971e-06,"records",0.367565880522386
"9924",10285,36,8,28,3.39383408223939e-06,"arrested",0.274431253918381
"9925",10286,54,14,40,3.65626702449333e-06,"takeover",0.459041324930455
"9926",10287,37,10,27,3.398332098606e-06,"frank",0.277595411259768
"9927",10288,58,19,39,3.66509800472065e-06,"irritation",0.465253532410463
"9928",10289,54,14,40,3.57403250939971e-06,"Moses",0.401192948348266
"9929",10290,39,10,29,3.46906633548647e-06,"stubble",0.327353846238754
"9930",10291,40,4,36,3.48727319646948e-06,"opposing",0.340161574834539
"9931",10292,42,8,34,3.61798427624034e-06,"embellish",0.432111089675597
"9932",10293,41,9,32,3.5925089004408e-06,"slop",0.41419027952494
"9933",10294,54,17,37,3.62568434792067e-06,"shells",0.43752775256668
"9934",10296,31,2,29,3.55368552726032e-06,"not me",0.386879738332131
"9935",10297,35,2,33,3.5792646042944e-06,"towering",0.404873497755501
"9936",10298,30,3,27,3.31717867319487e-06,"petrified",0.220507533879174
"9937",10299,40,2,38,3.56012517400112e-06,"decreasing",0.391409747529531
"9938",10300,48,11,37,3.53565531603455e-06,"paintings",0.374196275097049
"9939",10301,34,2,32,3.60224059364925e-06,"ding dong",0.421036099104027
"9940",10302,39,4,35,3.65611997923324e-06,"skies",0.458937885035772
"9941",10303,46,4,42,3.4992196740127e-06,"smoothly",0.348565398107085
"9942",10304,29,7,22,3.45361109576173e-06,"sultry",0.316481762579639
"9943",10305,43,4,39,3.75121914622252e-06,"disrespectful",0.525835980298874
"9944",10306,34,3,31,3.5824702565407e-06,"sixth",0.407128533589591
"9945",10307,41,6,35,3.49655239933426e-06,"glazed",0.346689087291963
"9946",10308,26,2,24,3.53776922423796e-06,"balsamic",0.375683316854054
"9947",10309,29,7,22,3.37893772955658e-06,"sustenance",0.263952322794206
"9948",10310,38,5,33,3.53328174741982e-06,"racetrack",0.372526573623012
"9949",10311,44,6,38,3.59727758032721e-06,"highly",0.417544836787845
"9950",10312,37,3,34,3.45984845863751e-06,"negligent",0.320869473945205
"9951",10313,51,7,44,3.71217295756244e-06,"roadkill",0.498368698183378
"9952",10314,30,3,27,3.49661352979639e-06,"tenet",0.346732089892395
"9953",10315,50,12,38,3.70908875107564e-06,"Madonna",0.496199094117461
"9954",10316,30,9,21,3.41717952836088e-06,"see through",0.290853751906942
"9955",10317,37,5,32,3.55374867178643e-06,"Roger",0.386924157738283
"9956",10318,58,13,45,3.70477397173998e-06,"leaning",0.493163835995083
"9957",10319,36,7,29,3.54661493337684e-06,"termination",0.381905885477696
"9958",10320,40,6,34,3.68269868159387e-06,"hazardous",0.477634837057356
"9959",10321,36,5,31,3.46006394198165e-06,"airless",0.321021057031997
"9960",10322,41,10,31,3.58377981256832e-06,"branches",0.408049748850057
"9961",10323,51,18,33,3.61739533066611e-06,"Alaska",0.431696792280816
"9962",10324,36,7,29,3.47638664372251e-06,"amass",0.332503362193879
"9963",10325,39,8,31,3.59501443398295e-06,"humiliation",0.415952812540677
"9964",10326,30,3,27,3.40079374526014e-06,"Tony",0.27932707177359
"9965",10327,40,10,30,3.57307473800429e-06,"worldwide",0.400519198155925
"9966",10328,38,5,33,3.65653440981706e-06,"Iceland",0.459229418784746
"9967",10329,43,13,30,3.49413335010517e-06,"inadequate",0.344987392199391
"9968",10330,34,3,31,3.62110233597312e-06,"nativity",0.434304508016088
"9969",10331,30,2,28,3.46739435716242e-06,"readiness",0.326177682779695
"9970",10332,36,4,32,3.49749404551639e-06,"demo",0.347351494103617
"9971",10333,33,8,25,3.31815828942304e-06,"scowl",0.221196650953779
"9972",10334,64,21,43,3.63452654839917e-06,"gods",0.443747853001555
"9973",10335,36,4,32,3.5029337069796e-06,"cardigan",0.351178057493028
"9974",10336,42,11,31,3.62230907714432e-06,"unacceptable",0.435153397531996
"9975",10337,25,2,23,3.55939020527003e-06,"unappealing",0.39089272924489
"9976",10338,47,11,36,3.49257130084311e-06,"rising",0.343888559016645
"9977",10339,43,9,34,3.64319960361988e-06,"smartphone",0.449848967162131
"9978",10340,45,2,43,3.60331793515469e-06,"incompetence",0.421793961627365
"9979",10341,49,8,41,3.69487705296606e-06,"flexibility",0.486201787473421
"9980",10342,27,2,25,3.26037696478467e-06,"sons",0.180550021940493
"9981",10343,46,9,37,3.4369221674606e-06,"blankets",0.304741833086313
"9982",10344,42,6,36,3.50277419716415e-06,"eyeshadow",0.351065849330049
"9983",10345,25,4,21,3.28996068496981e-06,"sprinkler",0.201360872275343
"9984",10346,48,6,42,3.77458196504737e-06,"windmill",0.542270699222705
"9985",10347,35,5,30,3.52399310706948e-06,"bender",0.365992422308188
"9986",10348,39,3,36,3.48004022926505e-06,"dismal",0.335073499466522
"9987",10349,39,5,34,3.55272600666491e-06,"remote control",0.386204757654269
"9988",10350,24,4,20,3.51985019517569e-06,"deluge",0.363078065397275
"9989",10351,40,13,27,3.6063977496078e-06,"performer",0.423960476090108
"9990",10352,30,2,28,3.5239185974804e-06,"duckling",0.365940008078428
"9991",10353,36,8,28,3.43236860892965e-06,"bountiful",0.301538604267036
"9992",10354,36,8,28,3.31690360414746e-06,"hulk",0.220314034862088
"9993",10355,41,7,34,3.60199406391378e-06,"pretzel",0.420862676241865
"9994",10356,43,8,35,3.64237686944993e-06,"bash",0.449270209738482
"9995",10357,28,5,23,3.47816408586891e-06,"overcast",0.333753714828913
"9996",10358,39,3,36,3.60090454722226e-06,"positivity",0.420096249008824
"9997",10359,44,6,38,3.57056143508005e-06,"inward",0.398751199720461
"9998",10360,42,4,38,3.55417811408201e-06,"gains",0.387226251568427
"9999",10361,50,14,36,3.63196565613276e-06,"Dutch",0.441946377549971
"10000",10362,58,13,45,3.63240101707228e-06,"New England",0.442252634886691
"10001",10363,37,5,32,3.47879327618836e-06,"finishing",0.334196322637805
"10002",10364,49,8,41,3.74332751869792e-06,"emotionless",0.520284566268285
"10003",10365,34,5,29,3.42834417832875e-06,"bramble",0.298707593751991
"10004",10366,39,4,35,3.6621719609466e-06,"frivolous",0.463195188879837
"10005",10367,42,3,39,3.65918363613078e-06,"poised",0.461093033366443
"10006",10368,40,5,35,3.51262965994232e-06,"physique",0.35799873537594
"10007",10369,63,26,37,3.62513231732958e-06,"workers",0.437139423244354
"10008",10370,39,5,34,3.6159041930025e-06,"beater",0.430647842299146
"10009",10371,47,8,39,3.54966153977218e-06,"scattered",0.384049039527488
"10010",10372,44,7,37,3.65550519081737e-06,"clipboard",0.45850540833473
"10011",10373,36,7,29,3.55336983828614e-06,"stingray",0.386657664977158
"10012",10374,38,4,34,3.31264037313581e-06,"clerical",0.217315038726005
"10013",10375,38,8,30,3.60475972474055e-06,"goof",0.422808197399535
"10014",10377,32,5,27,3.47497324270603e-06,"guinea pig",0.331509096535839
"10015",10378,40,5,35,3.74149278078968e-06,"brilliance",0.518993908576381
"10016",10379,57,15,42,3.66593103650534e-06,"take over",0.465839533754681
"10017",10380,45,8,37,3.59594521217875e-06,"crevasse",0.416607574200347
"10018",10381,44,3,41,3.65332836480676e-06,"go down",0.45697410665839
"10019",10382,44,8,36,3.51021296462056e-06,"grilled",0.356298696153986
"10020",10383,48,5,43,3.57634604724353e-06,"puzzling",0.402820420806447
"10021",10384,59,20,39,3.66231949342797e-06,"selling",0.46329897151333
"10022",10385,44,10,34,3.68318698803701e-06,"willpower",0.477978339234975
"10023",10387,45,4,41,3.54803687119917e-06,"measuring",0.382906156404433
"10024",10388,41,13,28,3.39109498457052e-06,"runny",0.272504418777884
"10025",10389,34,4,30,3.31079783606253e-06,"muddled",0.216018894663378
"10026",10390,39,6,33,3.53500539088322e-06,"leotard",0.373739081242844
"10027",10391,30,9,21,3.40670234619591e-06,"dunce",0.283483513525775
"10028",10392,64,20,44,3.60501962933188e-06,"products",0.422991028886506
"10029",10393,41,8,33,3.47212577428405e-06,"goosebumps",0.329506027321006
"10030",10394,36,3,33,3.69306221332605e-06,"ageless",0.484925127340964
"10031",10395,43,8,35,3.53000148260062e-06,"spectacles",0.370219051114559
"10032",10396,40,3,37,3.54019895918151e-06,"do not",0.377392528878334
"10033",10397,37,4,33,3.53374371877054e-06,"employed",0.372851550217525
"10034",10398,26,2,24,3.55608659782083e-06,"adrenal",0.388568786219463
"10035",10399,46,6,40,3.6822918584527e-06,"creating",0.477348654810814
"10036",10400,39,8,31,3.55993506678438e-06,"inconsiderate",0.39127601543599
"10037",10401,41,8,33,3.49917069654492e-06,"wounded",0.348530944605453
"10038",10402,30,2,28,3.55803511069047e-06,"rang",0.389939479609337
"10039",10403,48,3,45,3.66409081082666e-06,"clinging",0.464545015656828
"10040",10404,42,7,35,3.4524545225428e-06,"realist",0.315668164019021
"10041",10405,41,4,37,3.56319504573361e-06,"eagerness",0.393569267724158
"10042",10406,44,8,36,3.60456482088917e-06,"elitist",0.422671091083789
"10043",10407,33,4,29,3.62115478626134e-06,"drudgery",0.43434140449467
"10044",10408,24,3,21,3.59727758032721e-06,"Pikachu",0.417544836787845
"10045",10409,42,6,36,3.60690505904504e-06,"candy bar",0.424317346041068
"10046",10410,43,2,41,3.59519538089297e-06,"plastic surgery",0.416080100759991
"10047",10411,37,8,29,3.51538331739693e-06,"pliable",0.359935812687468
"10048",10412,36,6,30,3.52059371292375e-06,"revolting",0.363601097540603
"10049",10413,41,3,38,3.54384982581978e-06,"treacherous",0.379960753521014
"10050",10414,34,4,30,3.56518948982138e-06,"nightie",0.394972271712574
"10051",10415,36,13,23,3.39396078617708e-06,"washing machine",0.274520384584423
"10052",10416,29,3,26,3.48626411936968e-06,"spearmint",0.339451733328168
"10053",10417,37,7,30,3.48165169556438e-06,"smallest",0.336207095368762
"10054",10418,37,7,30,3.55657985055251e-06,"jackass",0.388915767894252
"10055",10419,44,4,40,3.65708267201088e-06,"lining",0.459615097204784
"10056",10420,35,3,32,3.48302200921608e-06,"scenario",0.337171050954432
"10057",10421,46,4,42,3.72694882153878e-06,"mobility",0.508762870784232
"10058",10422,36,5,31,3.50697537401892e-06,"insulin",0.354021193086941
"10059",10423,45,2,43,3.49591676921356e-06,"sanitation",0.346241949365178
"10060",10424,51,16,35,3.57539981908477e-06,"pointed",0.402154790775086
"10061",10425,46,10,36,3.54692942319834e-06,"whiny",0.382127115281321
"10062",10426,38,3,35,3.63703814161899e-06,"springtime",0.445514648734902
"10063",10427,41,3,38,3.76660602430968e-06,"rudeness",0.536659974542611
"10064",10428,33,4,29,3.53393103886971e-06,"derby",0.37298332169603
"10065",10429,40,5,35,3.55239786856128e-06,"limitless",0.38597392688244
"10066",10430,91,56,35,3.65714954450202e-06,"Harry Potter",0.459662139070916
"10067",10431,51,11,40,3.62823638685708e-06,"chewing gum",0.439323000088691
"10068",10432,39,13,26,3.34985930590915e-06,"lesser",0.243496926423743
"10069",10433,29,3,26,3.43997248022016e-06,"Yankee",0.306887594400862
"10070",10434,82,29,53,3.698662563617e-06,"knights",0.488864728276827
"10071",10435,56,7,49,3.72309135721572e-06,"filler",0.506049313726608
"10072",10436,48,10,38,3.52198245348342e-06,"stock market",0.364578015648276
"10073",10437,38,4,34,3.56061954780132e-06,"trunks",0.391757517826878
"10074",10438,26,5,21,3.00371559619249e-06,"wholly",0
"10075",10440,43,3,40,3.61492385162907e-06,"tourism",0.429958215116629
"10076",10441,35,7,28,3.47795843839666e-06,"relinquish",0.33360905084683
"10077",10442,27,2,25,3.45079851477632e-06,"rubbers",0.31450323514713
"10078",10443,36,2,34,3.57529755413894e-06,"indication",0.402082851868526
"10079",10444,41,5,36,3.49712711007907e-06,"uphill",0.347093371108241
"10080",10445,39,8,31,3.64535108376288e-06,"tremor",0.451362439131647
"10081",10446,46,9,37,3.56903222122289e-06,"ohm",0.397675464805712
"10082",10447,53,16,37,3.62502718770391e-06,"knives",0.437065469161095
"10083",10448,48,20,28,3.613500036135e-06,"flames",0.428956623330133
"10084",10449,43,9,34,3.63229546544234e-06,"hurting",0.442178383941928
"10085",10450,43,8,35,3.65977287449541e-06,"grouchy",0.461507536726436
"10086",10451,40,10,30,3.54865381817408e-06,"Olympic",0.38334015155714
"10087",10452,33,4,29,3.34098418712184e-06,"disparage",0.237253669401611
"10088",10453,37,6,31,3.46338337922316e-06,"inquisition",0.32335613562241
"10089",10454,34,5,29,3.57232165184153e-06,"traffic light",0.399989435052285
"10090",10455,39,4,35,3.55412758607208e-06,"mindset",0.387190707328363
"10091",10457,49,3,46,3.72173343456448e-06,"steward",0.505094074666597
"10092",10458,42,8,34,3.51446906915772e-06,"make believe",0.359292679127661
"10093",10459,40,3,37,3.54954814252146e-06,"pivot",0.383969269532421
"10094",10460,50,5,45,3.66386259049741e-06,"dress up",0.46438447265934
"10095",10461,40,11,29,3.62701253858235e-06,"anthropology",0.438462076475346
"10096",10462,37,5,32,3.59328343460404e-06,"gumption",0.414735130356731
"10097",10463,27,2,25,3.44126280579922e-06,"armed forces",0.307795281883739
"10098",10464,38,9,29,3.55352136199367e-06,"potter",0.386764255263296
"10099",10465,39,5,34,3.55852890415102e-06,"irritant",0.390286841663181
"10100",10466,39,3,36,3.58054617651377e-06,"cipher",0.405775027633541
"10101",10467,43,7,36,3.69554612780677e-06,"scandalous",0.486672452294666
"10102",10468,48,10,38,3.61663652802893e-06,"natives",0.431163007888011
"10103",10469,37,4,33,3.56956729705225e-06,"composure",0.398051867196381
"10104",10471,46,18,28,3.67595703541417e-06,"frilly",0.472892384492965
"10105",10473,47,3,44,3.54313411471251e-06,"evasive",0.37945728213056
"10106",10474,48,5,43,3.7014554122681e-06,"homophobic",0.490829374877131
"10107",10475,35,4,31,3.46023155869591e-06,"saver",0.321138968042927
"10108",10477,34,6,28,3.52575742083793e-06,"jiggly",0.367233539704821
"10109",10478,72,28,44,3.67753869690094e-06,"changing",0.474005014016078
"10110",10480,41,4,37,3.37467307854552e-06,"skewed",0.260952327750776
"10111",10481,25,4,21,3.48603320795234e-06,"Donald",0.33928929726817
"10112",10482,39,4,35,3.56731342058982e-06,"alchemy",0.396466363904728
"10113",10483,30,5,25,3.33423357639896e-06,"cremation",0.232504910674058
"10114",10484,41,6,35,3.69704901547585e-06,"sullen",0.487729667890122
"10115",10486,38,4,34,3.63331165457379e-06,"sliding",0.442893228450807
"10116",10487,29,2,27,3.45999211121799e-06,"Abel",0.320970527238495
"10117",10488,38,9,29,3.43724113277719e-06,"genealogy",0.30496621120455
"10118",10489,55,19,36,3.60046373972968e-06,"genetic",0.419786160260782
"10119",10490,52,11,41,3.72769904049027e-06,"vaccination",0.509290616930424
"10120",10491,39,5,34,3.49589232651634e-06,"authoritarian",0.346224754999144
"10121",10492,37,8,29,3.59632024512519e-06,"chrome",0.416871393438434
"10122",10493,41,14,27,3.71198004439528e-06,"nighttime",0.498232992226716
"10123",10494,39,14,25,3.27578864611655e-06,"lenses",0.191391464179636
"10124",10495,33,5,28,3.55297846184456e-06,"kingly",0.386382348806669
"10125",10496,33,3,30,3.48040358760002e-06,"embargo",0.335329106127199
"10126",10497,47,7,40,3.49285187863038e-06,"decode",0.344085933190742
"10127",10498,40,10,30,3.53849529026277e-06,"lab coat",0.376194072475079
"10128",10499,36,7,29,3.66313784387707e-06,"muddle",0.463874645181517
"10129",10500,48,12,36,3.55199408948184e-06,"loads",0.385689885999885
"10130",10501,48,15,33,3.67996113961037e-06,"Mac",0.475709096273318
"10131",10502,38,2,36,3.6313325901206e-06,"downgrade",0.441501043361144
"10132",10503,36,9,27,3.29678299914943e-06,"shrubs",0.206160071241556
"10133",10504,41,6,35,3.56597771977121e-06,"suction",0.395526756929867
"10134",10505,33,6,27,3.55707324013801e-06,"tenacious",0.389262845839702
"10135",10506,39,6,33,3.63987114856134e-06,"interrogation",0.447507544932739
"10136",10507,33,2,31,3.57116073437349e-06,"province",0.399172780502849
"10137",10508,52,6,46,3.67127411568185e-06,"Neanderthal",0.469598155739124
"10138",10509,49,9,40,3.54070035052933e-06,"involuntary",0.377745235712821
"10139",10510,42,8,34,3.60083971582173e-06,"likeness",0.420050642960463
"10140",10511,48,13,35,3.47701519107937e-06,"degrees",0.332945517706776
"10141",10512,45,4,41,3.57038295927621e-06,"first class",0.398625649816025
"10142",10513,34,7,27,3.44285040470707e-06,"obstruct",0.308912088122314
"10143",10514,31,3,28,3.45633269275967e-06,"vex",0.318396286765291
"10144",10515,40,5,35,3.58807467501014e-06,"introspective",0.411070996310691
"10145",10516,46,2,44,3.67451174925132e-06,"dropping",0.471875689032154
"10146",10517,47,9,38,3.43377113915358e-06,"farms",0.302525222799037
"10147",10518,36,2,34,3.36881821856893e-06,"political party",0.25683369040761
"10148",10519,36,5,31,3.69483609707073e-06,"brainstorm",0.486172976796377
"10149",10520,41,4,37,3.52134994471481e-06,"victorious",0.364133073455859
"10150",10521,54,17,37,3.62578951566704e-06,"lightening",0.437601733466174
"10151",10522,32,7,25,3.56304269594063e-06,"show up",0.393462096323115
"10152",10523,36,7,29,3.43778469154477e-06,"earning",0.305348580970406
"10153",10524,38,10,28,3.44308748540992e-06,"pillage",0.309078864004233
"10154",10525,31,3,28,3.60659285173297e-06,"farce",0.424097721882773
"10155",10526,40,4,36,3.62443594715572e-06,"circumstances",0.436649557352738
"10156",10527,44,5,39,3.63479076326971e-06,"repairman",0.443933716581005
"10157",10528,32,6,26,3.50048131618097e-06,"busybody",0.349452908067829
"10158",10529,40,8,32,3.5810205908684e-06,"abide",0.406108757335863
"10159",10530,53,14,39,3.63358889575233e-06,"meaningless",0.443088255466921
"10160",10531,33,2,31,3.39635842449725e-06,"speedometer",0.276207018041136
"10161",10532,39,5,34,3.53475548328944e-06,"coding",0.37356328220543
"10162",10533,55,21,34,3.59316723318937e-06,"atoms",0.41465338775525
"10163",10534,30,2,28,3.56361407485015e-06,"mumps",0.393864036339319
"10164",10535,33,5,28,3.6700480042279e-06,"forfeit",0.468735640078404
"10165",10536,39,8,31,3.58563022829708e-06,"ominous",0.409351435201452
"10166",10537,32,7,25,3.43940457028079e-06,"refusal",0.306488094653101
"10167",10538,33,5,28,3.58241892090377e-06,"sombrero",0.407092421219336
"10168",10539,44,10,34,3.45966890968534e-06,"goop",0.320743169127962
"10169",10540,37,2,35,3.5477725310164e-06,"ruffle",0.382720204673327
"10170",10541,43,11,32,3.55888350706616e-06,"dole",0.390536289269807
"10171",10542,50,10,40,3.61202515414317e-06,"powers",0.427919108500985
"10172",10543,37,3,34,3.38839474798814e-06,"pubic hair",0.270604920708241
"10173",10544,49,8,41,3.56933795919533e-06,"beaten",0.397890538067162
"10174",10545,39,5,34,3.61154248979739e-06,"watched",0.427579575291532
"10175",10546,40,4,36,3.60372048102461e-06,"foolishness",0.422077135001078
"10176",10548,44,13,31,3.67916232832109e-06,"San Francisco",0.475147167547556
"10177",10550,41,12,29,3.53007624964699e-06,"YouTube",0.370271646454233
"10178",10551,41,7,34,3.56042938778417e-06,"psyche",0.39162374859056
"10179",10552,37,8,29,3.55893417039465e-06,"glimmer",0.390571928700548
"10180",10553,47,12,35,3.62133837423635e-06,"resistant",0.434470550587431
"10181",10554,31,2,29,3.3729543032151e-06,"psychoanalysis",0.259743244649102
"10182",10555,34,3,31,3.46797154876141e-06,"throbbing",0.326583711768138
"10183",10556,60,17,43,3.76060019179061e-06,"parties",0.532435134633761
"10184",10557,35,7,28,3.385240352065e-06,"tiredness",0.268385941450643
"10185",10558,49,10,39,3.57391754972213e-06,"argumentative",0.401112079254398
"10186",10559,48,5,43,3.73077253106801e-06,"sewing machine",0.511452682824052
"10187",10560,47,11,36,3.64337215953598e-06,"holly",0.44997035268504
"10188",10561,48,7,41,3.4723427896802e-06,"tradesman",0.329658688139231
"10189",10562,45,3,42,3.62768357892751e-06,"violinist",0.438934123942822
"10190",10563,34,3,31,3.65716291929373e-06,"fifteen",0.45967154765059
"10191",10564,46,2,44,3.68021845776765e-06,"fascinate",0.475890108317315
"10192",10565,46,6,40,3.69018668654447e-06,"carrying",0.48290232030011
"10193",10566,34,4,30,3.3747755774241e-06,"chaps",0.261024431218778
"10194",10567,42,7,35,3.57626930738392e-06,"Space Shuttle",0.402766437679139
"10195",10569,45,5,40,3.52291302632321e-06,"infected",0.365232632848998
"10196",10570,31,6,25,3.43399517867077e-06,"decimate",0.302682824778512
"10197",10572,39,3,36,3.65714954450202e-06,"seasonal",0.459662139070916
"10198",10573,41,8,33,3.54582266631681e-06,"mentality",0.381348560330343
"10199",10574,51,10,41,3.64858307276369e-06,"materials",0.45363600171806
"10200",10575,31,8,23,3.26602064778254e-06,"Kung fu",0.184520105536163
"10201",10577,39,8,31,3.52416697503128e-06,"oblivious",0.366114730797732
"10202",10578,74,32,42,3.5650623885918e-06,"BBQ",0.3948828615691
"10203",10579,50,15,35,3.61124252021393e-06,"coup",0.427368559838865
"10204",10580,41,4,37,3.55103548194654e-06,"intervention",0.385015547619785
"10205",10581,35,12,23,3.3901867653889e-06,"wishing",0.271865526395807
"10206",10582,45,9,36,3.61612647763968e-06,"heads",0.430804209797457
"10207",10583,38,6,32,3.46682937652541e-06,"viewing",0.325780243667728
"10208",10585,40,5,35,3.64834346964761e-06,"resourceful",0.453467451429002
"10209",10586,49,11,38,3.55863021205877e-06,"disloyal",0.390358107335407
"10210",10587,42,2,40,3.64016264246687e-06,"taps",0.447712598117512
"10211",10588,39,4,35,3.5917734021996e-06,"splint",0.413672888753146
"10212",10589,31,3,28,3.52981457884017e-06,"emulate",0.370087572512091
"10213",10590,26,3,23,3.33989065198005e-06,"lactose",0.236484415364957
"10214",10591,45,9,36,3.61353920870718e-06,"logs",0.428984179517517
"10215",10592,33,4,29,3.46650489643817e-06,"hone",0.325551986150083
"10216",10593,36,3,33,3.54964893971986e-06,"duster",0.384040175943009
"10217",10594,50,13,37,3.58880865907753e-06,"variation",0.41158732192759
"10218",10595,38,7,31,3.53275749386183e-06,"lethargy",0.372157784225853
"10219",10596,40,3,37,3.60098234798453e-06,"hellfire",0.420150978434649
"10220",10597,55,15,40,3.507098367095e-06,"controller",0.354107713324506
"10221",10599,46,11,35,3.55725038774029e-06,"sneezing",0.389387461412561
"10222",10600,45,9,36,3.69765051286413e-06,"tactics",0.488152794935873
"10223",10602,42,5,37,3.67371530175897e-06,"controversial",0.471315423133917
"10224",10603,52,5,47,3.8145226506355e-06,"marking",0.570367220716415
"10225",10604,56,18,38,3.58525742148286e-06,"turning",0.409089181949803
"10226",10605,58,14,44,3.72438091478244e-06,"mental health",0.506956460946469
"10227",10606,39,7,32,3.72474159605177e-06,"unhappiness",0.507210184408823
"10228",10607,40,15,25,3.59044510747997e-06,"convenient",0.412738491644272
"10229",10608,47,6,41,3.75121914622252e-06,"swoop",0.525835980298874
"10230",10609,41,6,35,3.56893032020443e-06,"hemp",0.397603781906098
"10231",10610,36,7,29,3.58649183714458e-06,"Joseph",0.409957539256667
"10232",10611,33,9,24,3.28759197038537e-06,"ignition",0.199694585398834
"10233",10612,31,4,27,3.45001276504723e-06,"brine",0.313950494656402
"10234",10613,38,13,25,3.27641115028243e-06,"plethora",0.191829368572585
"10235",10614,38,3,35,3.57725438571388e-06,"godmother",0.403459397102919
"10236",10615,32,7,25,3.48846538919064e-06,"tarmac",0.34100023015358
"10237",10616,47,4,43,3.58529598410997e-06,"erosion",0.409116309067562
"10238",10617,42,5,37,3.45347989902025e-06,"salad dressing",0.316389471423074
"10239",10618,48,5,43,3.62784150686025e-06,"processing",0.439045219320661
"10240",10619,45,2,43,3.63395861647928e-06,"quota",0.443348337791453
"10241",10620,54,15,39,3.70026382881099e-06,"sucks",0.48999114814864
"10242",10621,34,3,31,3.43279278289645e-06,"equity",0.301836992058829
"10243",10622,33,4,29,3.56040403464985e-06,"estrogen",0.391605913771935
"10244",10623,66,34,32,3.7198782855825e-06,"rings",0.503789058679042
"10245",10624,51,10,41,3.6036815210419e-06,"limits",0.422049728361067
"10246",10625,45,3,42,3.66356728874039e-06,"chaser",0.464176740817963
"10247",10626,41,5,36,3.61786647178426e-06,"motherly",0.432028219404758
"10248",10627,42,11,31,3.61485851443774e-06,"eve",0.429912253266619
"10249",10628,48,12,36,3.48633704512017e-06,"hindrance",0.339503033396906
"10250",10629,32,7,25,3.55863021205877e-06,"cupid",0.390358107335407
"10251",10630,34,7,27,3.38284693632467e-06,"voluptuous",0.266702278393758
"10252",10631,40,4,36,3.67977155978157e-06,"raging",0.475575735174075
"10253",10632,49,3,46,3.6571227952121e-06,"crusader",0.459643322118018
"10254",10633,35,2,33,3.53940955569792e-06,"Lee",0.376837218131479
"10255",10634,40,10,30,3.44633878199495e-06,"dung",0.311366008629785
"10256",10635,41,7,34,3.54201717878332e-06,"dazed",0.378671566665751
"10257",10636,40,5,35,3.51332075564503e-06,"cowardly",0.358484890908309
"10258",10639,34,9,25,3.50229575486732e-06,"hermit",0.350729286146951
"10259",10641,53,20,33,3.56638468451761e-06,"plentiful",0.395813038789484
"10260",10643,40,8,32,3.49252250930757e-06,"conception",0.343854236310194
"10261",10645,35,3,32,3.44783596575609e-06,"come together",0.312419211776042
"10262",10646,43,6,37,3.61708130475357e-06,"breeding",0.431475888816809
"10263",10647,34,8,26,3.48083971777352e-06,"concealed",0.335635904586297
"10264",10648,37,7,30,3.46108186496935e-06,"harness",0.321737121232745
"10265",10650,50,14,36,3.65263446260615e-06,"agreeable",0.456485976877774
"10266",10651,45,10,35,3.58741820686488e-06,"businessman",0.410609199747076
"10267",10652,72,28,44,3.6727438334631e-06,"diamonds",0.470632037772512
"10268",10653,42,5,37,3.63347007292374e-06,"cuts",0.443004668815659
"10269",10654,31,3,28,3.42132993937403e-06,"downpour",0.2937733841196
"10270",10655,31,8,23,3.43043758661855e-06,"forthright",0.300180214718389
"10271",10656,39,4,35,3.53723112621902e-06,"infectious",0.375304788485488
"10272",10657,32,7,25,3.52478807211716e-06,"fag",0.366551645371589
"10273",10658,51,12,39,3.61184250921923e-06,"overdone",0.42779062580331
"10274",10659,40,3,37,3.51765864640495e-06,"crummy",0.361536406904564
"10275",10660,35,8,27,3.53850781125599e-06,"ejaculation",0.37620288044495
"10276",10661,56,14,42,3.61167292689974e-06,"restless",0.427671332075265
"10277",10662,46,16,30,3.46460730408512e-06,"Broadway",0.324217113111511
"10278",10663,55,20,35,3.39733920393548e-06,"undo",0.276896953383028
"10279",10664,35,10,25,3.64680011523888e-06,"hip hop",0.452381769256085
"10280",10665,33,4,29,3.49882789265596e-06,"thud",0.34828979709653
"10281",10666,18,2,16,3.36696935721188e-06,"haiku",0.25553309748858
"10282",10668,30,5,25,3.48040358760002e-06,"kimono",0.335329106127199
"10283",10669,35,4,31,3.49207125222183e-06,"cumin",0.343536796731428
"10284",10670,30,5,25,3.45537725808904e-06,"shut up",0.317724180356399
"10285",10671,38,7,31,3.63694554765126e-06,"fiesta",0.445449512937501
"10286",10672,29,3,26,3.4612376001163e-06,"reboot",0.321846674081902
"10287",10673,36,13,23,3.44302821217317e-06,"ringing",0.309037167880451
"10288",10674,53,17,36,3.71407560372299e-06,"zombies",0.499707126353993
"10289",10675,33,7,26,3.47824877130862e-06,"nothingness",0.333813287323523
"10290",10676,32,2,30,3.46482338062817e-06,"South Africa",0.324369113487739
"10291",10678,29,3,26,3.5185374143676e-06,"scour",0.362154581645103
"10292",10680,45,7,38,3.61262540325931e-06,"ghastly",0.428341357442003
"10293",10681,45,13,32,3.39609313445812e-06,"Xbox",0.27602039812771
"10294",10682,48,15,33,3.60550055164158e-06,"Joe",0.42332933664994
"10295",10683,65,21,44,3.68446262112671e-06,"jumping",0.478875691195641
"10296",10684,39,7,32,3.54681620043768e-06,"untouched",0.382047468032366
"10297",10685,38,5,33,3.51380221510092e-06,"purge",0.358823576530539
"10298",10686,53,15,38,3.4674304260085e-06,"earrings",0.326203055631818
"10299",10687,37,2,35,3.46319146946677e-06,"explicit",0.323221135521238
"10300",10688,25,5,20,3.45408825886319e-06,"sledge",0.316817425904863
"10301",10689,49,9,40,3.49047449510286e-06,"rabbits",0.342413548092787
"10302",10690,35,7,28,3.41506727682535e-06,"hasty",0.289367875543174
"10303",10691,49,10,39,3.66303049839193e-06,"emptiness",0.463799132338261
"10304",10692,37,3,34,3.58052053607553e-06,"fallout",0.405756990709206
"10305",10693,31,5,26,3.65461010792064e-06,"hangman",0.45787575675323
"10306",10694,32,5,27,3.52452718467818e-06,"hideous",0.366368122494377
"10307",10695,48,9,39,3.47409195921416e-06,"despicable",0.330889152230758
"10308",10696,46,6,40,3.66640146362746e-06,"dignified",0.466170458613714
"10309",10697,40,2,38,3.55186792734299e-06,"robbers",0.38560113646558
"10310",10698,24,4,20,3.41189797060309e-06,"auburn",0.287138407543743
"10311",10699,45,7,38,3.71783146326411e-06,"unprepared",0.502349208901413
"10312",10700,48,20,28,3.58455058697016e-06,"Middle Ages",0.408591954854518
"10313",10701,38,3,35,3.60141031227829e-06,"greenhouse effect",0.420452032555305
"10314",10702,41,14,27,3.53585534108629e-06,"pensive",0.374336983952758
"10315",10703,47,11,36,3.64111694903529e-06,"ages",0.448383910955947
"10316",10704,38,5,33,3.53755646824512e-06,"Omega",0.375533652339343
"10317",10705,42,8,34,3.6450321856342e-06,"cooperative",0.451138108277162
"10318",10706,34,8,26,3.35099306679534e-06,"ditzy",0.244294477508272
"10319",10707,27,6,21,3.44157073288249e-06,"lark",0.308011895088702
"10320",10708,44,2,42,3.66774620663349e-06,"suck up",0.467116426371049
"10321",10709,44,5,39,3.44216305526393e-06,"extensive",0.308428567919333
"10322",10710,50,10,40,3.52944083068919e-06,"calming",0.369824657071292
"10323",10711,44,12,32,3.6036036036036e-06,"Judaism",0.421994916858773
"10324",10712,44,9,35,3.41733133761183e-06,"demean",0.29096054306036
"10325",10713,38,13,25,3.34659701282751e-06,"irate",0.241202046244859
"10326",10714,49,13,36,3.54422663202776e-06,"figures",0.38022582017086
"10327",10715,40,3,37,3.68696216439427e-06,"inexperience",0.48063401031579
"10328",10716,88,46,42,3.72592123402511e-06,"too much",0.508040008013117
"10329",10717,39,9,30,3.52990179813198e-06,"fumble",0.370148927460578
"10330",10718,37,5,32,3.6484765786046e-06,"rubric",0.453561087745359
"10331",10719,26,3,23,3.34611549452241e-06,"bronco",0.24086331922479
"10332",10720,40,10,30,3.50938761186173e-06,"squawk",0.355718096667848
"10333",10721,43,8,35,3.64175343144217e-06,"mistakes",0.448831648428704
"10334",10722,43,2,41,3.48586308226985e-06,"inclined",0.339169621308076
"10335",10724,37,6,31,3.59106399635148e-06,"peninsula",0.413173852836108
"10336",10725,33,7,26,3.35102675459761e-06,"praying",0.244318175400446
"10337",10726,32,3,29,3.37068047297388e-06,"liable",0.258143704748756
"10338",10727,57,16,41,3.72633775525414e-06,"showy",0.508333012439343
"10339",10728,31,7,24,3.38553833445056e-06,"as well",0.268595558996699
"10340",10729,53,15,38,3.57187505581055e-06,"perseverance",0.399675274321222
"10341",10730,40,7,33,3.50606549330342e-06,"attendant",0.353381131888603
"10342",10731,36,2,34,3.56301730557505e-06,"airship",0.393444235313933
"10343",10732,52,3,49,3.76809628239621e-06,"environmental",0.537708305780367
"10344",10733,44,6,38,3.53458056899678e-06,"prudish",0.373440237667987
"10345",10734,47,15,32,3.59800238907359e-06,"heels",0.418054707968611
"10346",10735,29,3,26,3.43622537514991e-06,"reschedule",0.30425167023994
"10347",10736,42,4,38,3.64767807052421e-06,"lapse",0.452999372313754
"10348",10737,51,17,34,3.70767228626196e-06,"PC",0.495202673212401
"10349",10738,30,3,27,3.54346054356685e-06,"lore",0.379686910520434
"10350",10739,28,2,26,3.60453883530141e-06,"arsenic",0.422652811361888
"10351",10740,34,4,30,3.55536593603897e-06,"choosy",0.388061832246449
"10352",10741,42,18,24,3.52139954503518e-06,"Caesar",0.364167965106989
"10353",10742,53,9,44,3.7453043247029e-06,"bonfire",0.521675162638628
"10354",10743,43,11,32,3.58050771599413e-06,"role model",0.40574797234391
"10355",10744,36,4,32,3.55488565710284e-06,"tumbler",0.387723977068122
"10356",10746,39,11,28,3.37211262856179e-06,"theirs",0.25915116342568
"10357",10747,38,3,35,3.55719977233921e-06,"impairment",0.389351855696651
"10358",10748,53,11,42,3.56461760564635e-06,"upward",0.394569976264235
"10359",10749,63,13,50,3.72694882153878e-06,"joining",0.508762870784232
"10360",10750,21,2,19,3.49691921417231e-06,"patella",0.346947125451047
"10361",10751,31,2,29,3.49007248880559e-06,"inbox",0.342130754284779
"10362",10752,31,3,28,3.5517039299604e-06,"scraper",0.385485771495825
"10363",10753,31,4,27,3.5390087236565e-06,"Yellowstone",0.376555250360993
"10364",10754,54,25,29,3.5589215044273e-06,"planes",0.390563018747734
"10365",10755,29,3,26,3.37480974510062e-06,"negation",0.261048466681453
"10366",10756,47,10,37,3.68806358221616e-06,"catholicism",0.481408809472354
"10367",10757,49,4,45,3.59657893411787e-06,"thickness",0.417053369805038
"10368",10758,37,8,29,3.6363239673749e-06,"boner",0.445012258460328
"10369",10759,40,5,35,3.54266968502124e-06,"headdress",0.379130576201231
"10370",10760,45,4,41,3.68609237347488e-06,"indulgent",0.480022150531667
"10371",10761,31,2,29,3.48161533024862e-06,"stimulant",0.33618151396322
"10372",10762,43,11,32,3.59652719334211e-06,"underhanded",0.417016972437371
"10373",10764,36,7,29,3.41037367464353e-06,"wreath",0.28606613215438
"10374",10765,33,5,28,3.532370644587e-06,"LA",0.371885652718713
"10375",10766,46,6,40,3.55415284989746e-06,"hay fever",0.387208479322066
"10376",10767,39,6,33,3.59761406235385e-06,"adornment",0.417781537143747
"10377",10768,33,8,25,3.49457292824244e-06,"defecate",0.345296616149857
"10378",10769,46,10,36,3.64370404378275e-06,"swarm",0.450203818704349
"10379",10770,37,11,26,3.55599807976104e-06,"undead",0.388506517644627
"10380",10771,68,21,47,3.61812826988342e-06,"bears",0.432212382891485
"10381",10772,54,27,27,3.59208304896009e-06,"Sherlock",0.413890711675648
"10382",10773,42,3,39,3.64212481561743e-06,"striking",0.449092900916211
"10383",10774,37,4,33,3.5203458387752e-06,"rebuke",0.363426728942773
"10384",10775,34,2,32,3.55194362355081e-06,"slipped",0.385654385429603
"10385",10776,53,26,27,3.56376647351052e-06,"disorganized",0.39397124211643
"10386",10777,50,24,26,3.64103740437726e-06,"unkempt",0.448327954775897
"10387",10779,32,4,28,3.46905430110698e-06,"whomever",0.327345380580314
"10388",10780,55,14,41,3.49158353788194e-06,"removed",0.343193711072485
"10389",10781,40,2,38,3.60186432497461e-06,"splat",0.420771410585319
"10390",10782,30,3,27,3.46969223829846e-06,"luster",0.327794141430268
"10391",10784,47,7,40,3.57400696216556e-06,"raising",0.401174976988921
"10392",10785,34,3,31,3.43292241252055e-06,"creak",0.301928180817013
"10393",10786,34,2,32,3.40971085651937e-06,"lament",0.285599868658955
"10394",10787,38,5,33,3.59815774323546e-06,"carnage",0.418163992811474
"10395",10788,36,7,29,3.47974959721898e-06,"chops",0.334869052562098
"10396",10789,38,5,33,3.45449395118109e-06,"artillery",0.317102812666805
"10397",10790,34,4,30,3.41128110661959e-06,"bamboozle",0.286704470771858
"10398",10791,39,6,33,3.64329251631284e-06,"pariah",0.449914327168758
"10399",10792,24,2,22,3.43763105968415e-06,"search engine",0.305240507690981
"10400",10793,39,4,35,3.63894397845745e-06,"principles",0.446855321407563
"10401",10794,45,8,37,3.62651270911379e-06,"takeaway",0.438110468354462
"10402",10795,48,15,33,3.55108592207497e-06,"nickname",0.385051030039074
"10403",10796,27,3,24,3.57993090733349e-06,"aqua",0.405342212735812
"10404",10798,30,6,24,3.40438280241984e-06,"antiquated",0.281851816157532
"10405",10799,44,8,36,3.61378732138856e-06,"Mediterranean",0.429158715912738
"10406",10800,43,10,33,3.57986682895396e-06,"run away",0.405297136404719
"10407",10801,47,8,39,3.62304400911558e-06,"movable",0.435670389957712
"10408",10803,38,8,30,3.34248058854398e-06,"distaste",0.238306322206671
"10409",10804,42,4,38,3.71501385700169e-06,"rebellious",0.500367146406811
"10410",10805,43,8,35,3.6110990741142e-06,"masses",0.427267651795726
"10411",10806,48,10,38,3.55857955738387e-06,"defeated",0.390322473992085
"10412",10807,52,10,42,3.66743682840063e-06,"goon",0.466898792345966
"10413",10808,35,4,31,3.56810259008567e-06,"miscommunication",0.397021510051466
"10414",10809,47,8,39,3.5897362261821e-06,"iPhone",0.412239824725341
"10415",10810,25,8,17,3.62496148478422e-06,"noir",0.437019250037214
"10416",10811,46,6,40,3.51785664030619e-06,"does",0.361675686934937
"10417",10813,35,4,31,3.68104482776391e-06,"fondle",0.476471423385391
"10418",10814,53,14,39,3.71947704152796e-06,"dodgy",0.503506801075387
"10419",10815,58,18,40,3.70834600351551e-06,"poisonous",0.495676603767581
"10420",10816,32,7,25,3.42375469482363e-06,"hobble",0.295479093288165
"10421",10817,43,6,37,3.66116637438355e-06,"fruitful",0.462487802813063
"10422",10818,50,7,43,3.59778232697365e-06,"obstruction",0.417899903927828
"10423",10820,38,6,32,3.61381344049495e-06,"popularity",0.429177089559138
"10424",10821,37,3,34,3.66406395990048e-06,"euphoria",0.464526127207289
"10425",10823,45,9,36,3.58622173608994e-06,"flyer",0.409767535004729
"10426",10824,52,15,37,3.55379918902303e-06,"put off",0.386959694399779
"10427",10825,43,4,39,3.47364545195601e-06,"differentiate",0.330575053947491
"10428",10826,41,3,38,3.5539886414523e-06,"psych",0.387092965879045
"10429",10827,37,2,35,3.68500571175885e-06,"spontaneity",0.479257731648738
"10430",10828,36,12,24,3.51595187365075e-06,"mount",0.36033576708912
"10431",10829,32,3,29,3.62035508442668e-06,"outdo",0.43377884930927
"10432",10830,50,9,41,3.75831056423517e-06,"youthful",0.530824482015338
"10433",10831,38,4,34,3.58744394618834e-06,"chilling",0.410627306232834
"10434",10832,42,11,31,3.46204045740479e-06,"loony",0.322411448990751
"10435",10833,48,12,36,3.63457938830029e-06,"weeds",0.44378502355573
"10436",10834,48,7,41,3.62078766614889e-06,"hits",0.434083151588437
"10437",10835,58,15,43,3.5573642776594e-06,"monks",0.389467577978236
"10438",10836,41,14,27,3.53853285350828e-06,"privileged",0.376220496571694
"10439",10837,44,9,35,3.46095010002146e-06,"illogical",0.321644430367876
"10440",10838,35,9,26,3.51354295130581e-06,"confetti",0.358641195815623
"10441",10839,45,12,33,3.44895375987694e-06,"pew",0.313205530941061
"10442",10841,38,4,34,3.39598933659348e-06,"deduct",0.275947380879964
"10443",10842,57,13,44,3.68779156602069e-06,"shaking",0.481217458002791
"10444",10844,41,5,36,3.50761503223498e-06,"infertile",0.354471164602239
"10445",10845,39,5,34,3.49512255647244e-06,"fringe",0.345683255516468
"10446",10846,41,8,33,3.4083976100316e-06,"crippled",0.284676057321546
"10447",10847,36,5,31,3.40035431691982e-06,"scythe",0.279017953198709
"10448",10848,43,12,31,3.5321335852922e-06,"android",0.37171889189642
"10449",10849,51,7,44,3.55384970769586e-06,"tropic",0.386995232071611
"10450",10851,41,5,36,3.672811279938e-06,"leper",0.470679483411058
"10451",10852,43,9,34,3.53088642903801e-06,"vampires",0.370841572141244
"10452",10853,48,10,38,3.46579605869672e-06,"stopping",0.325053349871192
"10453",10854,46,7,39,3.78942900883695e-06,"powerless",0.552714943701971
"10454",10855,34,4,30,3.55666839757862e-06,"whipping",0.38897805684562
"10455",10856,36,4,32,3.51728746790475e-06,"relent",0.361275299100446
"10456",10857,40,4,36,3.41411120443015e-06,"navigate",0.288695320523004
"10457",10858,39,4,35,3.56272534237791e-06,"analytical",0.393238852003075
"10458",10859,41,8,33,3.59482058250473e-06,"spiteful",0.415816446523311
"10459",10860,36,6,30,3.58380549970792e-06,"melee",0.408067818626761
"10460",10861,33,7,26,3.56512593807376e-06,"effervescent",0.394927565843941
"10461",10862,30,2,28,3.34856932375642e-06,"astonishment",0.242589480526236
"10462",10863,27,2,25,3.446790176648e-06,"variance",0.311683544981122
"10463",10864,47,6,41,3.53769413096544e-06,"vendor",0.375630492028577
"10464",10865,41,8,33,3.59762700522735e-06,"grocery store",0.417790641887901
"10465",10866,65,29,36,3.59533756624409e-06,"Beatles",0.416180121921746
"10466",10867,46,12,34,3.57014077065059e-06,"sludge",0.398455280734343
"10467",10868,32,2,30,3.63187332025859e-06,"isolate",0.441881423310079
"10468",10870,44,8,36,3.49868099726403e-06,"lavish",0.348186462627532
"10469",10871,39,3,36,3.53905882269669e-06,"criteria",0.376590492839652
"10470",10872,31,7,24,3.50580736990825e-06,"wavy",0.353199553395059
"10471",10873,51,9,42,3.53525533381648e-06,"tingle",0.373914905140036
"10472",10874,42,11,31,3.55054376577773e-06,"testosterone",0.384669646849625
"10473",10875,46,8,38,3.71726483653328e-06,"seedy",0.501950611834608
"10474",10876,42,5,37,3.6850464500105e-06,"parenting",0.479286389222993
"10475",10877,34,3,31,3.60137140222997e-06,"fixation",0.420424661041951
"10476",10878,34,9,25,3.42476309201311e-06,"pixie",0.296188456507433
"10477",10879,55,9,46,3.74646895301179e-06,"censor",0.522494427601933
"10478",10880,57,16,41,3.61832464332365e-06,"tables",0.432350522998567
"10479",10881,30,3,27,3.4749007915824e-06,"armada",0.331458130346292
"10480",10882,44,4,40,3.58752116637488e-06,"divider",0.410681627249085
"10481",10883,39,3,36,3.42125970782442e-06,"hysteria",0.293723979303078
"10482",10884,39,9,30,3.58363853988231e-06,"stout",0.407950369708205
"10483",10885,31,5,26,3.48014922879893e-06,"ovation",0.335150175860565
"10484",10886,41,8,33,3.4368512943182e-06,"upside down",0.304691976937391
"10485",10887,32,4,28,3.54177882299606e-06,"slipping",0.378503893817848
"10486",10888,40,3,37,3.69374427469637e-06,"wayward",0.48540492761653
"10487",10889,21,4,17,3.33806225486105e-06,"waddle",0.235198218140333
"10488",10890,31,3,28,3.66442648061152e-06,"Labrador",0.464781144636247
"10489",10891,47,10,37,3.64277492022323e-06,"gave",0.449550221008768
"10490",10892,32,7,25,3.5153709595205e-06,"metamorphosis",0.359927119463116
"10491",10893,38,11,27,3.45189439964653e-06,"Marx",0.315274142114725
"10492",10894,41,2,39,3.63467186182431e-06,"firecracker",0.443850074626265
"10493",10895,46,10,36,3.4069692963927e-06,"digging",0.283671301287341
"10494",10896,47,10,37,3.60490266762797e-06,"opinionated",0.422908751454874
"10495",10897,34,5,29,3.48754076063264e-06,"gazing",0.340349794494526
"10496",10898,25,4,21,3.59558318561479e-06,"amorphous",0.416352904382198
"10497",10899,54,18,36,3.66429220531762e-06,"pedophile",0.464686687853006
"10498",10900,36,6,30,3.57229612905991e-06,"drool",0.39997148089422
"10499",10901,33,7,26,3.47776491004761e-06,"fetus",0.333472912136673
"10500",10902,39,2,37,3.40239051957906e-06,"frying pan",0.28045033251164
"10501",10903,53,11,42,3.4795437622219e-06,"biscuits",0.334724256664515
"10502",10904,31,4,27,3.55030426107517e-06,"thrilled",0.384501165790171
"10503",10905,42,10,32,3.64262895817169e-06,"prissy",0.449447543103822
"10504",10906,30,6,24,3.51034850739981e-06,"surname",0.356394044557612
"10505",10907,31,4,27,3.62930299236032e-06,"nuance",0.440073310305099
"10506",10909,47,5,42,3.56419834050925e-06,"revered",0.394275041618956
"10507",10910,42,14,28,3.57850890690867e-06,"Adam",0.404341897770966
"10508",10911,51,14,37,3.57485021377604e-06,"newspapers",0.401768167532588
"10509",10912,35,6,29,3.61280812737316e-06,"cynic",0.428469895846306
"10510",10913,48,7,41,3.45685840707965e-06,"creeping",0.318766103744473
"10511",10914,47,5,42,3.64916890178262e-06,"wounds",0.454048106752802
"10512",10915,47,13,34,3.40375706705061e-06,"varied",0.281411638754668
"10513",10916,37,8,29,3.50983103673389e-06,"take off",0.356030026627689
"10514",10917,43,13,30,3.71067152022501e-06,"uppity",0.497312502832667
"10515",10918,44,8,36,3.44721792277542e-06,"finder",0.311984445631327
"10516",10919,33,4,29,3.3644432182918e-06,"morsel",0.253756069492719
"10517",10920,41,2,39,3.63290247110026e-06,"stimuli",0.442605385813914
"10518",10921,32,6,26,3.41043182887817e-06,"kayak",0.286107041109234
"10519",10922,28,4,24,3.53469301191192e-06,"affluent",0.3735193363298
"10520",10923,50,9,41,3.56826810539237e-06,"won",0.397137942814291
"10521",10924,31,4,27,3.5227144628565e-06,"illegitimate",0.365092952154286
"10522",10925,60,25,35,3.60279865399442e-06,"injured",0.421428670094035
"10523",10926,34,4,30,3.63546468509605e-06,"gory",0.444407791044172
"10524",10927,47,6,41,3.66903808828439e-06,"climate change",0.468025208482262
"10525",10928,31,4,27,3.35471404417487e-06,"cluck",0.24691202198409
"10526",10929,48,7,41,3.54888050564449e-06,"raised",0.383499616255635
"10527",10930,46,8,38,3.72086100723707e-06,"diseased",0.504480360285001
"10528",10931,37,4,33,3.5183764803569e-06,"ligament",0.362041371623195
"10529",10932,37,6,31,3.56713526933655e-06,"statistic",0.39634104230739
"10530",10933,48,8,40,3.40795621457856e-06,"black hole",0.284365554969096
"10531",10934,43,7,36,3.64062647900451e-06,"terminator",0.448038886789264
"10532",10935,48,10,38,3.42489211589835e-06,"agreed",0.29627921915488
"10533",10936,28,3,25,3.28853255811659e-06,"spinal",0.20035624763667
"10534",10938,52,11,41,3.66009435723253e-06,"manipulative",0.461733685739664
"10535",10940,31,2,29,3.49088878028346e-06,"light year",0.342704979556963
"10536",10941,32,3,29,3.54447788068579e-06,"kidnapper",0.380402562588186
"10537",10942,46,4,42,3.70056507628715e-06,"freely",0.490203062542799
"10538",10943,40,8,32,3.59610038873845e-06,"evergreen",0.416716734107867
"10539",10944,36,4,32,3.32156392515852e-06,"whose",0.223592366406149
"10540",10945,57,23,34,3.80476965924483e-06,"ugh",0.56350641879975
"10541",10946,34,5,29,3.51233355929346e-06,"dejected",0.357790441549166
"10542",10947,38,4,34,3.70614701543981e-06,"colonialism",0.494129712049934
"10543",10948,42,8,34,3.54293326530901e-06,"bubbling",0.379315993379523
"10544",10949,38,2,36,3.46187266539962e-06,"imprecise",0.322293414670354
"10545",10950,50,13,37,3.5935546004686e-06,"ironing",0.414925883655775
"10546",10951,37,10,27,3.43438436942986e-06,"Holland",0.302956603417183
"10547",10952,40,5,35,3.40580894774127e-06,"infestation",0.282855046875451
"10548",10953,43,3,40,3.58842231424532e-06,"abusive",0.411315545273724
"10549",10954,36,5,31,3.50013825546109e-06,"ruckus",0.349211579889609
"10550",10955,37,12,25,3.37220360016456e-06,"inquisitive",0.259215157960448
"10551",10956,38,3,35,3.56256034086577e-06,"wiser",0.393122780672204
"10552",10957,42,8,34,3.54674072261295e-06,"links",0.381994372691278
"10553",10958,36,9,27,3.42192702398429e-06,"jumble",0.294193406969446
"10554",10959,47,5,42,3.70668277838114e-06,"choking",0.494506597793759
"10555",10960,56,20,36,3.46735828906673e-06,"dinosaurs",0.326152310455433
"10556",10961,38,3,35,3.57264071738626e-06,"padded",0.40021388367662
"10557",10962,43,10,33,3.53046259651402e-06,"introverted",0.370543424539503
"10558",10963,29,3,26,3.33310001633219e-06,"skittish",0.231707500857189
"10559",10964,47,11,36,3.63254616058034e-06,"worthwhile",0.442354736982175
"10560",10965,46,9,37,3.63804375111415e-06,"thrust",0.446222050933412
"10561",10966,35,12,23,3.32762091742509e-06,"Hebrew",0.227853194954755
"10562",10967,54,15,39,3.71435151136963e-06,"dresses",0.499901215288872
"10563",10968,41,5,36,3.57283218407231e-06,"impish",0.400348572097236
"10564",10969,43,2,41,3.49254690490493e-06,"inclination",0.343871397543546
"10565",10970,48,16,32,3.59721287946099e-06,"viscous",0.417499322564654
"10566",10972,35,7,28,3.40629619789218e-06,"scheming",0.283197805997796
"10567",10973,42,9,33,3.54911981828507e-06,"unhelpful",0.383667962207901
"10568",10974,39,6,33,3.48630058186357e-06,"alteration",0.339477383094266
"10569",10976,48,8,40,3.65521123465725e-06,"mothers",0.458298623061783
"10570",10977,40,3,37,3.53872068169915e-06,"eaten",0.376352625470442
"10571",10978,35,4,31,3.41698102892133e-06,"biography",0.290714116252526
"10572",10979,35,5,30,3.5106196243637e-06,"thrilling",0.356584763457173
"10573",10980,49,8,41,3.64660063888443e-06,"blue collar",0.452241446384862
"10574",10981,37,6,31,3.52416697503128e-06,"Colorado",0.366114730797732
"10575",10982,39,7,32,3.63588766561468e-06,"liking",0.444705339297494
"10576",10983,35,9,26,3.4586159310767e-06,"millions",0.320002444834563
"10577",10984,47,9,38,3.60893572485474e-06,"covers",0.425745830423065
"10578",10985,48,7,41,3.66533981365412e-06,"valued",0.465423634395363
"10579",10986,34,8,26,3.35893964993131e-06,"Alps",0.249884550402453
"10580",10987,49,9,40,3.68116678262342e-06,"schizophrenia",0.47655721328311
"10581",10988,40,5,35,3.49512255647244e-06,"widget",0.345683255516468
"10582",10989,48,9,39,3.61168597112818e-06,"detour",0.427680508118175
"10583",10990,36,6,30,3.50685238956922e-06,"offended",0.353934678917651
"10584",10991,43,8,35,3.5565419031767e-06,"erratic",0.388889073578809
"10585",10993,49,4,45,3.65032779943639e-06,"methodical",0.45486334045144
"10586",10994,50,6,44,3.50992959081241e-06,"classification",0.356099355101764
"10587",10995,53,8,45,3.70588605882724e-06,"narcissistic",0.493946140512137
"10588",10996,61,24,37,3.62693360898029e-06,"experienced",0.438406552960212
"10589",10997,42,6,36,3.70947399658728e-06,"literary",0.496470097447499
"10590",10998,61,22,39,3.59143801177992e-06,"hats",0.413436956294884
"10591",10999,31,5,26,3.41370328773764e-06,"mosque",0.288408369011027
"10592",11000,43,8,35,3.52565797591976e-06,"proficient",0.367163584564097
"10593",11001,50,6,44,3.76612371716411e-06,"bowls",0.53632069260785
"10594",11002,49,6,43,3.67026352492109e-06,"allure",0.468887249438622
"10595",11003,43,13,30,3.4882463539105e-06,"had",0.340846148435508
"10596",11004,47,4,43,3.59461383063617e-06,"certified",0.415671005646843
"10597",11005,46,8,38,3.64714592595564e-06,"parlor",0.452625031936561
"10598",11006,41,5,36,3.50349824299563e-06,"descriptive",0.351575183833625
"10599",11007,32,4,28,3.61164683872552e-06,"anagram",0.42765298018829
"10600",11008,40,6,34,3.57684493661831e-06,"snag",0.403171367612567
"10601",11010,49,9,40,3.50771346190272e-06,"Boston",0.354540405558788
"10602",11011,48,9,39,3.45537725808904e-06,"cartoons",0.317724180356399
"10603",11012,29,4,25,3.50185423181575e-06,"icebox",0.35041869403453
"10604",11013,39,3,36,3.4893174546127e-06,"fatherly",0.341599620827338
"10605",11014,73,32,41,3.72589346925393e-06,"dying",0.508020476713669
"10606",11015,72,27,45,3.7397857102788e-06,"politicians",0.517793059302165
"10607",11016,54,12,42,3.65374216272306e-06,"sexist",0.457265195353495
"10608",11017,43,2,41,3.60694408875968e-06,"sadomasochism",0.424344801734436
"10609",11018,38,8,30,3.65290131687092e-06,"atop",0.456673697155366
"10610",11019,42,15,27,3.51043476734594e-06,"squirm",0.356454724648465
"10611",11021,50,9,41,3.61046022536493e-06,"palm tree",0.426818249704831
"10612",11022,41,9,32,3.5546582018406e-06,"classes",0.387563972261739
"10613",11023,34,9,25,3.43718206065939e-06,"deter",0.304924656559131
"10614",11024,35,5,30,3.64674691941054e-06,"purgatory",0.452344348322708
"10615",11026,43,3,40,3.66008096099086e-06,"concentrated",0.461724262070877
"10616",11027,39,3,36,3.6307129267903e-06,"corned beef",0.441065137371499
"10617",11028,53,3,50,3.59641078203952e-06,"editing",0.416935082188944
"10618",11029,40,7,33,3.71878544467377e-06,"fixer",0.503020293004915
"10619",11031,51,8,43,3.64892922171989e-06,"suppress",0.453879502335151
"10620",11032,24,4,20,3.50558615153247e-06,"beret",0.353043935964899
"10621",11033,33,6,27,3.53150989705649e-06,"Hades",0.371280154562247
"10622",11034,39,7,32,3.66994025337268e-06,"desired",0.468659842075063
"10623",11035,42,8,34,3.62577636936509e-06,"misunderstanding",0.437592485619029
"10624",11036,32,2,30,3.35732703051139e-06,"piety",0.248750143330421
"10625",11037,46,10,36,3.5503798906483e-06,"inconsistent",0.384554367879609
"10626",11038,50,20,30,3.63444729142816e-06,"boo",0.443692099196709
"10627",11039,35,5,30,3.59881814812016e-06,"contraband",0.418628558698717
"10628",11040,29,2,27,3.29503405417695e-06,"abdicate",0.204929765119189
"10629",11041,43,5,38,3.68153269569187e-06,"lacquer",0.476814617086804
"10630",11042,47,16,31,3.63465865103279e-06,"fairness",0.443840781413526
"10631",11043,36,2,34,3.64959507742616e-06,"solicit",0.454347902636436
"10632",11044,27,8,19,3.44375148511783e-06,"yank",0.309545958692029
"10633",11046,40,4,36,3.51476552999149e-06,"talker",0.359501226328728
"10634",11048,39,9,30,3.59568661433744e-06,"lemons",0.416425661954738
"10635",11049,34,9,25,3.51292581051981e-06,"easily",0.358207064325309
"10636",11050,37,6,31,3.45764727848583e-06,"extinguish",0.319321040198196
"10637",11051,64,17,47,3.61600879413339e-06,"apprentice",0.430721424609487
"10638",11052,34,7,27,3.31655158232676e-06,"bottles",0.22006640294226
"10639",11053,40,7,33,3.58606741089519e-06,"tripping",0.409658973995133
"10640",11054,41,4,37,3.71638069117248e-06,"sickening",0.501328654330188
"10641",11055,26,4,22,3.27430846605197e-06,"dioxide",0.190350222388547
"10642",11056,50,10,40,3.65799234748001e-06,"continuing",0.460255014021289
"10643",11057,30,3,27,3.34262583314949e-06,"kindle",0.238408495419784
"10644",11058,44,10,34,3.35919916691861e-06,"chickens",0.250067109226975
"10645",11059,35,3,32,3.63409067783059e-06,"go after",0.443441237163138
"10646",11060,27,6,21,3.3322559039244e-06,"teeny",0.231113704780346
"10647",11061,45,5,40,3.49174203009882e-06,"suspended",0.343305203399484
"10648",11062,42,9,33,3.51633513486903e-06,"glutton",0.360605374555756
"10649",11063,49,5,44,3.53325677943645e-06,"trimmer",0.37250900974119
"10650",11064,40,5,35,3.63506823023068e-06,"timeline",0.44412890242516
"10651",11065,42,11,31,3.569796664382e-06,"Savannah",0.398213217058439
"10652",11066,40,6,34,3.54167847226157e-06,"were",0.378433301475054
"10653",11067,33,2,31,3.44859693833564e-06,"motif",0.312954522628183
"10654",11068,46,12,34,3.53576782734139e-06,"banish",0.374275421869424
"10655",11069,46,7,39,3.52472595255719e-06,"mush",0.366507946984185
"10656",11070,35,5,30,3.55649130793524e-06,"homely",0.388853482044306
"10657",11071,27,2,25,3.38916416433379e-06,"aerosol",0.271146171379702
"10658",11072,46,11,35,3.48789352158657e-06,"hoarder",0.340597946362186
"10659",11073,39,19,20,3.44551944651176e-06,"ding",0.310789642033292
"10660",11074,56,19,37,3.60192919327592e-06,"highest",0.420817042591761
"10661",11075,47,9,38,3.50730747512442e-06,"ruins",0.354254811656861
"10662",11076,45,4,41,3.53555531199508e-06,"ranking",0.374125926639001
"10663",11077,42,11,31,3.39248699829358e-06,"phlegm",0.273483639412523
"10664",11078,40,4,36,3.60853201309175e-06,"flasher",0.425461836894687
"10665",11079,34,3,31,3.4991094766382e-06,"nationalist",0.348487879084674
"10666",11080,36,4,32,3.57315134082504e-06,"tweed",0.400573084882402
"10667",11081,59,16,43,3.59142511339925e-06,"snakes",0.41342788284949
"10668",11082,35,5,30,3.41924762875177e-06,"braggart",0.29230856987584
"10669",11083,46,4,42,3.50023626594795e-06,"hand out",0.349280525970782
"10670",11084,42,2,40,3.65283459964933e-06,"taint",0.456626764514551
"10671",11086,30,4,26,3.5564786593498e-06,"extroverted",0.388844584318907
"10672",11087,41,3,38,3.54136491286472e-06,"indignation",0.378212726184379
"10673",11088,42,7,35,3.48615473646413e-06,"upstanding",0.339374787248961
"10674",11089,41,6,35,3.63848057051375e-06,"kink",0.446529334232862
"10675",11090,40,13,27,3.54353588184434e-06,"completed",0.379739907696163
"10676",11091,41,11,30,3.59491104392622e-06,"bought",0.415880082167914
"10677",11092,33,6,27,3.32912753554676e-06,"modification",0.228913034760083
"10678",11093,47,15,32,3.50451732282913e-06,"Stalin",0.352292061824676
"10679",11094,38,16,22,3.39555114888473e-06,"unintelligent",0.275639135035008
"10680",11096,58,17,41,3.66307075221158e-06,"crowds",0.46382744913584
"10681",11097,31,4,27,3.47257189091957e-06,"enchilada",0.329819850818378
"10682",11098,51,7,44,3.654716960445e-06,"dragons",0.457950922820191
"10683",11099,42,6,36,3.60652781534578e-06,"free time",0.424051971635282
"10684",11100,39,7,32,3.6805977290712e-06,"vivacious",0.476156909053837
"10685",11101,46,12,34,3.6171467223225e-06,"hurried",0.431521907208943
"10686",11102,49,15,34,3.65168744476823e-06,"wishes",0.455819791341737
"10687",11103,39,5,34,3.76236878738854e-06,"canister",0.533679264109738
"10688",11105,34,4,30,3.37812730134922e-06,"came",0.263382222075807
"10689",11106,33,6,27,3.36309673947771e-06,"baffle",0.252808880670496
"10690",11107,50,10,40,3.66701992291924e-06,"forces",0.466605517615044
"10691",11108,32,5,27,3.60227952248183e-06,"wrapping paper",0.421063483831282
"10692",11109,46,8,38,3.38235493079702e-06,"shipwreck",0.266356174072332
"10693",11110,43,4,39,3.64951516191074e-06,"staring",0.45429168557447
"10694",11111,44,12,32,3.61555120885955e-06,"glaze",0.430399533427792
"10695",11112,33,5,28,3.56158333748851e-06,"left wing",0.392435501623675
"10696",11113,26,2,24,3.46092614383609e-06,"anecdote",0.3216275782416
"10697",11114,40,2,38,3.53202130515251e-06,"for sale",0.371639907740002
"10698",11115,39,5,34,3.44764577508248e-06,"yak",0.31228542097425
"10699",11116,51,6,45,3.61385261986246e-06,"unrest",0.429204650526736
"10700",11117,47,12,35,3.59894766770196e-06,"biggest",0.41871967004697
"10701",11118,43,4,39,3.6187305493233e-06,"Game Boy",0.432636060076252
"10702",11119,36,7,29,3.57149234807764e-06,"gamma",0.399406056207286
"10703",11120,50,7,43,3.64330578994156e-06,"Christmas tree",0.449923664584707
"10704",11121,34,3,31,3.68173601216446e-06,"narcotics",0.476957641312801
"10705",11122,47,12,35,3.5601378485375e-06,"genocide",0.391418663510278
"10706",11124,41,4,37,3.55603601553277e-06,"garnish",0.388533203797106
"10707",11125,76,37,39,3.62980359132767e-06,"cells",0.440425459734658
"10708",11126,33,3,30,3.59932332721448e-06,"law enforcement",0.418983930046827
"10709",11127,56,9,47,3.7811472000605e-06,"bullying",0.546889054264473
"10710",11128,41,3,38,3.47233073255761e-06,"hypnotic",0.329650206482024
"10711",11129,43,6,37,3.67653817165757e-06,"blackout",0.473301188365832
"10712",11130,44,10,34,3.58964602500547e-06,"critter",0.412176372151593
"10713",11131,40,5,35,3.57081643146889e-06,"tomato sauce",0.39893057850213
"10714",11132,41,8,33,3.50805800924724e-06,"antisocial",0.354782779512271
"10715",11133,53,7,46,3.58911779484603e-06,"top hat",0.411804785389623
"10716",11134,23,3,20,3.47855125297416e-06,"Lima",0.334026069915813
"10717",11135,38,3,35,3.65769799119226e-06,"knew",0.460047947276097
"10718",11137,29,2,27,3.43031991163496e-06,"South Pole",0.300097435525769
"10719",11139,36,6,30,3.5150743965496e-06,"Virgo",0.359718500413056
"10720",11140,31,4,27,3.49324232272669e-06,"crawly",0.344360593497202
"10721",11141,38,2,36,3.47440578974981e-06,"cufflink",0.331109918255686
"10722",11142,29,4,25,3.56086044631825e-06,"fedora",0.391926979373646
"10723",11145,39,5,34,3.6026169409459e-06,"truthfully",0.421300842929873
"10724",11146,30,2,28,3.68024554598283e-06,"conquistador",0.475909163689267
"10725",11147,45,8,37,3.80572533319125e-06,"wellbeing",0.564178693528671
"10726",11148,29,4,25,3.48553502962705e-06,"deserted",0.338938850654194
"10727",11149,38,8,30,3.450298450816e-06,"dangle",0.314151462071566
"10728",11150,78,31,47,3.68858052355712e-06,"holes",0.481772455045369
"10729",11151,43,4,39,3.5867362493499e-06,"crossroad",0.410129472529196
"10730",11153,56,25,31,3.54808722617637e-06,"stopped",0.382941578923562
"10731",11154,35,3,32,3.4134818880651e-06,"troop",0.288252624046552
"10732",11155,37,8,29,3.42234862096462e-06,"submerge",0.294489981964224
"10733",11158,58,17,41,3.69940143684752e-06,"works",0.489384493205666
"10734",11159,43,5,38,3.67394475121883e-06,"advancement",0.471476830770908
"10735",11160,42,7,35,3.65070093457944e-06,"toilet paper",0.455125824668032
"10736",11161,54,15,39,3.42284061542674e-06,"blockage",0.294836078501531
"10737",11162,37,6,31,3.52400552564066e-06,"correspondence",0.366001158228641
"10738",11163,43,13,30,3.43757197416321e-06,"miles",0.305198943617038
"10739",11164,48,15,33,3.59445878234114e-06,"yuk",0.415561935967899
"10740",11167,35,4,31,3.52022191478951e-06,"wince",0.363339553851101
"10741",11168,43,12,31,3.43623718283531e-06,"buried",0.304259976429026
"10742",11169,36,6,30,3.63205799670209e-06,"heartless",0.442011335092709
"10743",11170,50,8,42,3.64038791973673e-06,"coating",0.447871070801731
"10744",11171,33,3,30,3.56494800523334e-06,"dashing",0.394802397890471
"10745",11172,40,12,28,3.5677206902826e-06,"Simpsons",0.396752860280752
"10746",11173,57,20,37,3.67772804672186e-06,"streets",0.474138213314862
"10747",11174,37,3,34,3.54804945980947e-06,"momentum",0.382915011939955
"10748",11175,53,8,45,3.56639740366269e-06,"sneaking",0.395821986150497
"10749",11176,41,12,29,3.61001707538077e-06,"Vietnam",0.426506513116648
"10750",11177,58,13,45,3.6506209706271e-06,"elves",0.45506957353282
"10751",11178,28,2,26,3.44865640346521e-06,"piccolo",0.312996353740157
"10752",11179,44,15,29,3.49453629250667e-06,"Lord of the Rings",0.345270844515683
"10753",11180,30,3,27,3.38599687133889e-06,"asphyxiate",0.268918119597472
"10754",11181,64,22,42,3.56088580595309e-06,"plains",0.391944818765105
"10755",11182,36,5,31,3.55246096733512e-06,"decorum",0.386018314103876
"10756",11183,47,8,39,3.65002135262491e-06,"piles",0.454647768552797
"10757",11185,50,19,31,3.46013577572784e-06,"unending",0.321071588923579
"10758",11186,30,4,26,3.19982592946944e-06,"regarding",0.137955022877522
"10759",11187,45,6,39,3.61929373102133e-06,"uphold",0.433032233713499
"10760",11188,29,3,26,3.40893208384609e-06,"cleft",0.28505203622115
"10761",11189,50,17,33,3.54075049747545e-06,"changeable",0.377780511891196
"10762",11190,31,8,23,3.59271541023421e-06,"nights",0.414335550112155
"10763",11191,37,6,31,3.61628340089756e-06,"shaker",0.430914598430575
"10764",11192,33,6,27,3.44560254974589e-06,"pensioner",0.310848101515635
"10765",11193,40,6,34,3.52771016333298e-06,"checkered",0.368607208450761
"10766",11194,36,5,31,3.40415102175593e-06,"Creole",0.281688768620682
"10767",11196,25,7,18,3.56412212108036e-06,"pucker",0.39422142459184
"10768",11197,38,7,31,3.41991416015458e-06,"sham",0.29277744550002
"10769",11198,41,8,33,3.68219694598585e-06,"bedding",0.477281888050917
"10770",11199,49,11,38,3.65842058666433e-06,"unworthy",0.460556261515402
"10771",11201,30,4,26,3.42716922676208e-06,"virile",0.297881066829356
"10772",11202,43,2,41,3.64334561140804e-06,"downfall",0.449951677240786
"10773",11203,25,2,23,3.39301649345317e-06,"cardiac",0.273856116046645
"10774",11206,50,10,40,3.7660102510799e-06,"upsetting",0.536240874191448
"10775",11207,47,11,36,3.69795133496043e-06,"entertaining",0.488364410093955
"10776",11208,27,6,21,3.52559582569454e-06,"sleet",0.367119864605041
"10777",11209,31,6,25,3.56538015865942e-06,"gobble",0.395106398882078
"10778",11210,33,7,26,3.35092569322275e-06,"genie",0.244247083153304
"10779",11211,50,12,38,3.51569229254779e-06,"arise",0.360153163162035
"10780",11212,42,4,38,3.64974159829484e-06,"rocking chair",0.454450973644746
"10781",11213,34,4,30,3.5895558283618e-06,"flicker",0.412112922766576
"10782",11214,33,3,30,3.46359930312382e-06,"skyline",0.323508028621403
"10783",11215,38,2,36,3.60620266858998e-06,"infect",0.423823245145528
"10784",11217,43,5,38,3.51817842793715e-06,"feudal",0.361902050427614
"10785",11218,30,2,28,3.45944150776299e-06,"jean",0.320583201843847
"10786",11219,42,2,40,3.54963633975699e-06,"unavoidable",0.384031312421455
"10787",11220,45,14,31,3.60386334150209e-06,"withhold",0.422177631084634
"10788",11221,46,5,41,3.52579471412856e-06,"calmness",0.367259773900014
"10789",11222,21,6,15,3.25746692856701e-06,"shamrock",0.178502939024088
"10790",11223,41,3,38,3.59123164880627e-06,"severity",0.413291788988938
"10791",11224,30,3,27,3.36959012305743e-06,"shingles",0.2573766913785
"10792",11225,41,5,36,3.55682020273875e-06,"Tylenol",0.389084845121326
"10793",11226,41,4,37,3.58017442609804e-06,"administrator",0.405513517511921
"10794",11227,28,4,24,3.4069692963927e-06,"lager",0.283671301287341
"10795",11228,29,2,27,3.47679759127463e-06,"bubble wrap",0.332792445782724
"10796",11229,31,5,26,3.47446614827632e-06,"felony",0.331152377833243
"10797",11230,33,6,27,3.46922279001835e-06,"dogma",0.327463905143682
"10798",11232,47,16,31,3.45817339281392e-06,"not allowed",0.319691138565553
"10799",11233,32,9,23,3.56027727439413e-06,"amiable",0.391516743488627
"10800",11234,43,8,35,3.41598887754021e-06,"painkiller",0.290016181247306
"10801",11235,36,4,32,3.53935944672733e-06,"doable",0.37680196866722
"10802",11236,51,7,44,3.69378520639025e-06,"waver",0.485433721268911
"10803",11237,35,5,30,3.49805682943125e-06,"bewilder",0.347747387917843
"10804",11238,32,3,29,3.39695836348134e-06,"flapper",0.27662904881785
"10805",11239,38,2,36,3.54184154509296e-06,"blurb",0.378548016063562
"10806",11241,47,6,41,3.78036102447784e-06,"inspired",0.546336014204424
"10807",11242,36,2,34,3.62477752927914e-06,"carpeting",0.436889845403158
"10808",11243,42,8,34,3.65697568111172e-06,"third world",0.459539833797216
"10809",11244,34,3,31,3.2472065905305e-06,"sending",0.171285240981837
"10810",11245,43,7,36,3.68031326826539e-06,"welding",0.475956803346416
"10811",11246,39,11,28,3.61048629639926e-06,"rant",0.426836589534649
"10812",11247,49,7,42,3.6280257734951e-06,"renewal",0.439174842820867
"10813",11248,26,3,23,3.62910542551261e-06,"homicide",0.439934330688168
"10814",11249,39,10,29,3.40156880353219e-06,"heave",0.279872291292953
"10815",11250,32,5,27,3.51786901566507e-06,"malevolent",0.361684392457428
"10816",11251,34,4,30,3.42145870470416e-06,"liter",0.293863964884862
"10817",11252,31,6,25,3.31641959340696e-06,"astound",0.219973554522971
"10818",11253,56,17,39,3.54781029148809e-06,"show off",0.382746767509915
"10819",11254,31,4,27,3.57635883754032e-06,"existentialism",0.402829418219572
"10820",11255,38,6,32,3.33830741137628e-06,"sprinkles",0.235370675002254
"10821",11256,34,2,32,3.47288544687353e-06,"blown",0.330040423687127
"10822",11257,35,8,27,3.41823079210662e-06,"pebbles",0.291593269869461
"10823",11259,33,4,29,3.6563606049083e-06,"offering",0.459107154650244
"10824",11260,46,11,35,3.67867508838017e-06,"Arabic",0.474804415607497
"10825",11261,52,4,48,3.49408451491625e-06,"grandeur",0.344953038784693
"10826",11262,35,2,33,3.65438306705062e-06,"baboon",0.45771604345361
"10827",11263,47,12,35,3.68645926646834e-06,"tiles",0.480280243669647
"10828",11264,37,6,31,3.49559904080762e-06,"nervous system",0.346018441359367
"10829",11265,48,12,36,3.6430403357426e-06,"exaggerate",0.449736929192037
"10830",11266,36,9,27,3.66089831122761e-06,"ignite",0.462299232133524
"10831",11267,48,15,33,3.49778764931181e-06,"assertive",0.347558031503445
"10832",11268,33,4,29,3.45792227282315e-06,"arachnid",0.319514486660006
"10833",11269,41,4,37,3.55039249589042e-06,"spastic",0.384563235114885
"10834",11270,44,10,34,3.51606313442964e-06,"unknowing",0.360414034169903
"10835",11271,44,10,34,3.55017821894659e-06,"smells",0.384412500677825
"10836",11272,27,4,23,3.5373812766409e-06,"choral",0.375410412725374
"10837",11273,37,3,34,3.62634174644619e-06,"craze",0.437990203612026
"10838",11274,35,11,24,3.38475910669438e-06,"bathe",0.268047406428015
"10839",11275,32,6,26,3.45965694041779e-06,"penniless",0.320734749272915
"10840",11276,38,9,29,3.55946622244528e-06,"chaste",0.390946203995432
"10841",11277,29,2,27,3.36665196561975e-06,"legality",0.255309826416517
"10842",11278,40,4,36,3.46098603492135e-06,"rabies",0.321669708994727
"10843",11279,40,4,36,3.54300858116678e-06,"Nordic",0.37936897478396
"10844",11281,41,4,37,3.39932557380616e-06,"forethought",0.278294277513652
"10845",11282,51,8,43,3.62657846827832e-06,"boy scout",0.438156727044126
"10846",11283,36,8,28,3.61994881392377e-06,"froth",0.43349305581952
"10847",11284,37,8,29,3.43188564957016e-06,"shrubbery",0.301198863528368
"10848",11285,29,5,24,3.30780808097514e-06,"conjoined",0.213915733016628
"10849",11286,47,10,37,3.70833225173643e-06,"breaking",0.49566692999381
"10850",11287,37,4,33,3.53149742553838e-06,"madman",0.371271381395951
"10851",11288,27,3,24,3.37811588964371e-06,"dyke",0.263374194441215
"10852",11289,35,11,24,3.43792651775861e-06,"well known",0.305448349494828
"10853",11290,42,9,33,3.63640330621789e-06,"rolls",0.445068069858514
"10854",11291,55,19,36,3.69208048735462e-06,"wrinkly",0.484234526154459
"10855",11292,43,10,33,3.69103116337611e-06,"starting",0.483496372733155
"10856",11293,30,10,20,3.4044291623402e-06,"Nile",0.281884428329304
"10857",11294,27,3,24,3.4629276282755e-06,"infatuated",0.32303553480877
"10858",11295,53,22,31,3.50602861620557e-06,"Islam",0.35335519046679
"10859",11296,40,13,27,3.56780979292432e-06,"objects",0.396815540083349
"10860",11297,46,11,35,3.5516913154044e-06,"watery",0.385476897708641
"10861",11298,37,3,34,3.58282964719876e-06,"cash register",0.407381349163495
"10862",11299,42,12,30,3.69408539986627e-06,"potty",0.485644894220182
"10863",11300,43,10,33,3.61790573908387e-06,"oz",0.432055842228737
"10864",11301,50,9,41,3.47873276722755e-06,"qualified",0.334153757236318
"10865",11302,51,10,41,3.46059079206002e-06,"Renaissance",0.321391672967427
"10866",11303,41,4,37,3.72404804021972e-06,"black magic",0.506722298283298
"10867",11304,25,9,16,3.18517999452149e-06,"elated",0.127652249652649
"10868",11305,50,9,41,3.59107689213841e-06,"devastation",0.413182924456926
"10869",11306,40,3,37,3.61453186390565e-06,"insightful",0.429682468936158
"10870",11307,32,3,29,3.49831381274226e-06,"movie star",0.34792816441216
"10871",11309,54,22,32,3.58829355111883e-06,"alot",0.411224966058627
"10872",11310,41,4,37,3.64350490597936e-06,"animate",0.450063733988956
"10873",11311,40,5,35,3.31255258677232e-06,"someday",0.217253284867439
"10874",11312,39,3,36,3.36391128693154e-06,"grading",0.253381879098219
"10875",11313,48,3,45,3.64338543374504e-06,"life jacket",0.44997969050923
"10876",11314,24,4,20,3.04213971939303e-06,"weeks",0.0270296863332218
"10877",11315,39,5,34,3.4679354686568e-06,"grimy",0.326558330996129
"10878",11317,43,7,36,3.62760462011724e-06,"family tree",0.438878579880992
"10879",11318,38,3,35,3.49390139511483e-06,"acronym",0.344824222031532
"10880",11319,55,6,49,3.7193940363236e-06,"ruthless",0.50344841055269
"10881",11320,44,12,32,3.53539281749595e-06,"fascist",0.374011618881884
"10882",11321,42,5,37,3.69892250387462e-06,"sociopath",0.489047584853471
"10883",11322,39,7,32,3.49523250286609e-06,"crystal ball",0.345760597984851
"10884",11323,45,10,35,3.60875339222819e-06,"stoic",0.425617567412917
"10885",11324,39,2,37,3.60637173758597e-06,"Sparky",0.423942177772994
"10886",11325,35,2,33,3.6584072026721e-06,"disinherit",0.460546846463565
"10887",11326,32,9,23,3.58452488914857e-06,"abhor",0.408573877563504
"10888",11327,34,7,27,3.51184016913022e-06,"ammunition",0.357443363197305
"10889",11328,38,5,33,3.51942900783777e-06,"lumps",0.362781778567977
"10890",11329,41,5,36,3.57925179320515e-06,"trapeze",0.404864485715791
"10891",11330,66,25,41,3.5638934823516e-06,"pirates",0.394060587268638
"10892",11331,46,5,41,3.60002304014746e-06,"relentless",0.41947614742295
"10893",11332,53,13,40,3.75818344445029e-06,"teens",0.53073505881903
"10894",11333,36,5,31,3.58802317862973e-06,"reassure",0.411034770864445
"10895",11334,36,5,31,3.62757830127763e-06,"boastful",0.438860065731024
"10896",11335,67,22,45,3.50652037463664e-06,"outer space",0.353701120966601
"10897",11336,38,6,32,3.55908616903524e-06,"intentional",0.390678853081275
"10898",11337,31,3,28,3.48317972510746e-06,"cache",0.337281997170472
"10899",11338,37,5,32,3.42149382420365e-06,"stellar",0.29388866991327
"10900",11339,40,6,34,3.5600998251991e-06,"shred",0.391391915758486
"10901",11340,46,3,43,3.55280173945173e-06,"hater",0.386258032350015
"10902",11341,43,8,35,3.60974341943775e-06,"wasteland",0.426314008156562
"10903",11342,43,7,36,3.53027564392228e-06,"spunky",0.37041191158636
"10904",11343,30,3,27,3.45917823761787e-06,"fiddler",0.320398002837321
"10905",11344,51,7,44,3.68747879699692e-06,"colored",0.480997438704936
"10906",11345,59,12,47,3.69994894070462e-06,"fertile",0.489769638169063
"10907",11346,43,12,31,3.55045552344366e-06,"glum",0.384607572235747
"10908",11347,56,11,45,3.69769153117709e-06,"enlightenment",0.488181649520985
"10909",11348,35,6,29,3.48011289486231e-06,"falsify",0.335124616528865
"10910",11349,38,2,36,3.62454104249049e-06,"suburbia",0.436723487313849
"10911",11350,35,5,30,3.68753318779869e-06,"compulsory",0.481035700249738
"10912",11351,47,14,33,3.52161036198633e-06,"Santa Claus",0.36431626559087
"10913",11353,42,4,38,3.54334754215698e-06,"smartass",0.379607418982057
"10914",11354,35,9,26,3.47543216999034e-06,"terrifying",0.331831931763069
"10915",11355,49,16,33,3.63756734046539e-06,"irrelevant",0.44588691692568
"10916",11356,54,15,39,3.70941895661464e-06,"togetherness",0.496431379239443
"10917",11357,58,14,44,3.6749573704945e-06,"ads",0.472189164042731
"10918",11358,39,8,31,3.50994191046138e-06,"s",0.35610802143478
"10919",11359,40,10,30,3.59210885526675e-06,"downer",0.413908865281151
"10920",11360,69,18,51,3.71658787500372e-06,"magnifying glass",0.501474399073467
"10921",11361,44,7,37,3.65769799119226e-06,"undermine",0.460047947276097
"10922",11363,40,15,25,3.63393220536078e-06,"gore",0.443329758727332
"10923",11364,52,3,49,3.62792047598317e-06,"cyst",0.439100770636988
"10924",11365,38,12,26,3.55058158526367e-06,"pomp",0.384696251200147
"10925",11366,23,4,19,3.38852104610422e-06,"Jill",0.270693765896567
"10926",11368,34,5,29,3.36602869202857e-06,"lax",0.254871380766594
"10927",11369,51,15,36,3.71668456869734e-06,"deceitful",0.50154241884832
"10928",11371,53,10,43,3.80853721702569e-06,"imperfect",0.566156730546028
"10929",11372,39,4,35,3.64588270466163e-06,"Dolly",0.451736411130081
"10930",11373,43,5,38,3.57401973573698e-06,"delusion",0.401183962636478
"10931",11374,41,6,35,3.49063288664868e-06,"catalyst",0.342524969602104
"10932",11375,32,7,25,3.40089783702898e-06,"slinky",0.279400295770055
"10933",11376,31,3,28,3.56304269594063e-06,"javelin",0.393462096323115
"10934",11379,37,7,30,3.4348444358955e-06,"flooring",0.303280240008545
"10935",11381,46,14,32,3.48127595726386e-06,"disdain",0.335942779945001
"10936",11382,43,6,37,3.51663191062128e-06,"hallelujah",0.360814143288168
"10937",11383,30,2,28,3.48396851886046e-06,"neurotransmitter",0.337836878998591
"10938",11385,56,14,42,3.57547652163342e-06,"witches",0.402208747655773
"10939",11386,45,3,42,3.49748181309457e-06,"oscillate",0.347342889131084
"10940",11387,46,11,35,3.4487515519382e-06,"stun",0.313063286520029
"10941",11388,49,16,33,3.55445604381933e-06,"pearls",0.387421762955463
"10942",11389,41,10,31,3.51165518355422e-06,"PowerPoint",0.357313233953509
"10943",11390,35,2,33,3.67734936657657e-06,"hallucinogen",0.473871828432265
"10944",11391,30,4,26,3.38638672536404e-06,"candy cane",0.269192364814739
"10945",11392,49,20,29,3.6444476839535e-06,"yelling",0.450726936966677
"10946",11393,22,2,20,3.26534877190233e-06,"pituitary",0.184047470306412
"10947",11394,43,12,31,3.61721214225772e-06,"sparks",0.43156792726566
"10948",11395,40,6,34,3.64581624356969e-06,"Hunger Games",0.451689658665256
"10949",11396,39,2,37,3.65638734304957e-06,"brushes",0.459125963760553
"10950",11397,41,7,34,3.5263790786982e-06,"turn on",0.367670848758876
"10951",11398,46,10,36,3.65565218662836e-06,"imaginative",0.458608813444132
"10952",11399,58,18,40,3.55992239369182e-06,"unruly",0.391267100470902
"10953",11400,49,10,39,3.64830353885443e-06,"crinkle",0.453439361866388
"10954",11401,31,3,28,3.47088448549344e-06,"oxide",0.328632835069253
"10955",11402,28,4,24,3.34762770362782e-06,"analogy",0.241927092042098
"10956",11403,43,18,25,3.40871130260494e-06,"occurrence",0.28489672629604
"10957",11404,33,4,29,3.73113445142996e-06,"silo",0.511707277933745
"10958",11405,87,43,44,3.75283808380087e-06,"hiding",0.526974831918404
"10959",11406,37,2,35,3.61962124283315e-06,"terrace",0.43326262391649
"10960",11407,42,10,32,3.4366505029538e-06,"linked",0.304550729014316
"10961",11408,45,7,38,3.71961539176849e-06,"stalking",0.503604124404955
"10962",11409,44,9,35,3.63333805667281e-06,"fulfill",0.442911801170115
"10963",11410,28,3,25,3.31687059892732e-06,"folding",0.220290817136523
"10964",11411,44,7,37,3.5226151895167e-06,"unplanned",0.365023117711427
"10965",11412,45,6,39,3.5848975436282e-06,"immerse",0.408836023654454
"10966",11413,43,7,36,3.58225209024409e-06,"dressed",0.406975063163348
"10967",11414,42,11,31,3.57768952810275e-06,"giver",0.403765500698834
"10968",11416,42,9,33,3.59683766032904e-06,"inedible",0.41723537235322
"10969",11417,49,6,43,3.58972334002218e-06,"unravel",0.412230759876711
"10970",11418,52,5,47,3.64938197716217e-06,"rubbing",0.454197995942061
"10971",11419,51,5,46,3.70859355298097e-06,"Gothic",0.495850743965089
"10972",11420,36,3,33,3.62956644828775e-06,"raider",0.440258640001343
"10973",11421,63,28,35,3.64276165046245e-06,"Victorian",0.449540886313745
"10974",11423,31,2,29,3.60642376200488e-06,"altruistic",0.423978774671188
"10975",11425,48,9,39,3.57708803571365e-06,"aloud",0.403342377169782
"10976",11426,29,2,27,3.47958008427543e-06,"dining room",0.334749807636982
"10977",11427,29,2,27,3.53501788719051e-06,"stylist",0.373747871847239
"10978",11428,34,5,29,3.46975243316389e-06,"mashed",0.32783648587943
"10979",11429,52,9,43,3.55532801456262e-06,"directed",0.388035156150146
"10980",11430,34,6,28,3.46949962876354e-06,"diversion",0.327658649065574
"10981",11431,49,9,40,3.48222151803965e-06,"mislead",0.336607940501698
"10982",11433,40,9,31,3.5773439651996e-06,"drops",0.403522412344367
"10983",11434,33,4,29,3.5686246520591e-06,"lilac",0.397388757764955
"10984",11435,40,4,36,3.57102045480517e-06,"lawless",0.399074099975746
"10985",11437,40,10,30,3.51239524281188e-06,"asthma",0.357833833200454
"10986",11439,28,5,23,3.35951515477286e-06,"axiom",0.250289392830978
"10987",11440,34,6,28,3.24213215579093e-06,"Maine",0.167715598582637
"10988",11441,37,6,31,3.63584800700992e-06,"sinful",0.444677441207492
"10989",11442,68,23,45,3.64232380258605e-06,"floating",0.449232879525953
"10990",11443,38,6,32,3.57620536001659e-06,"racer",0.402721453509383
"10991",11444,43,9,34,3.38396878627192e-06,"lol",0.267491450654857
"10992",11445,24,2,22,3.45836474681312e-06,"six pack",0.319825747715904
"10993",11446,35,2,33,3.6247906683389e-06,"uncoordinated",0.436899088155745
"10994",11447,38,3,35,3.50794725450508e-06,"defame",0.354704868406145
"10995",11448,32,2,30,3.42837943932283e-06,"knees and toes",0.298732398315642
"10996",11449,37,3,34,3.53823236987266e-06,"captivity",0.376009119505868
"10997",11450,32,5,27,3.54958594080001e-06,"maize",0.383995858964476
"10998",11451,50,15,35,3.53326926338402e-06,"kings",0.372517791651072
"10999",11452,47,14,33,3.71355149210499e-06,"Smith",0.499338436805394
"11000",11453,27,2,25,3.44113254554339e-06,"Moore",0.307703649503781
"11001",11454,36,2,34,3.50473840632535e-06,"splice",0.352447584372978
"11002",11455,46,7,39,3.63833495239239e-06,"brightness",0.446426898267716
"11003",11456,37,6,31,3.60724334463603e-06,"ambassador",0.424555315125433
"11004",11457,40,7,33,3.49649127100954e-06,"pretense",0.346646086195113
"11005",11458,35,5,30,3.49584344214729e-06,"folded",0.34619036698838
"11006",11459,31,7,24,3.62169248933412e-06,"Homer",0.434719655035918
"11007",11460,33,8,25,3.4035485397075e-06,"sorcery",0.281264948909677
"11008",11461,35,4,31,3.5026637758015e-06,"whoosh",0.350988172741788
"11009",11462,44,3,41,3.66229266845631e-06,"wronged",0.46328010132165
"11010",11463,48,10,38,3.55526481389966e-06,"crazed",0.387990697254182
"11011",11464,46,7,39,3.60650180144765e-06,"spirited",0.424033671998281
"11012",11465,33,6,27,3.48218514081957e-06,"centered",0.336582350721982
"11013",11466,42,9,33,3.65678846210104e-06,"bullseye",0.459408133430033
"11014",11467,36,4,32,3.62855235275335e-06,"anew",0.439545268246213
"11015",11468,39,7,32,3.54363633786446e-06,"outspoken",0.379810574102786
"11016",11469,45,10,35,3.522590372056e-06,"asking",0.365005659715707
"11017",11470,55,15,40,3.64987480929404e-06,"don't know",0.454544681743321
"11018",11471,34,2,32,3.59744581347243e-06,"repulse",0.417663181430938
"11019",11472,43,5,38,3.65228761034474e-06,"fixing",0.45624198151629
"11020",11474,45,9,36,3.65050103126654e-06,"uncivilized",0.454985201450258
"11021",11475,47,17,30,3.43009635140651e-06,"malleable",0.299940170704917
"11022",11476,36,3,33,3.6820342502826e-06,"hardcore",0.477167438755513
"11023",11477,42,4,38,3.52539695969766e-06,"passover",0.366979971093614
"11024",11478,37,8,29,3.65303475862573e-06,"birth control",0.456767567580392
"11025",11479,35,4,31,3.49208344682605e-06,"wordplay",0.343545375100937
"11026",11480,52,10,42,3.65327497835435e-06,"invasive",0.456936551629337
"11027",11481,36,6,30,3.6680152736156e-06,"females",0.467305703198296
"11028",11482,42,4,38,3.54008616569727e-06,"migration",0.377313183606528
"11029",11483,37,6,31,3.50146186032669e-06,"mortified",0.350142677891753
"11030",11484,37,7,30,3.49518363694829e-06,"rut",0.345726222953734
"11031",11485,33,4,29,3.61892698814801e-06,"steering wheel",0.432774246178457
"11032",11486,42,5,37,3.57029372806501e-06,"discredit",0.398562879570432
"11033",11487,55,6,49,3.66189034103185e-06,"stimulation",0.462997081614743
"11034",11488,41,12,29,3.57946959419553e-06,"cutter",0.405017699165124
"11035",11489,46,7,39,3.58180300799817e-06,"weaving",0.406659153489056
"11036",11490,33,4,29,3.5477725310164e-06,"kidding",0.382720204673327
"11037",11491,52,23,29,3.60080081810195e-06,"Amazon",0.420023280119694
"11038",11492,61,11,50,3.64418206333588e-06,"firework",0.450540084505783
"11039",11493,27,5,22,3.47357305618852e-06,"edifice",0.330524126698561
"11040",11494,37,3,34,3.62125969139625e-06,"flashing",0.434415200658516
"11041",11495,34,6,28,3.38930200714465e-06,"finality",0.271243137754739
"11042",11496,41,8,33,3.69435834537078e-06,"swings",0.485836899417919
"11043",11497,39,3,36,3.55756676663429e-06,"unease",0.389610020095882
"11044",11498,42,11,31,3.55412758607208e-06,"disappointing",0.387190707328363
"11045",11499,24,2,22,3.39428334798532e-06,"grail",0.274747292676885
"11046",11500,38,4,34,3.54382470825463e-06,"niceness",0.37994308441497
"11047",11501,45,8,37,3.57640999964236e-06,"housework",0.402865408515641
"11048",11502,52,6,46,3.73007672767829e-06,"whipped cream",0.510963215640232
"11049",11503,38,10,28,3.5762565177275e-06,"Arthur",0.402757440716488
"11050",11504,47,7,40,3.64127604877853e-06,"rascal",0.448495830651114
"11051",11505,31,3,28,3.27724868418465e-06,"Marxist",0.192418536959134
"11052",11506,29,8,21,3.5237075040875e-06,"slovenly",0.365791513129896
"11053",11507,40,9,31,3.68497855342482e-06,"Minecraft",0.479238626951243
"11054",11509,46,6,40,3.64955511923097e-06,"encouragement",0.454319793797702
"11055",11510,39,4,35,3.6658235272554e-06,"perverse",0.465763905710061
"11056",11511,32,11,21,3.49143725014402e-06,"archaic",0.34309080406145
"11057",11512,44,6,38,3.65764447695684e-06,"fundamentalist",0.460010302357297
"11058",11513,57,11,46,3.77766192947861e-06,"distracted",0.544437319188483
"11059",11514,37,5,32,3.5833431875271e-06,"deceptive",0.407742602273212
"11060",11515,51,10,41,3.6356629449597e-06,"woodwork",0.444547258167441
"11061",11516,49,21,28,3.59982864815635e-06,"Mario",0.419339401178463
"11062",11517,31,2,29,3.48279152706477e-06,"moisturizer",0.337008916864276
"11063",11518,53,16,37,3.64264222696575e-06,"forgetful",0.4494568771188
"11064",11519,32,7,25,3.43952286938756e-06,"handed",0.306571312889017
"11065",11520,28,5,23,3.43759560812785e-06,"aloe",0.305215569075159
"11066",11521,41,6,35,3.60214976297855e-06,"ironic",0.420972203708789
"11067",11522,41,4,37,3.48173655092214e-06,"laying",0.336266787393276
"11068",11523,47,8,39,3.55064461953068e-06,"countdown",0.384740593043854
"11069",11524,44,6,38,3.63010665253345e-06,"enduring",0.440638650008102
"11070",11526,45,7,38,3.69914142927427e-06,"goodwill",0.489201589275429
"11071",11527,39,6,33,3.45902268772981e-06,"imprisonment",0.320288580309667
"11072",11529,36,5,31,3.36123155524184e-06,"dotted",0.251496805321733
"11073",11530,34,2,32,3.44908461294372e-06,"outwit",0.313297580337541
"11074",11531,30,4,26,3.3512625881801e-06,"dupe",0.244484073987857
"11075",11532,48,7,41,3.74356574637342e-06,"headed",0.520452148995184
"11076",11533,41,6,35,3.4450802531445e-06,"askew",0.31048068875166
"11077",11534,41,6,35,3.60187729844795e-06,"crusty",0.420780536855118
"11078",11535,43,5,38,3.68195290782231e-06,"air conditioning",0.477110217900384
"11079",11536,59,15,44,3.6372498026792e-06,"unmoving",0.445663543012503
"11080",11537,40,7,33,3.50434538828147e-06,"barred",0.352171113407225
"11081",11538,43,5,38,3.49130316381893e-06,"nasal",0.342996480209479
"11082",11539,33,2,31,3.34581321663137e-06,"tin foil",0.240650679978928
"11083",11541,39,3,36,3.4965034965035e-06,"noticeable",0.346654686294201
"11084",11542,55,17,38,3.55396337996133e-06,"attached",0.387075195527496
"11085",11543,56,25,31,3.56471926053464e-06,"shapes",0.394641486022055
"11086",11544,28,6,22,3.28760277868187e-06,"gallows",0.199702188561633
"11087",11545,26,2,24,3.30105997035648e-06,"beanstalk",0.209168733002801
"11088",11546,43,7,36,3.49509812487986e-06,"malice",0.345666068962053
"11089",11548,39,2,37,3.48889136987831e-06,"uncanny",0.341299888894302
"11090",11549,28,3,25,3.36511120009961e-06,"Hawking",0.254225965413231
"11091",11550,52,17,35,3.45956118925875e-06,"cunt",0.320667392529829
"11092",11551,36,7,29,3.40104820305618e-06,"Columbus",0.279506071678833
"11093",11553,42,4,38,3.60535756133615e-06,"apple pie",0.423228749238107
"11094",11554,40,2,38,3.70979050813001e-06,"lampshade",0.496692749443381
"11095",11555,27,5,22,3.53785683708523e-06,"believing",0.375744948651557
"11096",11556,40,2,38,3.41952824188375e-06,"deviate",0.292505968913388
"11097",11557,32,2,30,3.60592959061881e-06,"grandson",0.423631146763309
"11098",11558,44,7,37,3.56670269036384e-06,"caregiver",0.396036741962379
"11099",11559,46,11,35,3.61434896539261e-06,"finding",0.429553807849673
"11100",11561,44,15,29,3.36155922563122e-06,"spout",0.251727307077084
"11101",11562,34,6,28,3.28746227637038e-06,"tadpole",0.199603351344481
"11102",11563,33,2,31,3.37097589752233e-06,"shaken",0.258351522968525
"11103",11564,43,6,37,3.54981274737758e-06,"crawling",0.38415540744963
"11104",11565,54,26,28,3.60355166051661e-06,"greater",0.421958377174018
"11105",11566,41,10,31,3.52256555494498e-06,"scab",0.364988201965975
"11106",11567,40,5,35,3.63677359993308e-06,"chainsaw",0.445328555255168
"11107",11568,26,2,24,3.44730110796258e-06,"French horn",0.312042962764029
"11108",11569,30,4,26,3.21939880946632e-06,"apostle",0.151723685969517
"11109",11570,29,3,26,3.48861142799332e-06,"sign language",0.341102962049587
"11110",11571,39,2,37,3.68742440779964e-06,"deprivation",0.480959178288825
"11111",11573,44,9,35,3.53571782143211e-06,"rounded",0.374240244904278
"11112",11574,43,8,35,3.47723281812334e-06,"sometime",0.333098608792431
"11113",11576,39,2,37,3.4253027111271e-06,"angled",0.29656805489968
"11114",11577,32,5,27,3.40261048276238e-06,"gush",0.280605066968922
"11115",11578,54,9,45,3.55811106999516e-06,"trucks",0.389992913650476
"11116",11579,41,3,38,3.71513807310649e-06,"well mannered",0.500454526991471
"11117",11580,37,5,32,3.47973748860386e-06,"combined",0.334860534682145
"11118",11581,46,12,34,3.65669485978404e-06,"beliefs",0.459342288303116
"11119",11582,40,6,34,3.50436994932681e-06,"thump",0.352188391025979
"11120",11583,35,6,29,3.53721861425924e-06,"recluse",0.375295986870249
"11121",11584,43,9,34,3.54742013870413e-06,"hippies",0.382472312128914
"11122",11585,33,2,31,3.47093267431892e-06,"reimburse",0.328666733795598
"11123",11586,40,5,35,3.59367082693959e-06,"revolutionary",0.415007643883281
"11124",11587,48,7,41,3.5596182665371e-06,"cooling",0.391053160349103
"11125",11588,30,5,25,3.53518034722541e-06,"headstrong",0.373862155360288
"11126",11589,44,7,37,3.67533555813646e-06,"whirlpool",0.472455202470825
"11127",11590,49,15,34,3.57427522634098e-06,"spiders",0.401363689076848
"11128",11591,30,6,24,3.41742476539379e-06,"infrequently",0.29102626540952
"11129",11593,34,5,29,3.66519203773682e-06,"undesirable",0.46531968051536
"11130",11594,32,2,30,3.55382444817991e-06,"brazen",0.386977463109401
"11131",11595,49,11,38,3.49555016464041e-06,"James Bond",0.345984059118243
"11132",11596,46,13,33,3.68862134088763e-06,"Kansas",0.481801168248137
"11133",11597,46,6,40,3.62577636936509e-06,"trespass",0.437592485619029
"11134",11598,39,9,30,3.51715138874723e-06,"orthodox",0.361179573378216
"11135",11599,37,8,29,3.56524033285084e-06,"meth",0.395008037555068
"11136",11600,29,5,24,3.56400779804906e-06,"October",0.394141003350724
"11137",11601,45,9,36,3.47869646286144e-06,"fortune teller",0.334128218706172
"11138",11602,49,9,40,3.64285454081818e-06,"cellular",0.449606230607116
"11139",11603,47,12,35,3.47149899326529e-06,"aghast",0.329065114349533
"11140",11604,35,4,31,3.58279113760784e-06,"questionnaire",0.407354259354366
"11141",11605,48,18,30,3.60780295623374e-06,"jokes",0.424948977353604
"11142",11606,37,6,31,3.37299981111201e-06,"crabby",0.25977525745972
"11143",11607,44,10,34,3.51700295076548e-06,"exclaim",0.361075153764899
"11144",11608,30,3,27,3.44831153425725e-06,"goatee",0.312753753369851
"11145",11609,44,3,41,3.64065298751984e-06,"skillful",0.448057534367789
"11146",11610,27,5,22,3.49579455914535e-06,"soaring",0.346155979939324
"11147",11611,47,14,33,3.55271338484768e-06,"shops",0.386195878759126
"11148",11612,30,8,22,3.43862400022007e-06,"braid",0.305938997832016
"11149",11613,43,8,35,3.65685532383282e-06,"Coca Cola",0.459455167727425
"11150",11614,34,9,25,3.60433096408645e-06,"sleepless",0.422506583074286
"11151",11616,43,11,32,3.45516235807921e-06,"amend",0.317573007619718
"11152",11617,50,14,36,3.73252710747812e-06,"uncontrollable",0.512686950415935
"11153",11618,37,3,34,3.59949175176465e-06,"disrupt",0.419102409334906
"11154",11619,83,40,43,3.65318155581696e-06,"black and white",0.456870832969505
"11155",11620,52,10,42,3.61199906088024e-06,"bushy",0.427900753034324
"11156",11621,44,4,40,3.68420470915046e-06,"rewarding",0.478694261426034
"11157",11622,41,6,35,3.64539094995243e-06,"nick",0.451390483248444
"11158",11623,50,8,42,3.658929250944e-06,"horde",0.460914084538633
"11159",11624,36,5,31,3.46230416342076e-06,"comes",0.322596954613317
"11160",11625,46,3,43,3.6091050502207e-06,"excitable",0.425864943395564
"11161",11626,26,3,23,3.48693271963317e-06,"Albert",0.339922064305147
"11162",11627,47,8,39,3.48462409617563e-06,"lifting",0.338298048902287
"11163",11628,53,12,41,3.60570855778869e-06,"saved",0.423475659856388
"11164",11629,38,6,32,3.59993232127236e-06,"wishful",0.419412330671021
"11165",11630,38,11,27,3.48876965049506e-06,"ogre",0.341214264643808
"11166",11632,33,9,24,3.51554397769739e-06,"nocturnal",0.360048830166227
"11167",11634,40,3,37,3.61574730265251e-06,"toughness",0.430537476815286
"11168",11635,40,5,35,3.52810843994101e-06,"bookkeeping",0.368887378585879
"11169",11636,35,4,31,3.48582662892678e-06,"heist",0.339143977979174
"11170",11637,40,7,33,3.46459530062293e-06,"question mark",0.324208669202041
"11171",11638,45,6,39,3.62778886268819e-06,"whimsical",0.4390081864533
"11172",11639,35,7,28,3.39196917378415e-06,"optics",0.273119372569204
"11173",11640,31,5,26,3.43352355053803e-06,"repugnant",0.302351055061159
"11174",11641,41,3,38,3.53173439944622e-06,"entranced",0.371438082152266
"11175",11642,29,7,22,3.48783269564126e-06,"kiln",0.340555157975988
"11176",11643,39,11,28,3.48415059892549e-06,"shudder",0.337964964342776
"11177",11644,31,7,24,3.42134164491264e-06,"Venice",0.29378161845289
"11178",11645,43,6,37,3.62649955756705e-06,"permissive",0.438101216817837
"11179",11646,36,10,26,3.50747970046123e-06,"latte",0.354375964631735
"11180",11647,43,8,35,3.71277938664885e-06,"hoodie",0.498795294462579
"11181",11648,57,22,35,3.7015102161682e-06,"wires",0.490867927018493
"11182",11649,48,5,43,3.60239631402809e-06,"multicultural",0.42114564156447
"11183",11650,47,3,44,3.66505770633359e-06,"apartments",0.465225184261664
"11184",11651,35,2,33,3.45893893589203e-06,"go off",0.320229664563085
"11185",11652,39,6,33,3.57313857346016e-06,"in time",0.400564103600868
"11186",11653,55,18,37,3.46726211114655e-06,"benefits",0.326084653504594
"11187",11654,34,10,24,3.42671121391245e-06,"easel",0.297558874866836
"11188",11656,34,9,25,3.43472645838485e-06,"roundabout",0.303197248001403
"11189",11657,42,6,36,3.64687991189138e-06,"peep",0.452437902703196
"11190",11658,36,3,33,3.6044219047928e-06,"faithfulness",0.42257055587478
"11191",11659,45,7,38,3.58740533734166e-06,"disposable",0.41060014660163
"11192",11660,31,4,27,3.44452252028824e-06,"joiner",0.310088348135746
"11193",11661,42,6,36,3.57290877649312e-06,"agility",0.400402451507809
"11194",11662,41,8,33,3.58313775373094e-06,"blacksmith",0.407598088602896
"11195",11663,45,5,40,3.65440977627703e-06,"daredevil",0.457734832223581
"11196",11664,52,18,34,3.47613287170289e-06,"Lincoln",0.33232484470228
"11197",11665,33,2,31,3.67474129821261e-06,"libido",0.47203716666404
"11198",11666,47,13,34,3.53873320428753e-06,"worldly",0.376361434562432
"11199",11667,36,10,26,3.34665301232238e-06,"glisten",0.241241439434738
"11200",11668,38,5,33,3.39239492904806e-06,"piglet",0.273418872734196
"11201",11669,35,7,28,3.44045771849487e-06,"obstinate",0.307228938256488
"11202",11670,34,7,27,3.35838689960438e-06,"apprehensive",0.249495714777513
"11203",11671,56,11,45,3.73429727993786e-06,"Arab",0.513932189145075
"11204",11673,30,8,22,3.61941162844568e-06,"rocking",0.433115169383444
"11205",11674,44,7,37,3.72828275296398e-06,"laziness",0.509701233068391
"11206",11675,65,18,47,3.6810854784859e-06,"sides",0.476500019386364
"11207",11676,40,5,35,3.48510986808859e-06,"thyroid",0.338639768149033
"11208",11677,39,3,36,3.38575612398639e-06,"alas",0.268748764388254
"11209",11678,51,10,41,3.67771452108802e-06,"loom",0.474128698624357
"11210",11680,44,4,40,3.609065973726e-06,"sophistication",0.42583745479448
"11211",11681,48,13,35,3.44101413568607e-06,"nuns",0.307620353359705
"11212",11682,33,7,26,3.40903667441654e-06,"sleuth",0.285125611102688
"11213",11683,42,9,33,3.61030380706536e-06,"sexism",0.426708216287753
"11214",11684,25,5,20,3.15162135160433e-06,"Mussolini",0.104045215418317
"11215",11685,66,23,43,3.6441422235827e-06,"machines",0.450512058985813
"11216",11686,31,7,24,3.43044935456095e-06,"headstone",0.300188492950018
"11217",11687,47,7,40,3.53376869363639e-06,"tech",0.372869118940866
"11218",11688,50,9,41,3.54401309867241e-06,"Midwest",0.380075608815703
"11219",11689,44,3,41,3.6679345493759e-06,"gusto",0.46724891723425
"11220",11690,48,5,43,3.73803827751196e-06,"skipping",0.516563816950179
"11221",11691,44,7,37,3.48831936261429e-06,"cut off",0.340897506858253
"11222",11692,45,9,36,3.60750360750361e-06,"prime minister",0.424738398644038
"11223",11693,42,5,37,3.370032992623e-06,"pronunciation",0.257688230704494
"11224",11694,37,4,33,3.53030056979051e-06,"bank account",0.370429445842027
"11225",11695,39,8,31,3.41737805086426e-06,"mayo",0.290993403785744
"11226",11696,24,3,21,3.630343866171e-06,"moronic",0.440805519403755
"11227",11697,24,7,17,3.31063342349292e-06,"imbecile",0.21590323762775
"11228",11698,35,9,26,3.67541660847257e-06,"daft",0.472512217829403
"11229",11699,52,22,30,3.57994372328467e-06,"pages",0.405351228195675
"11230",11700,53,11,42,3.63092385226497e-06,"overwhelmed",0.441213514196915
"11231",11701,29,4,25,3.62300463019992e-06,"irk",0.435642688616736
"11232",11702,43,7,36,3.68924731976182e-06,"guru",0.482241516946072
"11233",11703,38,7,31,3.66829783643794e-06,"bauble",0.467504473757544
"11234",11704,73,26,47,3.76163284958735e-06,"testing",0.533161564126757
"11235",11705,39,5,34,3.63446050068328e-06,"intrusive",0.443701391328654
"11236",11706,38,8,30,3.53267013339362e-06,"purposeful",0.372096329965953
"11237",11707,26,4,22,3.33347778403731e-06,"jest",0.231973243878126
"11238",11708,44,10,34,3.68478845629472e-06,"tic",0.479104901953212
"11239",11709,34,6,28,3.68792756910254e-06,"zeal",0.48131313020912
"11240",11710,29,3,26,3.6246461439202e-06,"cushy",0.436797421562479
"11241",11711,47,4,43,3.58446064620657e-06,"convinced",0.408528685469923
"11242",11712,49,6,43,3.49319351244101e-06,"obliged",0.344326257600849
"11243",11713,44,7,37,3.70474652124302e-06,"satisfying",0.49314452577377
"11244",11714,48,3,45,3.74191279098049e-06,"daycare",0.519289367334287
"11245",11715,27,7,20,3.18978248873209e-06,"happenstance",0.130889902577448
"11246",11716,47,9,38,3.70881362469773e-06,"teddy bear",0.496005554770892
"11247",11717,40,4,36,3.64016264246687e-06,"feeding",0.447712598117512
"11248",11718,34,6,28,3.57523364151847e-06,"turncoat",0.402037892141664
"11249",11719,28,2,26,3.20461464508893e-06,"largely",0.141323674400377
"11250",11720,34,3,31,3.4593577356428e-06,"kindly",0.320524271829484
"11251",11721,27,7,20,3.35681988311553e-06,"disarray",0.248393387368465
"11252",11722,61,25,36,3.68549463023432e-06,"saving",0.479601664364274
"11253",11723,42,10,32,3.51816605040125e-06,"built",0.361893343373679
"11254",11724,30,4,26,3.54225556665462e-06,"rue",0.378839262083377
"11255",11725,32,3,29,3.5277599429914e-06,"wham",0.368642226258346
"11256",11727,43,6,37,3.43880137139399e-06,"viral",0.306063770677722
"11257",11728,37,5,32,3.54115172418677e-06,"subliminal",0.378062757294667
"11258",11729,50,18,32,3.55082112738571e-06,"uncouth",0.38486475858257
"11259",11730,37,9,28,3.47882958257524e-06,"evangelical",0.33422186258947
"11260",11731,38,2,36,3.63354928727931e-06,"solutions",0.443060392642401
"11261",11732,39,10,29,3.65400917887106e-06,"Zeus",0.45745302950884
"11262",11733,44,9,35,3.61566886258289e-06,"ragged",0.430482297664761
"11263",11735,40,7,33,3.52875583126901e-06,"lance",0.369342790006444
"11264",11736,29,3,26,3.36682198938778e-06,"bomber",0.255429430684257
"11265",11737,34,8,26,3.41934116134503e-06,"lifeless",0.292374365955158
"11266",11738,56,14,42,3.7120627190117e-06,"trained",0.498291150195289
"11267",11739,45,9,36,3.63300805801187e-06,"bothered",0.442679661577784
"11268",11740,38,5,33,3.77439675703831e-06,"lynch",0.542140413507003
"11269",11741,33,3,30,3.64142190242446e-06,"Noel",0.448598432297464
"11270",11742,48,9,39,3.74226287151315e-06,"move on",0.519535633643074
"11271",11743,37,2,35,3.65238098716553e-06,"gateway",0.456307668016505
"11272",11744,53,27,26,3.63822905562488e-06,"damaged",0.446352404533808
"11273",11745,38,9,29,3.55946622244528e-06,"viewpoint",0.390946203995432
"11274",11746,28,7,21,3.51057032725537e-06,"hoof",0.356550085102421
"11275",11747,36,7,29,3.47214988576627e-06,"drizzle",0.329522988691811
"11276",11748,67,25,42,3.57261519004526e-06,"accomplishment",0.400195926311235
"11277",11749,48,9,39,3.50819338565219e-06,"hamburgers",0.354878010878869
"11278",11750,46,14,32,3.54980014625177e-06,"huh",0.384146543109999
"11279",11751,35,2,33,3.54552094339221e-06,"subtitle",0.381136311479045
"11280",11752,35,3,32,3.45132254679993e-06,"enchant",0.314871868704568
"11281",11753,63,21,42,3.67082938719174e-06,"mental illness",0.469285308741204
"11282",11754,32,8,24,3.48568082317838e-06,"noob",0.339041410026634
"11283",11755,43,8,35,3.61289949636181e-06,"patriarchy",0.428534169924619
"11284",11756,51,6,45,3.73074469394836e-06,"mines",0.511433100630631
"11285",11758,33,3,30,3.46449927591965e-06,"divert",0.324141120032567
"11286",11759,72,21,51,3.72219058360226e-06,"robes",0.505415658975345
"11287",11760,34,2,32,3.57674258898936e-06,"dancefloor",0.403099370542053
"11288",11761,39,6,33,3.5324205558617e-06,"walking stick",0.371920763112584
"11289",11762,73,37,36,3.70644922164566e-06,"candles",0.494342300868411
"11290",11763,54,13,41,3.5159642356118e-06,"eject",0.360344463186821
"11291",11764,31,2,29,3.58605455106183e-06,"sherry",0.409649927666081
"11292",11765,44,4,40,3.68614672338418e-06,"social security",0.480060383310406
"11293",11766,50,5,45,3.67479531390102e-06,"deeply",0.472075164333035
"11294",11767,38,5,33,3.50500865737138e-06,"antibiotic",0.352637694137287
"11295",11768,38,4,34,3.54623761919791e-06,"sympathize",0.381640461492555
"11296",11769,33,3,30,3.47345240328172e-06,"implication",0.330439252667501
"11297",11770,33,3,30,3.51148254793174e-06,"upload",0.357191792360653
"11298",11771,37,7,30,3.60884455623843e-06,"needless",0.425681697297907
"11299",11772,41,10,31,3.61972605913184e-06,"quake",0.433336357587954
"11300",11773,32,8,24,3.64077228061616e-06,"ick",0.448141451831787
"11301",11774,35,6,29,3.56788617015963e-06,"beginnings",0.396869268120358
"11302",11776,39,4,35,3.54328476671013e-06,"dazzle",0.37956325920699
"11303",11777,43,5,38,3.62034197750319e-06,"meanness",0.433769629163146
"11304",11778,45,13,32,3.63304765468609e-06,"PhD",0.442707516102356
"11305",11779,46,7,39,3.64314651278016e-06,"congestion",0.449811620083644
"11306",11780,31,3,28,3.43177965229209e-06,"cartography",0.301124299089683
"11307",11781,40,8,32,3.51047173719204e-06,"taunt",0.356480731314613
"11308",11782,41,4,37,3.68459837877671e-06,"conditions",0.478971190751423
"11309",11784,36,8,28,3.51382690888647e-06,"seamstress",0.358840947526211
"11310",11785,35,7,28,3.34251410540952e-06,"vial",0.238329899852354
"11311",11786,49,17,32,3.40890884236865e-06,"pounds",0.285035686860567
"11312",11787,39,7,32,3.64345180624123e-06,"callous",0.450026380650837
"11313",11788,39,4,35,3.58737959857222e-06,"bad guy",0.410582040505601
"11314",11789,36,6,30,3.54656462018066e-06,"quark",0.381870492349687
"11315",11791,69,24,45,3.60226654611081e-06,"ghosts",0.421054355523099
"11316",11792,41,11,30,3.66539355330582e-06,"gummy",0.465461437884629
"11317",11793,40,4,36,3.56122819638037e-06,"vigilante",0.392185675421861
"11318",11794,43,4,39,3.61901866689828e-06,"denounce",0.432838738160494
"11319",11795,38,6,32,3.56749158963858e-06,"tops",0.39659169802041
"11320",11796,52,16,36,3.6485963849707e-06,"hearts",0.453645366272145
"11321",11797,38,3,35,3.58275262884474e-06,"wonderland",0.407327170127573
"11322",11798,50,6,44,3.5474956454491e-06,"swelling",0.382525427814128
"11323",11799,47,8,39,3.6673830288183e-06,"shoddy",0.466860946698122
"11324",11800,35,5,30,3.48685976896067e-06,"omnipotent",0.339870746704866
"11325",11801,39,6,33,3.49953806097595e-06,"hot chocolate",0.348789369379103
"11326",11803,38,7,31,3.62615765083003e-06,"White House",0.437860700415971
"11327",11804,58,15,43,3.80730469478742e-06,"possessive",0.565289705179563
"11328",11805,39,5,34,3.48682329476907e-06,"limitation",0.339845088709935
"11329",11806,25,3,22,3.30381921501255e-06,"litigation",0.211109740665644
"11330",11807,47,6,41,3.6010731197897e-06,"goats",0.420214832420562
"11331",11808,38,2,36,3.52677705478848e-06,"buzzer",0.36795080749293
"11332",11809,43,8,35,3.57912368735639e-06,"heredity",0.404774368866764
"11333",11810,39,10,29,3.57766392856121e-06,"dalmatian",0.403747492543524
"11334",11811,44,8,36,3.46794749527492e-06,"Spock",0.326566791194785
"11335",11812,43,4,39,3.62763093933876e-06,"guiding",0.438897094299611
"11336",11813,29,4,25,3.32978156632925e-06,"operating system",0.229373116745837
"11337",11814,32,3,29,3.52115155740533e-06,"plotting",0.36399351668004
"11338",11815,34,7,27,3.50467699144508e-06,"poof",0.352404381696857
"11339",11816,34,8,26,3.55798447295576e-06,"toot",0.389903858182694
"11340",11817,55,24,31,3.66593103650534e-06,"ow",0.465839533754681
"11341",11818,43,10,33,3.46337138424027e-06,"New Orleans",0.323347697677754
"11342",11819,41,3,38,3.60684001139761e-06,"insertion",0.424271587872499
"11343",11820,30,12,18,3.29055610398157e-06,"snoop",0.20177972344966
"11344",11822,49,8,41,3.60246120149286e-06,"overthrow",0.421191287051565
"11345",11823,28,6,22,3.53481795687522e-06,"Parmesan",0.373607229634468
"11346",11824,40,2,38,3.53425577409037e-06,"sowing",0.373211758688856
"11347",11825,31,4,27,3.47885378725418e-06,"lay down",0.33423888952008
"11348",11826,34,3,31,3.66891693572058e-06,"theme park",0.467939982964391
"11349",11827,42,2,40,3.71915887502882e-06,"sedate",0.503282984890212
"11350",11828,29,2,27,3.672851749012e-06,"amok",0.470707951630637
"11351",11829,43,12,31,3.41649071739472e-06,"pimples",0.29036920358658
"11352",11830,46,10,36,3.51929276292636e-06,"Native Americans",0.362685936245158
"11353",11831,25,3,22,3.45534143956435e-06,"bonkers",0.317698983594401
"11354",11832,36,8,28,3.54742013870413e-06,"valiant",0.382472312128914
"11355",11833,32,5,27,3.45435075477564e-06,"lewd",0.317002080272647
"11356",11834,45,12,33,3.73325169956284e-06,"ladies",0.513196669184721
"11357",11835,56,21,35,3.66059008712204e-06,"rolling",0.462082409986399
"11358",11836,47,12,35,3.60021745313417e-06,"laborer",0.419612908436923
"11359",11837,39,14,25,3.39745462699346e-06,"obtuse",0.276978148444695
"11360",11838,33,3,30,3.60625468813109e-06,"heady",0.423859838612406
"11361",11839,24,4,20,3.32900562601951e-06,"bicep",0.228827276751619
"11362",11841,53,10,43,3.70235988419018e-06,"gunpowder",0.491465631226388
"11363",11842,43,11,32,3.48844105057891e-06,"nations",0.340983109007119
"11364",11843,32,5,27,3.55378655957923e-06,"pitiful",0.386950810139688
"11365",11844,33,4,29,3.58983931879209e-06,"existing",0.412312345857359
"11366",11845,29,4,25,3.35231863118126e-06,"befuddled",0.245226953947063
"11367",11846,26,2,24,3.47217399758337e-06,"stunted",0.329539950298187
"11368",11847,49,5,44,3.58175169148224e-06,"flinch",0.406623054569581
"11369",11848,49,9,40,3.66712750235613e-06,"old people",0.466681195033103
"11370",11849,40,9,31,3.68215627071213e-06,"unsuccessful",0.47725327477887
"11371",11850,47,12,35,3.57972586459329e-06,"ho",0.405197974156221
"11372",11851,33,5,28,3.44740806624539e-06,"wrecked",0.312118203227428
"11373",11852,43,9,34,3.67333744747127e-06,"historic",0.471049619205929
"11374",11853,45,10,35,3.61736915975749e-06,"vertigo",0.431678382193818
"11375",11854,74,31,43,3.69336228929368e-06,"houses",0.485136217630234
"11376",11855,43,10,33,3.68804998045334e-06,"snow white",0.481399241228447
"11377",11856,43,4,39,3.64473991135993e-06,"based",0.450932506137182
"11378",11857,19,3,16,3.38482784765567e-06,"talc",0.268095762680993
"11379",11858,31,3,28,3.4481450703594e-06,"iced",0.312636653314732
"11380",11859,43,7,36,3.59106399635148e-06,"misguided",0.413173852836108
"11381",11860,42,6,36,3.5414276203023e-06,"cramped",0.378256838117909
"11382",11861,48,2,46,3.81337350086754e-06,"Tea Party",0.569558844228143
"11383",11862,42,2,40,3.61139901986631e-06,"golfer",0.42747865048408
"11384",11863,47,13,34,3.59713524149367e-06,"tasks",0.417444707657939
"11385",11864,25,2,23,3.29605495182816e-06,"fanny",0.205647921865316
"11386",11865,37,6,31,3.48254894722545e-06,"plunge",0.336838272580909
"11387",11867,37,6,31,3.57114798123005e-06,"needing",0.399163809225473
"11388",11868,42,4,38,3.66538011824516e-06,"mannerism",0.465451986908389
"11389",11869,32,3,29,3.55049334104974e-06,"fleck",0.384634175263874
"11390",11870,34,5,29,3.59275413346363e-06,"carbonation",0.414362790206603
"11391",11871,42,4,38,3.51048406064712e-06,"race car",0.356489400325057
"11392",11874,26,3,23,3.52778483334744e-06,"larceny",0.368659735532744
"11393",11875,32,8,24,3.56713526933655e-06,"covet",0.39634104230739
"11394",11876,45,15,30,3.60655382961918e-06,"covert",0.424070271536277
"11395",11877,36,2,34,3.46401923223478e-06,"emphatic",0.323803430343184
"11396",11878,38,9,29,3.53624295403591e-06,"Gemini",0.374609652671637
"11397",11879,38,2,36,3.49068162540099e-06,"graves",0.342559255177872
"11398",11880,37,5,32,3.58565594196974e-06,"outward",0.409369523643004
"11399",11881,36,7,29,3.52876828343067e-06,"salve",0.369351549556324
"11400",11882,55,18,37,3.72004434292857e-06,"actors",0.503905872742806
"11401",11883,44,4,40,3.57497801388521e-06,"turn away",0.401858069307216
"11402",11884,41,6,35,3.63105569313222e-06,"disposition",0.441306258467724
"11403",11885,29,5,24,3.43084951264783e-06,"fang",0.300469986623028
"11404",11886,39,8,31,3.47876907235144e-06,"conservation",0.33417929629952
"11405",11887,60,13,47,3.55338246476821e-06,"rotting",0.38666654715381
"11406",11888,42,2,40,3.67127411568185e-06,"David Bowie",0.469598155739124
"11407",11890,43,12,31,3.56231921229998e-06,"stunning",0.392953157296142
"11408",11891,33,9,24,3.50094700616517e-06,"Soviet",0.349780500557984
"11409",11892,37,6,31,3.46884972942972e-06,"Mardi Gras",0.327201473372855
"11410",11893,38,5,33,3.62838119772863e-06,"hexagon",0.439424868188983
"11411",11894,27,4,23,3.367241454783e-06,"bogus",0.255724506202345
"11412",11895,35,8,27,3.5200360451691e-06,"red light",0.363208802720822
"11413",11896,39,2,37,3.65571900681426e-06,"crockery",0.458655818515823
"11414",11897,48,12,36,3.61440122022185e-06,"wrapped",0.429590566831432
"11415",11898,35,6,29,3.50953540770273e-06,"wrongdoing",0.355822064563294
"11416",11899,41,10,31,3.49625900286693e-06,"supplement",0.346482695738364
"11417",11900,42,9,33,3.61441428416525e-06,"cracked",0.42959975674295
"11418",11901,45,7,38,3.57479909629079e-06,"motto",0.401732208622469
"11419",11902,33,5,28,3.62860501908646e-06,"big bang",0.439582316702908
"11420",11903,43,7,36,3.50230802098583e-06,"surpass",0.350737914823635
"11421",11904,37,5,32,3.53448062574445e-06,"benevolent",0.373369931971029
"11422",11905,26,4,22,3.65248770937886e-06,"steed",0.456382742415364
"11423",11906,43,4,39,3.41051324813871e-06,"baking soda",0.286164315989975
"11424",11907,44,11,33,3.39825125990165e-06,"Nintendo",0.277538544774858
"11425",11908,41,2,39,3.54954814252146e-06,"brutish",0.383969269532421
"11426",11909,38,5,33,3.58054617651377e-06,"bulk",0.405775027633541
"11427",11910,28,2,26,3.35697764588586e-06,"amino acid",0.248504366561788
"11428",11911,24,5,19,3.2047584253099e-06,"thee",0.141424817483161
"11429",11912,41,9,32,3.60230547550432e-06,"discord",0.421081740644946
"11430",11913,42,6,36,3.69193054740254e-06,"look up",0.484129049970853
"11431",11914,33,5,28,3.35442146293029e-06,"gizmo",0.246706203903951
"11432",11915,27,4,23,3.3460483169377e-06,"axle",0.240816062738704
"11433",11916,37,6,31,3.33567942786426e-06,"ruse",0.233522003800363
"11434",11917,45,3,42,3.53810718341901e-06,"refine",0.375921056323333
"11435",11918,48,11,37,3.512592644631e-06,"aimless",0.357972696727008
"11436",11919,18,2,16,3.43253355301548e-06,"repudiate",0.301654635201021
"11437",11920,53,11,42,3.4424000413088e-06,"bonds",0.308595277213513
"11438",11921,41,4,37,3.49151039248068e-06,"disapproval",0.343142256489065
"11439",11923,42,3,39,3.69957935782702e-06,"threatening",0.489509652815497
"11440",11924,44,6,38,3.59268959521166e-06,"burned",0.414317390375407
"11441",11925,39,6,33,3.48303414070065e-06,"realization",0.337179584922038
"11442",11926,51,14,37,3.66249386532278e-06,"ended",0.463421634497658
"11443",11927,38,2,36,3.47221016593692e-06,"hernia",0.329565393149459
"11444",11928,47,11,36,3.6241863701599e-06,"condescending",0.436473990876492
"11445",11929,26,3,23,3.31336478820972e-06,"catsup",0.217824632975448
"11446",11930,50,10,40,3.57432632884517e-06,"stretchy",0.401399637448446
"11447",11931,39,8,31,3.55339509134002e-06,"feat",0.386675429393585
"11448",11932,31,3,28,3.40382658184331e-06,"pseudoscience",0.281460539364119
"11449",11933,40,6,34,3.5445155710569e-06,"loopy",0.380429076112094
"11450",11934,44,3,41,3.5974069890423e-06,"line up",0.417635870146223
"11451",11935,32,4,28,3.54743272293841e-06,"underling",0.382481164586096
"11452",11936,42,9,33,3.63395861647928e-06,"emphasize",0.443348337791453
"11453",11937,32,6,26,3.43203876830993e-06,"sabbath",0.301306575849769
"11454",11938,46,6,40,3.60635873171576e-06,"eyed",0.423933028713422
"11455",11939,34,4,30,3.50856264714035e-06,"ritzy",0.355137770149046
"11456",11940,31,5,26,3.50841493321732e-06,"propriety",0.355033859879304
"11457",11941,52,12,40,3.61892698814801e-06,"stately",0.432774246178457
"11458",11942,45,7,38,3.55875685505539e-06,"spotty",0.390447195132076
"11459",11943,41,5,36,3.46894599544874e-06,"nunnery",0.327269192297374
"11460",11944,47,14,33,3.49480497240851e-06,"sheen",0.345459849048933
"11461",11945,36,6,30,3.63891749482364e-06,"overhead",0.446836691332098
"11462",11946,34,4,30,3.3768154604119e-06,"instantaneous",0.262459399481528
"11463",11948,41,7,34,3.50263923866634e-06,"gallant",0.350970911942798
"11464",11949,32,4,28,3.44010265266316e-06,"starved",0.306979165008344
"11465",11950,41,6,35,3.51253095417903e-06,"chocolate bar",0.357929300198277
"11466",11951,37,7,30,3.47146283972603e-06,"pamphlet",0.32903968191947
"11467",11952,38,9,29,3.50151090195419e-06,"seesaw",0.350177176526943
"11468",11953,48,13,35,3.57338116899592e-06,"circles",0.400734758925993
"11469",11954,36,4,32,3.50963394517952e-06,"illumination",0.355891381358782
"11470",11955,59,17,42,3.54770959868309e-06,"put together",0.382675934535509
"11471",11956,26,2,24,3.44309934030217e-06,"toothpick",0.309087203401267
"11472",11957,39,4,35,3.55362238497813e-06,"prying",0.386835320504477
"11473",11958,47,3,44,3.69104478713745e-06,"sweatpants",0.48350595645205
"11474",11959,51,11,40,3.825627881176e-06,"unskilled",0.578179263598985
"11475",11960,28,5,23,3.38457581111359e-06,"ravenous",0.267918466021776
"11476",11961,33,9,24,3.51158119478039e-06,"months",0.357261186094449
"11477",11962,49,6,43,3.71985061079947e-06,"soften",0.50376959068232
"11478",11963,47,3,44,3.53842016616421e-06,"exploring",0.376141225964842
"11479",11964,59,16,43,3.59946583926945e-06,"decrepit",0.419084181030419
"11480",11966,33,4,29,3.35299304924541e-06,"tuberculosis",0.245701377491781
"11481",11967,51,11,40,3.73707439393996e-06,"decisions",0.515885767109536
"11482",11968,39,8,31,3.42209096602206e-06,"sameness",0.294308733006548
"11483",11969,33,4,29,3.46435524884464e-06,"withdrawal",0.324039803298784
"11484",11970,36,4,32,3.71611829147745e-06,"hypocritical",0.501144067647142
"11485",11972,55,24,31,3.60160487513236e-06,"songs",0.420588898994396
"11486",11973,41,12,29,3.52359575900014e-06,"Hamlet",0.365712905359337
"11487",11974,51,17,34,3.66358071051484e-06,"embarrassment",0.46418618244794
"11488",11975,26,5,21,3.29334119344098e-06,"guacamole",0.203738911798731
"11489",11976,46,5,41,3.58401101008182e-06,"cleansing",0.408212386166165
"11490",11977,37,6,31,3.56018854758548e-06,"assortment",0.39145432806812
"11491",11978,34,4,30,3.6590631334753e-06,"parish",0.461008265030603
"11492",11979,41,13,28,3.38824549871586e-06,"brains",0.270499930387596
"11493",11980,34,4,30,3.38486221918337e-06,"oddity",0.268119941544039
"11494",11981,35,3,32,3.47843025399498e-06,"migrate",0.333940952438
"11495",11982,37,12,25,3.58370275335883e-06,"aide",0.407995541074105
"11496",11983,34,9,25,3.49116908779243e-06,"cheery",0.342902163602119
"11497",11984,31,3,28,3.46604832364573e-06,"corps",0.325230807204673
"11498",11985,40,8,32,3.54067527758894e-06,"bosom",0.377727597998338
"11499",11986,39,9,30,3.52308678771993e-06,"Elvis",0.365354866374685
"11500",11987,49,13,36,3.61124252021393e-06,"resting",0.427368559838865
"11501",11988,39,5,34,3.61721214225772e-06,"gatherer",0.43156792726566
"11502",11989,28,3,25,3.48282791695545e-06,"budge",0.337034515557202
"11503",11990,40,12,28,3.55184269599068e-06,"William",0.385583387315258
"11504",11991,44,10,34,3.64746519406339e-06,"admiration",0.452849623055099
"11505",11992,32,6,26,3.34093953901716e-06,"calamity",0.237222261417138
"11506",11993,44,6,38,3.5424312414096e-06,"tempt",0.378962841572727
"11507",11994,39,5,34,3.33965641614791e-06,"crypt",0.236319640724873
"11508",11995,45,4,41,3.60412311684567e-06,"restrictive",0.422360371651476
"11509",11996,50,5,45,3.76508859253458e-06,"inspirational",0.535592527806123
"11510",11997,33,3,30,3.52079203737673e-06,"intrepid",0.363740610099635
"11511",11998,35,3,32,3.59465259479998e-06,"sprawl",0.415698274536833
"11512",11999,47,9,38,3.47573416194836e-06,"whiteboard",0.332044369867586
"11513",12000,35,8,27,3.45347989902025e-06,"flavorful",0.316389471423074
"11514",12001,42,2,40,3.58021287945781e-06,"watcher",0.405540567764901
"11515",12002,35,3,32,3.47804311382244e-06,"kiosk",0.33366861629708
"11516",12003,62,21,41,3.66286949196e-06,"tests",0.463685871371187
"11517",12004,39,6,33,3.4827793972702e-06,"indecent",0.337000384085508
"11518",12005,80,47,33,3.65838043498143e-06,"boxes",0.460528016566554
"11519",12007,35,5,30,3.52368267123336e-06,"ramble",0.365774044305567
"11520",12008,26,3,23,3.31177368663335e-06,"pinky",0.216705362763108
"11521",12009,36,8,28,3.56585056233463e-06,"game show",0.39543730724724
"11522",12010,46,6,40,3.74597775638408e-06,"oppressive",0.522148892306163
"11523",12011,45,13,32,3.65424952677469e-06,"July",0.457622103723287
"11524",12012,38,7,31,3.28257380046547e-06,"Aries",0.196164522833871
"11525",12014,57,17,40,3.68150558852548e-06,"unthinking",0.476795548383505
"11526",12015,43,8,35,3.59963427715744e-06,"untrained",0.41920266970107
"11527",12016,33,3,30,3.53603038157304e-06,"subdue",0.374460117262212
"11528",12017,42,5,37,3.65929075626562e-06,"repression",0.461168387685645
"11529",12018,32,6,26,3.4619805298215e-06,"retina",0.322369292562861
"11530",12019,33,4,29,3.6715032602949e-06,"sweeping",0.469759348929749
"11531",12020,33,7,26,3.59959540547642e-06,"quarry",0.419175325177432
"11532",12021,48,14,34,3.59154120216067e-06,"iPod",0.413509546204349
"11533",12023,44,8,36,3.58914355856406e-06,"snide",0.411822909035893
"11534",12025,37,5,32,3.51312327198249e-06,"dildo",0.358345969808497
"11535",12026,40,9,31,3.44713474160278e-06,"howdy",0.311925931322655
"11536",12027,50,11,39,3.65809939787684e-06,"gems",0.460330319282857
"11537",12028,38,7,31,3.61444041233536e-06,"advert",0.429618136765283
"11538",12029,51,6,45,3.65654778010984e-06,"services",0.459238824199623
"11539",12030,33,7,26,3.56233190246335e-06,"soaked",0.392962084269799
"11540",12031,61,7,54,3.76460667389471e-06,"activist",0.535253519168089
"11541",12032,48,7,41,3.54906943399441e-06,"mobile phone",0.38363251906804
"11542",12033,33,3,30,3.58758551906981e-06,"tactless",0.410726896549039
"11543",12036,28,2,26,3.5827269567959e-06,"fish tank",0.407309110966556
"11544",12037,37,4,33,3.62631544592801e-06,"curler",0.437971702350385
"11545",12038,45,3,42,3.61441428416525e-06,"physicist",0.42959975674295
"11546",12040,30,4,26,3.35782305615623e-06,"oaf",0.249099075628067
"11547",12041,55,10,45,3.77028412861193e-06,"wars",0.539247359687927
"11548",12042,41,6,35,3.58456343601913e-06,"unsympathetic",0.408600993597224
"11549",12043,45,2,43,3.5543549734312e-06,"robotics",0.387350664367874
"11550",12044,35,4,31,3.34987052750411e-06,"mix up",0.243504820323894
"11551",12045,36,8,28,3.66489652164671e-06,"downtrodden",0.465111797900049
"11552",12046,41,11,30,3.53968518040006e-06,"ways",0.377031108027302
"11553",12047,35,4,31,3.34311752395344e-06,"Robert",0.238754378346879
"11554",12048,34,4,30,3.56155796791749e-06,"smitten",0.392417655242543
"11555",12049,35,4,31,3.51793089376552e-06,"gruff",0.361727920988642
"11556",12052,40,4,36,3.69413998574062e-06,"nationalism",0.485683292989988
"11557",12053,39,9,30,3.56181167989286e-06,"rowdy",0.392596130495643
"11558",12054,46,4,42,3.73710232559878e-06,"overpowering",0.515905415807118
"11559",12055,39,8,31,3.58546309841379e-06,"Dorothy",0.409233866654773
"11560",12056,63,33,30,3.59142511339925e-06,"soldiers",0.41342788284949
"11561",12057,28,2,26,3.62665738242377e-06,"hokey",0.438212239686213
"11562",12058,52,11,41,3.54021149223455e-06,"dire",0.377401345331756
"11563",12060,46,15,31,3.51223487017024e-06,"possessions",0.357721018077062
"11564",12061,52,13,39,3.57661466268947e-06,"nail polish",0.40300937999779
"11565",12062,46,9,37,3.69037734108313e-06,"appealing",0.483036437410627
"11566",12063,47,13,34,3.44238819123155e-06,"thorns",0.30858694120362
"11567",12064,45,3,42,3.7459216278277e-06,"specialty",0.52210940832717
"11568",12065,45,6,39,3.6027726938652e-06,"resilience",0.4214104082811
"11569",12066,37,4,33,3.47130618309057e-06,"apprehension",0.328929480843537
"11570",12067,36,7,29,3.48110629558074e-06,"crows",0.33582343038812
"11571",12068,34,4,30,3.28181970338914e-06,"sender",0.195634048596847
"11572",12070,44,8,36,3.52676461667595e-06,"bookish",0.367942057825997
"11573",12071,86,42,44,3.72630998427497e-06,"walls",0.508313476772854
"11574",12072,38,4,34,3.65206085794214e-06,"setback",0.456082471140851
"11575",12073,40,7,33,3.57681934916195e-06,"minion",0.403153367958658
"11576",12074,48,2,46,3.70774102170512e-06,"bazaar",0.495251025583611
"11577",12075,37,3,34,3.57985401355333e-06,"incorporate",0.405288121332141
"11578",12076,45,3,42,3.73227635267026e-06,"foyer",0.512510555400552
"11579",12077,50,14,36,3.63246698995623e-06,"clues",0.442299043918595
"11580",12078,39,3,36,3.63701168571855e-06,"imprison",0.445496038168645
"11581",12079,35,2,33,3.4178569353444e-06,"interject",0.291330278025414
"11582",12080,32,7,25,3.48202751498142e-06,"taker",0.336471467854446
"11583",12081,26,5,21,3.51645878534481e-06,"unlike",0.360692357245189
"11584",12082,34,4,30,3.45936970284014e-06,"carried",0.320532690228227
"11585",12083,53,15,38,3.60756867908873e-06,"figure out",0.424784173651728
"11586",12084,49,12,37,3.57151785937506e-06,"flighty",0.399424002286716
"11587",12085,26,2,24,3.37424037413577e-06,"superego",0.26064793916631
"11588",12086,37,3,34,3.37266990667822e-06,"literate",0.259543184152057
"11589",12087,47,7,40,3.62852602016009e-06,"goes",0.439526744421158
"11590",12088,43,12,31,3.63973866676373e-06,"supple",0.447414349795515
"11591",12089,35,9,26,3.5599604132402e-06,"tons",0.391293845556588
"11592",12090,51,14,37,3.56446513418429e-06,"shots",0.394462719274326
"11593",12091,47,4,43,3.70724618339005e-06,"dominance",0.494902928520421
"11594",12092,54,15,39,3.58408808254872e-06,"included",0.408266603268118
"11595",12093,32,2,30,3.60742552470004e-06,"correctness",0.424683470814524
"11596",12094,42,12,30,3.46703370996876e-06,"pots",0.325923983288083
"11597",12095,50,10,40,3.48413845966239e-06,"sentences",0.337956424903314
"11598",12097,40,2,38,3.59351585998225e-06,"entitlement",0.414898631421833
"11599",12098,35,5,30,3.54977494426853e-06,"piss off",0.384128814619535
"11600",12099,51,5,46,3.70600966527321e-06,"defensive",0.494033092228535
"11601",12100,39,11,28,3.39622000713206e-06,"inept",0.276109647492309
"11602",12101,51,20,31,3.5952470833558e-06,"upper class",0.41611647117619
"11603",12102,40,5,35,3.43241573419373e-06,"unpaid",0.301571754824556
"11604",12103,45,6,39,3.52683924666714e-06,"gemstone",0.367994556753356
"11605",12104,24,2,22,3.56455407428531e-06,"Davidson",0.394525284736663
"11606",12105,25,2,23,3.42792110296789e-06,"unafraid",0.298409978781323
"11607",12107,33,5,28,3.54085079562917e-06,"godless",0.37785106724573
"11608",12108,38,6,32,3.56379187455453e-06,"flawed",0.39398911063742
"11609",12109,40,4,36,3.57290877649312e-06,"gong",0.400402451507809
"11610",12110,67,22,45,3.76985772556944e-06,"hateful",0.538947403839097
"11611",12111,45,3,42,3.69962041894502e-06,"pains",0.489538537512079
"11612",12112,27,6,21,3.5062744781787e-06,"impoverished",0.353528143587423
"11613",12113,39,4,35,3.63237462858969e-06,"chastise",0.44223407174594
"11614",12115,36,6,30,3.63288927316784e-06,"exhausting",0.442596101646996
"11615",12116,33,5,28,3.33989065198005e-06,"amongst",0.236484415364957
"11616",12117,41,2,39,3.54597354703734e-06,"sore throat",0.381454698303311
"11617",12118,35,12,23,3.32778702163062e-06,"Beethoven",0.227970041982093
"11618",12119,32,4,28,3.46882566375979e-06,"cleave",0.327184544228989
"11619",12120,36,5,31,3.48723671362812e-06,"snoopy",0.340135910754881
"11620",12122,40,3,37,3.58840943751682e-06,"outlandish",0.411306487059682
"11621",12123,26,4,22,3.5168050529455e-06,"livid",0.360935941323484
"11622",12125,36,7,29,3.37862949273257e-06,"Tolkien",0.26373549170021
"11623",12126,56,10,46,3.62538202463085e-06,"trickster",0.437315081384763
"11624",12127,56,13,43,3.68196646464944e-06,"snacks",0.477119754534001
"11625",12128,46,5,41,3.64616186770996e-06,"slow down",0.451932790097345
"11626",12129,47,14,33,3.55498675767433e-06,"stuffing",0.387795096888376
"11627",12130,55,9,46,3.81155663973167e-06,"ambitious",0.568280762061962
"11628",12131,46,3,43,3.61186860022032e-06,"developer",0.42780897967887
"11629",12132,37,3,34,3.5201599560684e-06,"slayer",0.363295968606791
"11630",12133,46,12,34,3.54640111215139e-06,"ostentatious",0.38175547161854
"11631",12134,31,3,28,3.39542432617804e-06,"baritone",0.275549920820182
"11632",12135,51,14,37,3.61599571866107e-06,"unbalanced",0.43071222658788
"11633",12136,42,6,36,3.68692138377533e-06,"deserving",0.480605322938006
"11634",12137,30,3,27,3.45792227282315e-06,"Dennis",0.319514486660006
"11635",12138,47,5,42,3.50095926283802e-06,"nervousness",0.349789122590057
"11636",12139,43,2,41,3.55230953404356e-06,"guessing",0.385911787421406
"11637",12140,33,5,28,3.48184565674573e-06,"newt",0.33634353855747
"11638",12141,53,14,39,3.53253286138694e-06,"overalls",0.371999765126631
"11639",12142,50,8,42,3.71225564077245e-06,"kidnapping",0.498426862197163
"11640",12143,37,6,31,3.60190324567501e-06,"abduction",0.42079878959195
"11641",12144,36,2,34,3.67786330853228e-06,"roast beef",0.474233364069231
"11642",12145,53,6,47,3.78948644879646e-06,"memorable",0.552755350195581
"11643",12146,41,5,36,3.69063611804131e-06,"dingy",0.483218475657104
"11644",12147,40,5,35,3.48489125396842e-06,"footpath",0.338485982698539
"11645",12148,44,5,39,3.55106070183164e-06,"spunk",0.385033288703429
"11646",12149,49,9,40,3.6284206936089e-06,"spiny",0.439452651809431
"11647",12150,47,9,38,3.6318337491783e-06,"pedestal",0.441853586789709
"11648",12151,57,12,45,3.75812694952835e-06,"grounded",0.530695317117928
"11649",12152,33,3,30,3.69506819248349e-06,"reliant",0.486336245745248
"11650",12153,39,9,30,3.58078977899365e-06,"longevity",0.405946391299721
"11651",12154,34,6,28,3.56291574773131e-06,"fiend",0.393372793822695
"11652",12156,63,27,36,3.72775462427961e-06,"exams",0.509329717689687
"11653",12157,41,5,36,3.46753863704926e-06,"assimilate",0.326279177355515
"11654",12158,34,8,26,3.61756545080292e-06,"sect",0.431816464339772
"11655",12159,31,3,28,3.54297092283764e-06,"hankie",0.379342483800174
"11656",12160,53,16,37,3.63105569313222e-06,"forced",0.441306258467724
"11657",12162,33,3,30,3.66636113657195e-06,"pedantic",0.466142090297916
"11658",12163,34,4,30,3.35893964993131e-06,"credible",0.249884550402453
"11659",12164,33,9,24,3.57274283039833e-06,"healthcare",0.400285715704442
"11660",12165,27,6,21,3.37249929177515e-06,"Chevy",0.259423164046723
"11661",12166,31,6,25,3.37496920340602e-06,"permitted",0.261160638609376
"11662",12167,65,21,44,3.67974447854341e-06,"trains",0.475556684710148
"11663",12168,32,3,29,3.53052491844487e-06,"prostate",0.370587265285949
"11664",12169,48,13,35,3.74698835810717e-06,"tiresome",0.522859806318185
"11665",12170,45,13,32,3.56206542801778e-06,"beaches",0.392774631178364
"11666",12171,40,5,35,3.61697664156485e-06,"Celtic",0.431402262851502
"11667",12172,27,4,23,3.49323012002739e-06,"loathing",0.344352009433157
"11668",12173,35,3,32,3.5770624447791e-06,"ostracize",0.403324375069117
"11669",12174,23,4,19,3.14004276738249e-06,"nonetheless",0.09590018897059
"11670",12175,38,3,35,3.45122725641238e-06,"assassination",0.31480483609402
"11671",12176,39,6,33,3.54477942610021e-06,"digestive",0.380614686568858
"11672",12177,50,13,37,3.49534245617714e-06,"meh",0.345837945319325
"11673",12178,34,3,31,3.5160013220165e-06,"wetland",0.36037055184683
"11674",12179,61,16,45,3.62120723806903e-06,"monkeys",0.434378302042131
"11675",12180,40,3,37,3.55230953404356e-06,"illuminated",0.385911787421406
"11676",12182,55,19,36,3.67981218238621e-06,"spinning",0.475604311395731
"11677",12183,61,17,44,3.75471216376553e-06,"Russian",0.528293165022415
"11678",12184,40,15,25,3.62568434792067e-06,"Ikea",0.43752775256668
"11679",12185,45,10,35,3.68731563421829e-06,"firing",0.480882660842483
"11680",12186,65,21,44,3.76847968224179e-06,"outlook",0.537978010765235
"11681",12187,45,6,39,3.41779852761239e-06,"waterproof",0.291289190746276
"11682",12188,47,10,37,3.5861317114455e-06,"innovative",0.409704206613632
"11683",12189,43,3,40,3.7285885800789e-06,"birdie",0.509916369037666
"11684",12190,42,8,34,3.60032114864646e-06,"taller",0.419685853684281
"11685",12191,36,2,34,3.57639720897962e-06,"ice hockey",0.402856410845087
"11686",12192,41,8,33,3.46805573859183e-06,"monetary",0.326642935623338
"11687",12193,59,12,47,3.59547976284215e-06,"sneer",0.416280150995231
"11688",12194,30,4,26,3.51151953985048e-06,"afar",0.357217814553931
"11689",12195,48,18,30,3.5552774538525e-06,"typical",0.387999588906924
"11690",12196,35,8,27,3.42834417832875e-06,"clapping",0.298707593751991
"11691",12197,59,13,46,3.6338397694692e-06,"breathless",0.443264734129579
"11692",12198,39,4,35,3.62903957467656e-06,"hairless",0.439888007511608
"11693",12199,55,16,39,3.59101241412992e-06,"bushes",0.413137567004368
"11694",12200,40,8,32,3.52049455907566e-06,"horrifying",0.363531347154925
"11695",12201,38,7,31,3.54938435928288e-06,"Dante",0.383854055203594
"11696",12202,32,5,27,3.37695230054875e-06,"derelict",0.262555660519355
"11697",12203,43,6,37,3.65316821013024e-06,"fleeting",0.456861444863908
"11698",12204,46,10,36,3.55371078480149e-06,"witchcraft",0.386897505905167
"11699",12205,43,8,35,3.62773622004397e-06,"shades",0.438971154660702
"11700",12206,36,6,30,3.63336445915553e-06,"pushover",0.442930374159349
"11701",12207,45,6,39,3.72921429184085e-06,"lovable",0.51035652983385
"11702",12208,29,3,26,3.48480624477279e-06,"resin",0.338426182455829
"11703",12209,29,2,27,3.39186562785129e-06,"highness",0.273046532544417
"11704",12210,54,12,42,3.6536754147835e-06,"failing",0.457218241103941
"11705",12212,49,10,39,3.49512255647244e-06,"rejected",0.345683255516468
"11706",12214,52,12,40,3.61983088150122e-06,"epidemic",0.433410095529872
"11707",12215,54,5,49,3.67451174925132e-06,"salesperson",0.471875689032154
"11708",12216,41,13,28,3.50445591569681e-06,"sails",0.352248864598898
"11709",12217,49,16,33,3.68028617905328e-06,"actions",0.475937747273163
"11710",12219,44,6,38,3.77001406215245e-06,"slacker",0.539057379772164
"11711",12220,32,2,30,3.34990419274009e-06,"lymph",0.243528502341673
"11712",12221,43,6,37,3.70238729933061e-06,"mace",0.491484916575923
"11713",12222,37,12,25,3.45511460615149e-06,"nemesis",0.317539416231794
"11714",12223,55,10,45,3.47445407640325e-06,"carbon dioxide",0.331143885799712
"11715",12224,43,6,37,3.31588074766479e-06,"chicken pox",0.219594500163897
"11716",12225,43,10,33,3.68320055395336e-06,"waving",0.477987882262463
"11717",12226,51,8,43,3.57724158901071e-06,"greatness",0.403450395183193
"11718",12227,46,7,39,3.69014583456338e-06,"oppress",0.482873582722177
"11719",12228,32,4,28,3.60927439147634e-06,"count on",0.425984067545758
"11720",12229,52,4,48,3.64668042680748e-06,"wrestler",0.452297573691186
"11721",12230,40,9,31,3.64565674683466e-06,"fall apart",0.45157745970377
"11722",12231,34,5,29,3.60521458237194e-06,"elbows",0.423128169804336
"11723",12232,43,3,40,3.55483510897347e-06,"marital",0.38768841867491
"11724",12233,28,6,22,3.54151541444584e-06,"misuse",0.378318597449398
"11725",12234,32,6,26,3.42018318501139e-06,"inattentive",0.292966692693962
"11726",12235,52,16,36,3.49787329303783e-06,"unfaithful",0.347618278110472
"11727",12236,31,5,26,3.44007898421348e-06,"trite",0.306962515291513
"11728",12237,41,5,36,3.46566393456827e-06,"prosecution",0.324960406338542
"11729",12239,29,4,25,3.4697885510857e-06,"intrigued",0.327861893254174
"11730",12240,33,7,26,3.39269417236922e-06,"full stop",0.273629377293169
"11731",12241,32,3,29,3.34297223661557e-06,"speed up",0.238652175073427
"11732",12242,50,17,33,3.50777498325037e-06,"redundant",0.354583683130045
"11733",12244,27,2,25,3.35595245286565e-06,"matey",0.247783188211859
"11734",12245,51,6,45,3.70333337036667e-06,"hooligan",0.49215043607835
"11735",12246,49,5,44,3.58772710312563e-06,"exclusion",0.410826494725906
"11736",12247,47,11,36,3.51055800319461e-06,"OCD",0.356541415665908
"11737",12248,38,4,34,3.5312854232069e-06,"resentment",0.371122247048974
"11738",12249,61,13,48,3.59290903472906e-06,"restricted",0.414471756456667
"11739",12250,53,5,48,3.69698067588201e-06,"wedge",0.487681593981552
"11740",12251,21,3,18,3.2519373416713e-06,"Rudolph",0.174613117034834
"11741",12252,36,2,34,3.49266888800408e-06,"stoke",0.343957207306613
"11742",12253,31,2,29,3.44950102967606e-06,"lyrical",0.313590511254927
"11743",12254,37,7,30,3.42630028095662e-06,"tarot",0.29726980154584
"11744",12256,33,4,29,3.45603406267172e-06,"collected",0.318186213588998
"11745",12257,44,10,34,3.58299653165936e-06,"bendable",0.407498745066068
"11746",12258,29,2,27,3.5992844622489e-06,"cuticle",0.418956590247206
"11747",12259,53,12,41,3.52629203340104e-06,"joints",0.36760961620799
"11748",12260,25,4,21,3.4198673775431e-06,"stagger",0.292744535983579
"11749",12261,61,12,49,3.72129024575401e-06,"glamour",0.504782310765805
"11750",12263,48,11,37,3.5596309374644e-06,"grumble",0.391062073791028
"11751",12264,41,4,37,3.52764794073551e-06,"keeping",0.368563437580999
"11752",12265,41,11,30,3.69993525113311e-06,"associated",0.489760008155592
"11753",12266,38,7,31,3.60071006002384e-06,"Phoenix",0.419959435790164
"11754",12267,50,7,43,3.57135204245623e-06,"Doctor Who",0.399307357352982
"11755",12268,34,4,30,3.46503948412492e-06,"baloney",0.32452113282471
"11756",12270,43,3,40,3.76365737168751e-06,"flight attendant",0.534585726678404
"11757",12271,38,3,35,3.65124744869085e-06,"windscreen",0.45551027338872
"11758",12272,35,3,32,3.6392883007799e-06,"liner",0.447097537067885
"11759",12273,36,6,30,3.46373126987316e-06,"fundamental",0.323600861444742
"11760",12275,49,25,24,3.56726251841599e-06,"ew",0.39643055645676
"11761",12276,40,4,36,3.63042294427301e-06,"geriatric",0.440861147382092
"11762",12277,57,15,42,3.56443972354205e-06,"Romans",0.394444844001401
"11763",12278,68,21,47,3.76016183736548e-06,"doctors",0.532126771511142
"11764",12279,34,6,28,3.42270003114657e-06,"stocky",0.294737183623004
"11765",12280,40,8,32,3.61975226415504e-06,"swag",0.433354791673064
"11766",12281,58,21,37,3.63748795082116e-06,"squares",0.445831069791046
"11767",12282,36,5,31,3.59960836261015e-06,"lipid",0.419184439953025
